"","Bar1","Bar2","Bar3","Bar4","Bar5","nUMI","nUMI_total"
"AAACCCAAGCGATGAC",362,150,112,32,77,733,32908
"AAACCCACAGTTGAAA",25,239,76,27,55,422,16669
"AAACCCATCGAGAATA",4,22,11,2,8,47,104
"AAAGAACCATACAGGG",52,204,85,11,44,396,16567
"AAAGAACGTTCCGGTG",28,201,70,15,35,349,10930
"AAAGGGCAGAATTCAG",2,11,7,0,0,20,508
"AAAGTCCAGCACGTCC",0,48,29,3,11,91,4823
"AAAGTGAAGCATGGGT",16,57,110,9,33,225,11759
"AAAGTGACAAGTTGGG",5,59,36,10,11,121,4102
"AAATGGAAGAAACTCA",18,122,87,19,226,472,24820
"AAATGGAGTATGTCAC",21,106,133,15,145,420,23158
"AACAAAGAGAAGCTGC",1,22,7,0,5,35,424
"AACAAAGAGACTAGAT",44,412,138,33,85,712,33850
"AACAAAGAGCGACTGA",8,56,45,2,8,119,4006
"AACAAGAGTAGAATAC",13,76,33,6,21,149,2906
"AACAAGATCGTCTCAC",5,34,13,3,9,64,1360
"AACACACAGGTGATCG",77,242,395,61,537,1312,88934
"AACACACAGTAACAGT",16,101,96,4,38,255,12261
"AACACACGTACCCGCA",2,22,8,0,2,34,80
"AACACACGTAGCACAG",10,39,91,8,21,169,10068
"AACAGGGTCACCTCTG",8,63,34,6,23,134,2750
"AACCAACAGTTAGAAC",6,69,28,5,15,123,3397
"AACCAACGTTTGTGGT",26,128,85,18,289,546,33965
"AACCAACTCGACGCTG",20,133,260,15,52,480,27803
"AACCACAAGGTGCCAA",74,675,151,55,144,1099,62329
"AACCACACATCTGTTT",33,80,37,10,19,179,5816
"AACCACATCGGAAACG",13,69,91,11,19,203,6790
"AACCACATCTCTTCAA",20,80,73,10,22,205,9591
"AACCATGGTCGCAACC",24,90,227,14,48,403,22413
"AACCTGAAGCGTGCCT",4,82,31,7,19,143,3688
"AACCTGAAGGATACGC",7,65,36,2,13,123,4166
"AACCTGAAGGCATCAG",13,137,96,18,27,291,12630
"AACCTGAGTTCTCTCG",9,81,53,7,22,172,4394
"AACCTTTGTTGGGAAC",12,82,61,8,29,192,8331
"AACCTTTTCCGTAATG",6,50,21,5,17,99,2423
"AACGAAAGTGTCCCTT",5,70,75,6,29,185,7215
"AACGTCAAGCTACGTT",27,96,34,8,18,183,6681
"AACGTCACAACAGTGG",16,78,69,8,22,193,4727
"AACGTCACACGTTGGC",6,61,19,0,10,96,2803
"AACGTCATCATGGTAC",10,53,53,4,25,145,6119
"AACGTCATCGTAACCA",19,97,165,15,46,342,21173
"AACTTCTTCCCGTGAG",0,5,6,0,2,13,44
"AACTTCTTCGGCATTA",193,113,76,25,61,468,22741
"AAGAACACAAGCTCTA",2,12,4,0,2,20,118
"AAGAACAGTGTTAACC",4,63,20,3,9,99,4066
"AAGACAAAGACGTCGA",0,2,3,0,0,5,31
"AAGACAAAGTGAATAC",0,10,4,0,2,16,35
"AAGACTCCAACCGCCA",4,72,36,6,14,132,3561
"AAGACTCGTACAGTTC",12,69,30,5,48,164,6009
"AAGACTCGTAGCACAG",13,73,41,9,14,150,7028
"AAGACTCGTTAAAGTG",21,109,234,11,51,426,18799
"AAGACTCTCTCTCTAA",73,590,207,45,111,1026,61990
"AAGATAGTCGGTTGTA",24,188,53,7,27,299,12939
"AAGCCATAGACCTGGA",23,236,62,8,43,372,13104
"AAGCCATTCCTCATAT",0,8,7,4,2,21,734
"AAGCGAGAGGCGATAC",4,47,17,6,13,87,1672
"AAGCGAGAGTTCCATG",46,91,38,11,22,208,8214
"AAGCGAGCATGAATAG",22,72,90,11,24,219,12293
"AAGCGTTAGATCGACG",2,30,11,2,12,57,2262
"AAGCGTTGTCCAGAAG",19,94,51,17,139,320,16116
"AAGCGTTGTTCTTCAT",56,223,102,25,50,456,16358
"AAGCGTTTCCGCAGTG",3,14,13,0,7,37,655
"AAGTACCAGCGCTTCG",13,119,38,14,20,204,7872
"AAGTACCGTTTGTGGT",22,209,58,12,39,340,19545
"AAGTCGTAGTACAGAT",44,405,229,30,113,821,35853
"AAGTCGTGTTCTCGCT",36,361,93,20,68,578,25289
"AAGTCGTGTTGAGTCT",16,67,48,11,165,307,13563
"AAGTCGTTCCGCAGTG",1,44,22,0,12,79,1908
"AATAGAGAGAAATCCA",56,78,94,15,45,288,8737
"AATAGAGAGAAGCTCG",6,69,37,7,19,138,2950
"AATCACGCAGCTGCCA",10,64,39,2,17,132,5289
"AATCACGCATAGAGGC",6,67,22,4,13,112,2583
"AATCACGCATCCGGTG",1,10,7,0,0,18,241
"AATCGTGAGCGTGTTT",34,125,326,20,62,567,37259
"AATGAAGCAATGCTCA",12,73,42,12,90,229,11134
"AATGAAGCAGAACATA",6,97,61,12,27,203,4334
"AATGAAGCATCGCCTT",0,27,22,2,15,66,1779
"AATGAAGGTATTCCTT",24,131,58,15,186,414,21432
"AATGAAGGTCGACGCT",66,86,41,12,32,237,11607
"AATGACCAGTCATAGA",17,196,59,15,43,330,13557
"AATGACCCAAGTGGCA",8,63,18,2,14,105,1670
"AATGACCCAATGTGGG",28,251,85,17,47,428,22883
"AATGACCCAGTTACCA",58,553,117,42,100,870,40427
"AATGACCCATTGACTG",13,94,106,14,34,261,9097
"AATGACCTCACTCTTA",46,304,107,24,138,619,30083
"AATGCCAAGGTCTGGA",6,54,22,2,16,100,3277
"AATGGAACATACAGCT",12,102,57,7,47,225,7258
"AATGGAACATCGGCCA",2,40,14,2,7,65,1188
"AATGGCTAGCTGCCTG",12,71,34,6,19,142,5095
"AATTCCTGTTGAAGTA",31,122,82,17,203,455,28552
"ACAAAGACATGACAAA",1,63,35,2,16,117,3013
"ACAACCAAGACCACGA",9,62,38,7,39,155,4865
"ACAACCAGTTAGGCCC",2,26,9,0,7,44,1102
"ACAACCATCGACATTG",39,231,79,14,64,427,18045
"ACAACCATCGCCAGAC",8,119,48,11,20,206,6897
"ACAAGCTCAGTGGTGA",5,91,37,3,20,156,5579
"ACACAGTCAACACTAC",27,131,37,8,28,231,8700
"ACACAGTGTGTTCCTC",26,321,79,25,48,499,26369
"ACACCAACAGCTCTGG",13,112,50,6,26,207,10213
"ACACGCGAGATACGAT",55,394,108,75,87,719,31244
"ACACGCGAGATGCTAA",5,52,24,0,39,120,3689
"ACACGCGCACTAGTAC",86,67,39,8,24,224,11847
"ACACGCGCACTGAGGA",14,110,54,11,167,356,16124
"ACACGCGCATGACGTT",0,3,2,0,0,5,176
"ACACTGAAGCACCAGA",12,126,140,17,42,337,12506
"ACACTGAAGCCATTTG",0,16,8,0,3,27,103
"ACACTGAGTAGGTACG",15,88,63,9,98,273,14019
"ACACTGATCGCTGACG",23,228,57,14,36,358,12591
"ACAGAAAAGGTGAGCT",7,65,25,5,13,115,2362
"ACAGAAAGTCTCTCCA",4,19,8,0,5,36,99
"ACAGAAAGTGGCCCAT",5,81,30,4,16,136,5015
"ACAGCCGAGCCTGAGA",30,387,102,20,63,602,28575
"ACAGCCGTCATTTGCT",95,76,44,9,27,251,9741
"ACAGGGAAGAGTCTTC",6,49,23,3,14,95,1751
"ACAGGGAAGCTATCCA",19,229,75,22,49,394,19140
"ACAGGGAAGGAGAGGC",11,199,49,11,27,297,14871
"ACAGGGAAGTTACGAA",66,209,71,13,58,417,18137
"ACAGGGACATGACTTG",7,76,60,10,20,173,4904
"ACAGGGAGTTCGTGCG",8,60,42,6,62,178,6938
"ACAGGGATCGTGCATA",12,75,30,8,16,141,5886
"ACATGCATCGCCATAA",0,4,4,0,4,12,47
"ACATGCATCTCATTTG",4,39,17,6,21,87,2439
"ACATTTCCATATCTGG",4,23,14,0,7,48,1285
"ACATTTCTCGCTAAAC",110,319,177,524,130,1260,58846
"ACCAAACAGTCGGGAT",27,147,48,11,34,267,14421
"ACCAAACGTACCGGAA",2,9,6,0,4,21,43
"ACCAAACGTCAGTCTA",1,29,14,6,12,62,2339
"ACCAAACGTTCCACGG",1,14,8,4,12,39,1921
"ACCAACAAGCGACTTT",15,141,47,7,26,236,9682
"ACCACAAAGATCACTC",3,12,26,2,5,48,1272
"ACCACAAGTACGCGTC",117,1083,420,234,230,2084,111646
"ACCACAAGTTGGTGTT",58,564,148,32,97,899,63554
"ACCATTTAGCATGTTC",11,51,40,6,39,147,6627
"ACCATTTCAGTCTGGC",0,7,2,0,0,9,241
"ACCCAAACAACCCGCA",66,214,619,41,329,1269,83018
"ACCCAAAGTCACAGAG",10,59,48,7,23,147,3188
"ACCCTCAGTCGGTGAA",48,471,124,37,90,770,39617
"ACCCTTGCAGTAGAGC",12,102,35,11,26,186,8048
"ACCCTTGGTACCCGAC",8,56,35,0,25,124,4856
"ACCCTTGGTGACGCCT",11,127,48,7,24,217,7800
"ACCGTTCAGAGCCCAA",9,90,24,8,17,148,8451
"ACCGTTCAGAGCGACT",16,122,54,11,52,255,15598
"ACCGTTCAGGTAAGAG",65,246,74,27,57,469,20493
"ACCGTTCTCTTGCAAG",2,29,17,4,5,57,2194
"ACCTACCCACACAGCC",5,55,21,2,11,94,2695
"ACCTACCTCCCAGGAC",0,12,11,2,7,32,481
"ACCTGAACACAAAGTA",123,1225,321,92,423,2184,147485
"ACCTGAAGTCTAACGT",4,21,7,2,3,37,221
"ACCTGAATCTGTCGTC",22,155,44,12,36,269,11376
"ACCTGTCAGTTCATGC",24,311,74,26,63,498,28418
"ACCTGTCCACGCTGAC",41,54,33,15,20,163,5649
"ACCTGTCTCGCCAACG",11,167,41,11,24,254,10839
"ACGATCAAGGTGGCTA",42,166,61,13,36,318,9351
"ACGATCAGTGGGATTG",52,431,104,32,75,694,43269
"ACGCACGGTCGATTCA",39,232,54,10,33,368,15114
"ACGGAAGTCAAGGACG",14,183,57,7,41,302,13064
"ACGGGTCCACTCCGGA",11,70,51,7,118,257,15892
"ACGGTCGAGGGAGATA",3,4,2,0,2,11,21
"ACGGTCGTCATCAGTG",19,209,55,10,39,332,17067
"ACGGTCGTCCGACAGC",22,92,196,28,47,385,21053
"ACGGTTAAGCACCTGC",9,78,23,5,15,130,5407
"ACGGTTATCTCTTAAC",6,36,14,4,5,65,256
"ACGTAACCAACACGTT",19,84,169,17,34,323,17728
"ACGTAACTCCCATTTA",2,18,7,0,5,32,107
"ACGTACACACGCAGTC",4,46,23,2,43,118,2548
"ACGTACACATTAAGCC",8,52,42,2,19,123,2014
"ACGTACAGTGACCGTC",1,28,10,0,14,53,1474
"ACGTAGTCATCCGGCA",6,65,26,5,13,115,2620
"ACGTAGTGTAAGGTCG",50,195,547,49,103,944,58520
"ACGTTCCAGATGCTGG",11,108,32,7,25,183,11188
"ACGTTCCTCGCTACAA",15,101,104,13,111,344,14840
"ACTACGACATTAAAGG",22,62,19,5,18,126,4834
"ACTATCTAGGTACATA",4,87,40,8,13,152,4943
"ACTATCTCACTATCGA",9,107,35,10,31,192,9112
"ACTATCTGTAACAAGT",66,232,145,48,498,989,58827
"ACTATGGTCCTGCTAC",4,17,10,0,4,35,1330
"ACTATTCAGCGATGCA",3,27,8,2,5,45,1324
"ACTATTCCATCATGAC",71,229,176,52,724,1252,87081
"ACTATTCTCATGACAC",27,126,135,11,127,426,24648
"ACTCCCAAGGTCGTCC",8,47,20,3,12,90,1919
"ACTCCCAGTACGACAG",14,81,32,8,66,201,7914
"ACTCTCGAGATTGGGC",19,193,65,11,39,327,18820
"ACTCTCGAGGAGCTGT",80,856,204,68,160,1368,74922
"ACTCTCGTCTTGATTC",2,64,24,2,13,105,3380
"ACTGATGCACGAGAAC",1,11,10,0,9,31,340
"ACTGATGCAGTGTGCC",4,24,12,0,4,44,743
"ACTGCAAAGTCTGCGC",1,42,17,4,11,75,166
"ACTGCAACAAACTCTG",11,83,43,2,24,163,379
"ACTGTCCCACGCTGTG",24,108,64,15,233,444,26411
"ACTGTGAAGCTCTTCC",18,99,168,12,44,341,20295
"ACTGTGAAGGTTTGAA",9,78,42,4,24,157,5098
"ACTTCCGAGCTATCTG",4,13,6,0,8,31,1692
"ACTTCCGCAAGCTGTT",20,218,63,13,44,358,20406
"ACTTCCGGTACAGTCT",9,69,22,8,14,122,2179
"ACTTCGCGTGGGCTTC",14,67,33,11,28,153,5905
"ACTTCGCTCTGAGGTT",2,14,12,0,2,30,598
"ACTTTCATCGAAGCCC",2,21,7,4,25,59,3115
"ACTTTGTAGCTGGCTC",10,55,15,0,14,94,1534
"ACTTTGTTCGGATTAC",8,49,35,2,12,106,3166
"AGAAATGCAATGAAAC",41,441,122,35,86,725,32309
"AGAAATGCACCCGTAG",19,257,50,14,42,382,24066
"AGAAATGCATGCCGGT",4,15,7,3,28,57,1812
"AGAAATGCATTCATCT",27,99,195,18,47,386,22543
"AGAAATGGTAACAAGT",40,95,44,8,26,213,5521
"AGAAATGTCCATGATG",13,69,127,10,37,256,11435
"AGAACAAGTTAAACAG",2,36,10,0,6,54,985
"AGAACCTAGAGCTGCA",8,85,76,11,81,261,11161
"AGAACCTAGGTTTACC",7,72,36,4,24,143,5183
"AGAACCTGTACATACC",14,49,120,15,27,225,12116
"AGAAGCGTCATGAGTC",14,131,55,13,75,288,8307
"AGAAGTATCAGAACCT",39,218,99,315,92,763,36489
"AGAAGTATCCGTGCGA",19,194,67,20,37,337,20449
"AGAAGTATCCTCTTTC",14,92,26,6,18,156,5494
"AGACAAACAATACCCA",71,383,164,29,89,736,38705
"AGACAAATCAAGCTGT",1,13,6,0,8,28,189
"AGACACTAGAGGTCAC",43,191,221,18,91,564,24624
"AGACACTAGCAATAGT",19,105,71,22,118,335,11046
"AGACACTGTGCCTTCT",81,234,725,63,138,1241,84969
"AGACACTTCCAACCGG",6,61,31,2,11,111,4290
"AGACAGGGTTCGGCTG",9,52,37,5,16,119,3517
"AGACCATAGAAATGGG",1,11,9,0,8,29,77
"AGACCATCACCGGTCA",56,184,124,39,479,882,56963
"AGACCATCAGCATCTA",14,72,93,10,32,221,7248
"AGACCCGCAACTGATC",48,132,40,8,38,266,10494
"AGACTCAGTTAGAAAC",4,71,33,8,17,133,2368
"AGAGAATTCATTGAGC",28,115,81,18,190,432,22630
"AGAGAGCAGACGGATC",1,6,5,0,0,12,129
"AGAGCAGAGTCCCTAA",7,57,30,5,11,110,4908
"AGAGCAGCAGTAGAGC",19,91,77,8,157,352,21923
"AGAGCCCCACACCGCA",2,50,18,3,16,89,2324
"AGATAGAAGCTGAAGC",3,21,29,4,14,71,2535
"AGATAGAAGCTGACAG",0,13,8,0,10,31,1032
"AGATAGAAGGACAGCT",3,60,45,3,17,128,2926
"AGATAGAAGGACGGAG",11,73,73,8,23,188,6942
"AGATCCATCCACGAAT",80,148,71,19,59,377,13918
"AGATCGTAGCCTGCCA",2,19,6,0,5,32,639
"AGATCGTAGGATATAC",2,15,7,0,0,24,627
"AGATCGTCACATCCCT",21,35,25,3,17,101,1695
"AGATCGTGTCGAGTGA",25,81,36,11,28,181,3755
"AGATCGTGTCTTACTT",7,62,30,8,18,125,2615
"AGATGAACACTAAACC",19,113,161,15,58,366,14370
"AGATGAAGTCAAGGCA",34,111,339,21,64,569,39239
"AGATGCTAGTATGGCG",19,76,107,13,66,281,14798
"AGCATCAAGATACCAA",18,120,164,16,41,359,16409
"AGCATCATCGACATTG",0,51,22,6,11,90,1945
"AGCCACGAGACAGCGT",4,66,35,5,14,124,3984
"AGCCACGAGCCAACCC",7,64,21,4,18,114,2695
"AGCCAGCTCGGACTTA",4,14,9,3,22,52,2670
"AGCGATTAGGCCCAAA",26,112,223,14,56,431,21339
"AGCGCTGGTGACGCCT",27,101,185,13,43,369,16538
"AGCGCTGGTTTACCTT",9,75,37,5,67,193,6505
"AGCGTATCAGCTCATA",46,408,107,26,69,656,32299
"AGCGTCGCAGCAGTCC",0,17,2,3,13,35,637
"AGCGTCGCAGGGAGAG",2,22,18,2,6,50,882
"AGCTACAAGAGACAAG",5,71,37,6,49,168,3933
"AGCTACAAGTAATCCC",3,23,7,2,5,40,1676
"AGCTACACAGAGAAAG",31,337,91,32,63,554,24718
"AGCTCAACAGGTCAAG",13,77,143,12,30,275,16375
"AGCTCAATCCCAACTC",7,64,34,3,21,129,3931
"AGCTTCCCAGGTGTGA",13,61,83,6,18,181,8570
"AGGAAATCAGGTCCCA",20,98,184,14,42,358,17197
"AGGAAATCATGACAAA",7,62,61,4,23,157,4630
"AGGAAATGTTTGTGGT",21,105,126,15,39,306,14587
"AGGAATAAGATGATTG",30,127,72,131,52,412,15531
"AGGAATAAGTCAGGGT",3,11,22,2,5,43,1888
"AGGAATAGTTTCACTT",7,85,62,8,19,181,5354
"AGGAATATCTTAGCAG",10,112,48,9,34,213,7133
"AGGACGACACTGAGTT",32,335,115,21,60,563,27104
"AGGACGAGTAAGATAC",3,78,31,0,15,127,3367
"AGGACGATCATCACTT",5,28,39,2,8,82,2382
"AGGAGGTTCCCGAACG",0,13,10,0,0,23,759
"AGGATAAAGACCATGG",25,160,59,17,38,299,12622
"AGGATAACAGACCGCT",6,94,28,6,14,148,4952
"AGGATCTAGAACGCGT",8,50,23,3,22,106,2459
"AGGATCTTCAGGTGTT",69,101,53,9,34,266,11915
"AGGCATTCAAATGGCG",282,3134,609,203,505,4733,281695
"AGGCATTCAACTTCTT",1,21,4,0,2,28,615
"AGGCATTGTGACACGA",2,36,55,4,13,110,3663
"AGGCTGCAGCTGAGCA",14,65,147,9,32,267,16415
"AGGCTGCTCCCTCTTT",17,87,75,8,106,293,13851
"AGGGAGTCACCTGTCT",25,176,44,19,33,297,12990
"AGGGCCTAGTATGGCG",233,241,111,29,73,687,34142
"AGGGCCTTCACCTTAT",17,140,60,13,38,268,13701
"AGGGCCTTCACTACGA",2,16,7,0,11,36,204
"AGGGCTCAGCCTCTCT",0,3,2,0,4,9,45
"AGGGCTCCACTGGCCA",19,195,81,16,47,358,17896
"AGGGTCCAGCCGCACT",49,521,113,46,96,825,44430
"AGGGTCCTCAGCTCTC",26,78,207,11,43,365,22966
"AGGGTGAAGACAAGCC",27,119,266,16,51,479,24345
"AGGGTGAAGATCCCAT",3,17,12,0,5,37,489
"AGGGTGATCATTTGGG",13,69,28,5,75,190,8012
"AGGGTTTGTTGCATTG",63,579,149,40,104,935,53916
"AGGGTTTTCGAGCTGC",40,149,246,25,270,730,42441
"AGGTAGGGTATCAGCT",11,109,38,14,25,197,8455
"AGGTAGGGTATTAAGG",16,128,32,10,17,203,8469
"AGGTAGGGTTGTGCAT",27,92,224,19,61,423,29384
"AGGTAGGTCAAGAATG",33,126,330,25,68,582,34119
"AGGTCTAAGACAACTA",0,8,8,0,3,19,36
"AGGTGTTAGAAGCTGC",1,20,9,0,3,33,357
"AGGTGTTAGGCTGAAC",1,18,4,0,10,33,948
"AGGTGTTAGTCTGCAT",2,58,29,2,22,113,3283
"AGGTGTTCAAGTTCCA",3,59,25,3,20,110,2785
"AGGTGTTCATAATGAG",152,1308,325,106,238,2129,109662
"AGGTGTTGTACGTACT",7,56,19,5,11,98,1848
"AGGTGTTTCCCGAGAC",11,103,45,7,25,191,4904
"AGGTTACTCGCATTAG",5,47,23,0,14,89,2426
"AGGTTGTAGAGCAGTC",37,146,397,23,134,737,52385
"AGGTTGTAGCAAGTCG",7,72,32,5,13,129,4641
"AGGTTGTAGTCTTCCC",4,33,22,6,13,78,1626
"AGGTTGTGTCGTGCCA",1,8,6,0,4,19,33
"AGTAACCTCGAAGTGG",72,718,136,51,127,1104,52809
"AGTAACCTCTCGTTTA",1,18,8,2,3,32,367
"AGTACCATCACTAGCA",32,140,320,22,64,578,35801
"AGTACCATCGATACAC",27,35,17,4,9,92,3421
"AGTAGCTAGAAGGATG",3,13,5,0,3,24,605
"AGTAGCTAGCCTCTGG",55,192,431,46,233,957,60743
"AGTAGCTAGCGGTAGT",5,48,30,6,28,117,2993
"AGTAGCTCACACGGAA",8,61,35,9,18,131,5123
"AGTAGTCGTTTACGAC",15,146,137,7,71,376,15328
"AGTCACAAGTATCCTG",23,116,240,22,51,452,27787
"AGTCACACAAAGGGTC",5,57,19,2,11,94,2976
"AGTCACACATCCGGCA",36,51,30,4,22,143,6487
"AGTCATGTCCATCTGC",49,577,118,32,102,878,42615
"AGTCTCCTCCCTTGGT",22,207,56,16,40,341,15730
"AGTGACTAGATTGCGG",12,97,37,4,22,172,8188
"AGTGACTTCCGCAGTG",2,47,45,3,15,112,3016
"AGTGACTTCGTAACAC",62,760,183,44,145,1194,62690
"AGTGATCAGTCTTGGT",3,41,13,4,16,77,3225
"AGTGATCGTGTGGTCC",4,69,32,2,18,125,3283
"AGTGATCGTTATGACC",6,64,26,2,20,118,2635
"AGTGATCTCATACAGC",12,59,28,6,22,127,1755
"AGTGCCGAGGACGGAG",110,1212,287,79,183,1871,101096
"AGTGTTGTCAAATGAG",0,10,2,0,0,12,197
"AGTTAGCAGGTCGTGA",1,13,6,0,7,27,733
"AGTTAGCGTCGTTATG",0,0,0,0,0,0,33
"AGTTAGCTCAAGAAAC",15,77,118,8,30,248,10898
"AGTTCCCTCGGCAGTC",7,67,71,9,37,191,8275
"AGTTCGAAGACCAGAC",17,94,74,11,18,214,7853
"AGTTCGACAAAGTGTA",9,78,31,4,27,149,2740
"AGTTCGACACATCATG",4,45,40,4,24,117,2434
"AGTTCGAGTCCCGTGA",6,49,25,5,13,98,2090
"AGTTCGAGTCGTTCAA",179,183,72,6,33,473,11116
"ATACCGATCGCCAATA",15,91,89,15,72,282,14024
"ATACCTTCAACCACGC",4,39,18,5,18,84,2402
"ATACCTTCAACCGATT",2,64,26,6,14,112,3305
"ATACCTTTCCCAGTGG",48,313,93,15,61,530,27397
"ATAGACCCAACGGCTC",418,1362,1029,330,3926,7065,405843
"ATAGACCCACACCTTC",136,161,82,32,51,462,20553
"ATAGACCGTCCATAGT",15,83,25,7,21,151,4279
"ATAGACCTCTGTCTCG",14,162,66,13,37,292,11236
"ATAGAGATCAGCGGAA",10,158,48,11,36,263,13542
"ATAGGCTTCAAGCCCG",57,45,27,2,18,149,4998
"ATATCCTGTTCGGTAT",12,82,57,4,65,220,8836
"ATCACAGCAAACCATC",20,76,20,11,21,148,7547
"ATCACAGCATCGGTTA",1,4,0,0,0,5,101
"ATCACAGGTAGACGTG",0,58,36,2,14,110,2919
"ATCACAGGTCACCCTT",14,96,39,8,25,182,5491
"ATCACGACAAGCTACT",9,85,40,4,29,167,4958
"ATCACTTCAAGGTCGA",1,11,5,2,0,19,47
"ATCACTTCACAGCCTG",0,15,14,0,2,31,647
"ATCAGGTCAGCACCCA",129,326,92,21,69,637,32731
"ATCAGGTGTTCTCGTC",66,283,785,72,237,1443,94684
"ATCAGGTTCCAAAGGG",7,108,35,10,18,178,8876
"ATCATTCTCCGCTAGG",15,92,139,11,36,293,16079
"ATCCACCCAAATTAGG",5,35,20,3,5,68,481
"ATCCACCCACCGCTGA",1,18,9,3,5,36,192
"ATCCACCTCTCTATAC",17,107,110,19,34,287,11441
"ATCCATTAGCAAACAT",75,593,209,49,132,1058,56468
"ATCCATTCAAAGCGTG",4,66,30,3,19,122,2707
"ATCCATTGTCATATGC",12,76,31,54,25,198,9449
"ATCCATTTCATGCAGT",14,112,35,6,24,191,6881
"ATCCCTGCAGAAGCTG",12,91,102,6,24,235,7399
"ATCCGTCAGACCAGAC",8,91,33,5,30,167,5678
"ATCCGTCTCTCGCTTG",3,8,18,0,6,35,1052
"ATCCTATGTATCACCA",8,73,28,3,19,131,2252
"ATCGATGAGCTCTGTA",5,45,22,2,15,89,1741
"ATCGATGAGGGTCTTT",19,73,29,4,22,147,3560
"ATCGATGCAAATGAGT",32,439,130,24,80,705,39281
"ATCGATGCACAAGCTT",63,214,611,44,225,1157,85333
"ATCGATGGTTCAAGTC",19,106,107,16,126,374,19665
"ATCGCCTCACAATGTC",1,17,6,0,0,24,692
"ATCGCCTCACAGTGTT",25,236,60,19,40,380,23686
"ATCGGCGGTTTGGAAA",2,21,13,3,7,46,717
"ATCGTAGAGGTGGCTA",18,89,160,14,35,316,15885
"ATCGTAGCAGTCTCTC",18,97,139,12,34,300,14244
"ATCGTAGCATGAAAGT",30,389,96,29,62,606,27494
"ATCGTAGGTGTGAGCA",11,35,20,2,9,77,2367
"ATCGTCCGTGTTTACG",28,267,63,23,55,436,19423
"ATCGTGACAGAACATA",8,68,37,3,18,134,3597
"ATCTCTAGTACGACAG",11,75,55,8,28,177,4958
"ATCTTCAAGAAACACT",33,163,345,27,195,763,45561
"ATCTTCACAACCACGC",12,119,54,9,31,225,8058
"ATCTTCAGTCGTTCAA",14,90,43,7,67,221,7416
"ATGAAAGTCGATTGAC",157,693,170,53,134,1207,57093
"ATGACCAGTGCCTATA",19,101,64,114,38,336,13653
"ATGACCATCTCGAACA",30,259,63,16,52,420,25839
"ATGAGTCCACAAAGTA",1,27,14,0,12,54,614
"ATGAGTCCATCTCATT",13,136,46,10,35,240,9689
"ATGCATGAGGAGCAAA",93,464,210,161,97,1025,48112
"ATGCATGGTAGCTGCC",10,25,94,3,14,146,8992
"ATGCATGGTTTACCTT",15,152,40,10,28,245,11167
"ATGCCTCAGACTCCGC",6,69,28,6,15,124,3245
"ATGCCTCAGGGAGAAT",26,79,56,16,178,355,20238
"ATGGAGGGTAGGTACG",153,381,1175,105,429,2243,156454
"ATGGAGGGTGCTTCAA",250,361,185,38,112,946,44837
"ATGGATCAGCTCGACC",15,71,34,14,109,243,14309
"ATGGATCGTGTGGACA",18,243,66,18,37,382,21724
"ATGGGAGGTGAGGAAA",4,63,15,2,14,98,218
"ATGGGTTCACTGCGTG",5,42,25,3,16,91,3752
"ATGGGTTCATCTCATT",118,389,502,93,951,2053,105423
"ATGGGTTTCAGACAAA",1,21,8,0,5,35,167
"ATGGTTGAGACATCCT",8,53,28,5,18,112,3100
"ATGGTTGCAAACACGG",10,87,34,7,13,151,4463
"ATGGTTGCAGACGATG",31,277,141,33,68,550,26413
"ATGTCCCAGCACTCTA",2,35,42,2,10,91,3295
"ATGTCCCCAATTCTCT",22,136,117,12,44,331,17529
"ATGTCTTCAAGATCCT",3,85,34,4,18,144,5620
"ATGTCTTCAGACCTGC",19,92,275,12,57,455,33139
"ATGTCTTGTAGTGTGG",1,41,22,4,13,81,1486
"ATGTCTTGTGTCATTG",11,48,49,6,50,164,6119
"ATGTCTTTCATGAGGG",6,55,20,39,16,136,3068
"ATGTCTTTCTGAACGT",13,168,36,8,35,260,12423
"ATTACTCCAGAGAATT",3,15,2,3,2,25,121
"ATTACTCTCTTGCAGA",9,88,38,4,69,208,7514
"ATTATCCTCACCTCTG",11,58,42,2,23,136,4553
"ATTCACTAGTCTGCAT",2,83,37,12,15,149,2593
"ATTCACTCAGACGCTC",14,70,50,10,48,192,6269
"ATTCAGGGTTCATCGA",21,68,48,113,37,287,12544
"ATTCATCCATTCTCCG",3,14,7,0,5,29,95
"ATTCATCGTGATCATC",17,85,100,10,65,277,16123
"ATTCCATAGCGCCGTT",48,211,889,50,113,1311,58793
"ATTCCATAGGGTACGT",43,139,331,27,75,615,38189
"ATTCCATAGGTATTGA",52,55,29,7,23,166,5843
"ATTCCCGCAGCGTATT",23,118,206,14,48,409,28122
"ATTCCCGCATTACGGT",0,12,6,2,6,26,726
"ATTCCTATCACTGAAC",1,25,11,2,9,48,150
"ATTCGTTAGAGGACTC",61,172,394,47,341,1015,69822
"ATTCTACTCATTTGTC",19,194,63,12,41,329,17072
"ATTCTACTCTGGTTGA",24,86,35,9,23,177,6194
"ATTCTTGCACATCCCT",5,69,58,7,18,157,6635
"ATTCTTGCAGCGACCT",1,10,4,2,5,22,413
"ATTCTTGTCGGAGATG",2,13,9,0,9,33,113
"ATTGGGTAGGAGTCTG",9,85,47,11,107,259,9584
"ATTGGGTGTATCGTTG",3,63,30,7,13,116,3379
"ATTGTTCCATAAGATG",2,44,25,6,16,93,1869
"ATTGTTCGTTCAGTAC",8,58,29,2,20,117,2295
"ATTGTTCTCTGATTCT",1,40,19,0,9,69,1738
"ATTTACCCAATGAAAC",17,215,57,17,40,346,13710
"ATTTACCTCAAGCCGC",9,33,10,2,8,62,379
"ATTTCACCAAGACAAT",35,148,206,22,181,592,38032
"ATTTCACTCGAGAAAT",85,246,165,476,127,1099,47748
"ATTTCTGAGACATCCT",0,17,9,2,4,32,486
"ATTTCTGCAACGCATT",34,63,36,6,24,163,6326
"CAAAGAAGTGAATGTA",3,12,7,0,5,27,485
"CAAAGAAGTTCCTACC",5,39,26,3,22,95,3282
"CAACAACAGATAGTCA",33,307,151,33,65,589,30332
"CAACAGTCATGTACGT",32,134,285,28,73,552,22493
"CAACAGTTCAAGCCGC",42,306,280,43,84,755,38697
"CAACAGTTCACTCACC",6,55,58,8,51,178,5368
"CAACAGTTCCTCGCAT",11,94,36,10,22,173,6350
"CAACCAAAGAGAACCC",3,9,5,0,6,23,114
"CAACCAAGTATTCCGA",7,92,38,10,22,169,6755
"CAACCAAGTCTTCCGT",2,12,5,2,2,23,168
"CAACCTCAGCCAGACA",30,99,274,21,60,484,34894
"CAACCTCGTCTGCCTT",9,126,38,7,27,207,13256
"CAACCTCTCCCTCGAT",8,71,34,4,18,135,4964
"CAACGATCAAGTTCGT",6,50,35,6,13,110,4051
"CAACGATGTACTTCCC",11,101,47,6,20,185,3549
"CAACGGCAGATGGGCT",3,18,7,0,3,31,540
"CAAGACTGTGCTCGTG",25,261,78,27,52,443,20875
"CAAGAGGAGCCTAGGA",12,153,39,13,29,246,10778
"CAAGCTACACGTCTCT",7,86,38,4,16,151,5725
"CAAGCTACATCGGCCA",1,5,3,3,0,12,48
"CAAGCTATCTCACCCA",8,97,32,6,22,165,8420
"CAAGGGAAGATTGACA",28,285,115,19,67,514,29186
"CAAGGGAAGGAGAGGC",4,10,6,0,3,23,412
"CAAGGGACAAAGACTA",1,21,7,2,5,36,790
"CAAGGGAGTGAAGCGT",4,29,14,2,19,68,1647
"CAAGGGAGTTCACGAT",3,45,21,2,10,81,2531
"CAATACGGTGCGTTTA",32,112,167,17,128,456,24587
"CAATCGAAGATCCCGC",4,21,10,0,4,39,622
"CAATCGAAGCTGTACT",18,122,88,13,159,400,18930
"CAATCGAAGTTGCGAG",7,51,31,18,19,126,3220
"CAATCGACAATTGTGC",2,15,7,0,4,28,111
"CAATCGACAGCGTTTA",83,218,277,48,633,1259,82124
"CAATGACAGAAGTCTA",20,212,55,15,39,341,16516
"CAATGACCATGAGATA",4,80,70,2,25,181,6855
"CAATGACGTAAGACCG",9,65,22,4,14,114,1331
"CAATGACGTTGGTGTT",3,22,12,2,8,47,107
"CAATTTCCAAATCCCA",42,114,278,25,112,571,29396
"CACAACACAATACGAA",18,78,81,11,117,305,19723
"CACACAAAGACCAAAT",21,64,38,3,22,148,4114
"CACACAAAGGTTTGAA",24,111,314,27,58,534,30005
"CACAGATCATGAGAAT",26,285,81,17,56,465,20979
"CACAGATCATTGAGGG",10,94,30,7,24,165,5842
"CACAGATGTGCAGGAT",6,43,29,2,17,97,2491
"CACAGGCAGTCAACAA",5,63,18,5,15,106,2463
"CACAGGCGTGAGAACC",17,175,60,11,37,300,16131
"CACAGGCTCTTGTGCC",11,106,33,8,23,181,9923
"CACATGACAGAGTCAG",12,164,54,10,34,274,12122
"CACCAAAAGCATGCGA",48,169,321,31,272,841,57831
"CACCAAAAGTCTGCAT",9,84,37,9,96,235,9541
"CACCAAACACGCTTAA",6,32,14,5,4,61,1773
"CACCGTTAGGGAGAAT",65,207,689,42,129,1132,82919
"CACCGTTTCCAGCTCT",13,80,41,9,97,240,13059
"CACGAATCATGAGAAT",6,76,21,5,18,126,3491
"CACGGGTGTATTTCTC",6,42,51,6,20,125,3445
"CACGGGTGTCGAGCAA",24,223,59,16,45,367,18325
"CACGTGGCAGGCGATA",156,529,404,130,1428,2647,158560
"CACGTTCCAGAGATTA",12,67,23,2,21,125,1947
"CACGTTCGTTGGGACA",19,76,123,6,56,280,16276
"CACTAAGAGACATACA",2,20,9,2,10,43,710
"CACTAAGCACTTCATT",7,81,34,5,18,145,4439
"CACTAAGCATCATTGG",3,34,11,2,7,57,1368
"CACTGAATCGCCAGAC",19,107,234,29,43,432,26859
"CACTGAATCTGCTAGA",14,70,122,8,33,247,14945
"CACTGGGAGCTGACAG",14,100,198,13,84,409,27446
"CACTGGGAGGATGGCT",4,47,30,2,15,98,2492
"CACTGGGAGTCATGGG",5,16,11,0,5,37,365
"CACTGGGAGTGCTCGC",32,86,41,8,27,194,8895
"CACTGTCAGAGGTCGT",0,8,2,0,0,10,31
"CACTGTCAGCGTCTCG",33,118,140,18,234,543,31563
"CACTGTCCACAAGTTC",161,1794,384,125,302,2766,158867
"CACTGTCGTTGGGTAG",11,121,36,5,16,189,7977
"CACTTCGTCTCATAGG",1,5,3,0,0,9,92
"CAGAGCCTCCTAAGTG",8,58,20,4,12,102,1522
"CAGAGCCTCGGACTTA",6,77,33,6,16,138,2850
"CAGATACCACTGAATC",13,49,29,9,44,144,4509
"CAGATACCAGCAGTCC",97,75,43,12,25,252,12437
"CAGATACGTAGGTCAG",6,83,30,5,22,146,3587
"CAGATCAGTATTGCCA",19,137,57,73,36,322,16565
"CAGATTGCACACAGAG",7,58,26,2,17,110,2171
"CAGATTGTCCCGTTCA",23,82,192,18,46,361,22834
"CAGCACGAGGCCTTGC",4,10,9,0,3,26,334
"CAGCACGAGGCGATAC",11,80,67,10,31,199,5388
"CAGCACGCAAGCACCC",27,135,322,22,70,576,33901
"CAGCAGCAGATGTAGT",0,20,12,0,8,40,832
"CAGCAGCAGCGATGAC",47,568,193,35,93,936,48761
"CAGCAGCCACCTCAGG",41,556,113,35,96,841,47583
"CAGCAGCGTACGTAGG",0,12,7,3,4,26,321
"CAGCAGCGTAGCACAG",6,82,30,4,16,138,3590
"CAGCAGCGTTCTCCTG",1,25,13,3,3,45,122
"CAGCGTGAGTGTGTTC",10,84,26,7,21,148,4871
"CAGCGTGCAAAGGATT",3,64,21,2,18,108,1479
"CAGCGTGTCACTACTT",4,42,24,2,14,86,3819
"CAGCGTGTCTCCAAGA",6,55,26,4,26,117,2851
"CAGGGCTAGGTCGTGA",20,115,42,8,30,215,7832
"CAGGGCTCAGCTGTAT",8,53,58,5,13,137,6134
"CAGGGCTTCCTTCGAC",15,61,73,9,24,182,8057
"CAGGTATAGAACAAGG",9,49,76,5,21,160,5387
"CAGGTATCAATTGAAG",4,26,14,2,9,55,119
"CAGGTATCATCTTAGG",125,149,64,16,59,413,17599
"CAGTGCGAGCATTGAA",7,58,25,7,36,133,4246
"CAGTGCGAGGTACTGG",29,105,274,17,57,482,29717
"CAGTGCGCAAGAATAC",1,11,5,0,0,17,95
"CAGTGCGGTCCTATAG",5,36,22,4,9,76,1724
"CAGTTAGAGCAGGGAG",7,63,25,3,25,123,2579
"CAGTTAGAGGACTGGT",21,142,58,12,40,273,13100
"CAGTTAGAGGTACAAT",18,110,60,11,123,322,12559
"CAGTTAGGTGAACCGA",20,138,127,21,126,432,29989
"CATAAGCCATGCAGCC",70,903,197,60,146,1376,72622
"CATAAGCGTCGAGCTC",14,108,33,5,17,177,3762
"CATAAGCGTTAACCTG",7,40,50,7,12,116,4282
"CATAAGCTCCGCCTAT",68,392,133,29,74,696,32014
"CATAAGCTCGTGCGAC",7,46,37,6,26,122,4273
"CATACAGCAACCGTAT",4,56,23,2,9,94,2845
"CATACCCCACACCTGG",18,98,192,17,37,362,23132
"CATACCCGTATGAGCG",2,26,9,0,6,43,1156
"CATAGACCACTCTGCT",0,9,3,2,5,19,91
"CATCAAGCATTGCTGA",12,104,45,5,16,182,8697
"CATCAAGGTGGCTTAT",3,50,32,3,15,103,2338
"CATCAAGTCCGTGTCT",2,18,3,0,5,28,70
"CATCCACAGTGTACCT",69,223,349,53,433,1127,74456
"CATCCACCAAACGTGG",35,134,98,24,341,632,36112
"CATCCGTAGCCATTCA",16,162,62,15,73,328,18055
"CATCCGTAGTGGAAGA",179,107,65,17,49,417,21501
"CATCCGTTCGATAACC",19,60,27,5,15,126,3517
"CATCGCTAGATACTGA",19,150,63,14,126,372,17074
"CATCGCTAGCCAAGGT",0,10,2,0,6,18,56
"CATCGCTTCTATCGGA",13,132,41,8,67,261,13397
"CATCGGGCAGAAATTG",8,41,16,5,11,81,1432
"CATCGGGGTGAATTAG",4,52,23,4,17,100,2300
"CATCGGGGTTGTCCCT",5,33,31,0,10,79,1492
"CATCGGGTCCGTGGGT",5,30,24,0,17,76,1426
"CATCGGGTCGAAGTGG",19,73,128,5,37,262,15411
"CATCGGGTCTGACAGT",6,48,24,6,42,126,5150
"CATCGTCCAACATACC",45,162,479,37,75,798,47930
"CATGAGTAGTAGGGTC",14,139,52,15,30,250,9195
"CATGCAAAGGAAAGTG",34,119,294,15,67,529,29668
"CATGCAATCCGAACGC",24,192,78,165,52,511,25446
"CATGCCTGTCCGGTCA",3,46,26,0,12,87,3691
"CATGCCTTCACTTGTT",63,204,635,50,139,1091,73481
"CATGCCTTCCGGACGT",1,25,19,2,9,56,768
"CATGCCTTCCTCAGGG",28,114,222,15,48,427,21371
"CATGCCTTCGTCAGAT",217,1887,516,140,353,3113,178104
"CATGCGGCAGAAATTG",32,192,81,163,61,529,22446
"CATGCGGGTCGTCATA",14,176,54,9,29,282,11722
"CATGCGGGTTCGGTCG",22,111,329,27,53,542,38514
"CATGCTCGTGACTCGC",583,234,151,50,109,1127,56493
"CATGCTCTCATCGCAA",27,117,157,31,230,562,32236
"CATGGATAGCCTTTGA",0,6,3,0,0,9,23
"CATGGATAGTCTCGTA",3,20,10,0,6,39,108
"CATGGATCACATGTTG",8,56,31,5,13,113,3018
"CATGGATGTGCAACGA",23,64,151,15,35,288,14400
"CATGGATGTGCCAAGA",1,12,10,3,2,28,531
"CATGGATTCAAGAAAC",3,64,24,7,20,118,2501
"CATGGTACAATAGAGT",4,17,12,3,6,42,437
"CATGGTATCGTAACTG",7,62,36,6,15,126,2514
"CATTCATAGGGCGAGA",54,236,86,27,66,469,18261
"CATTCATCATGTGGCC",12,55,21,3,11,102,3581
"CATTCATGTACCTGTA",17,83,153,12,58,323,20614
"CATTCATTCCGCTAGG",27,130,48,13,34,252,10987
"CATTCATTCTGTGCGG",29,157,222,16,59,483,27626
"CATTCCGTCCCGTGAG",9,123,37,11,25,205,7521
"CATTCTACAAGAGTAT",72,181,56,13,49,371,18131
"CATTCTATCATCTGTT",4,17,10,2,7,40,498
"CATTCTATCGGAGTAG",5,48,34,3,24,114,2158
"CATTGAGAGAAGATCT",3,15,10,0,5,33,89
"CATTGAGCAATGGGTG",67,240,636,52,308,1303,89207
"CATTGAGGTCTGTGCG",6,73,30,2,19,130,3399
"CATTGCCCATCCTCAC",0,13,6,0,4,23,81
"CATTGTTCAAGCGAAC",6,66,31,11,45,159,5372
"CATTGTTCAGGACTTT",31,248,126,23,57,485,25617
"CATTGTTTCCATATGG",4,63,31,4,15,117,2991
"CCAAGCGCAAAGGCAC",19,86,44,7,38,194,7254
"CCAAGCGCACTGCGTG",31,259,128,26,51,495,24977
"CCAAGCGGTCTGTCAA",1,12,0,0,0,13,74
"CCAAGCGTCGAATCCA",4,39,73,6,11,133,3528
"CCAAGCGTCGCTTACC",7,60,177,9,29,282,6608
"CCAATGAAGAGAGGTA",9,67,33,2,8,119,2466
"CCAATGACAATCTCTT",1,15,5,0,5,26,145
"CCAATTTAGGACTGGT",1,52,33,2,23,111,3029
"CCAATTTCAGGGAGAG",102,902,274,77,182,1537,84192
"CCACAAATCTGTCCCA",6,68,30,26,14,144,5814
"CCACACTAGAGGTGCT",21,168,55,11,31,286,11304
"CCACGAGGTGCATGTT",49,147,327,43,151,717,43771
"CCACGTTAGTTACGTC",23,237,74,14,45,393,20769
"CCACGTTGTACAGAAT",5,45,23,2,16,91,1936
"CCACGTTGTTTGCAGT",7,25,9,2,7,50,399
"CCACGTTTCCGCCTAT",22,95,48,11,25,201,7586
"CCACGTTTCTTTGCTA",9,110,33,9,30,191,4479
"CCACTTGAGACCAAGC",6,70,33,7,23,139,3006
"CCACTTGGTGATAGTA",1,23,7,0,8,39,154
"CCACTTGGTGCAGATG",64,526,155,169,121,1035,59753
"CCATAAGAGGATATAC",137,470,169,52,198,1026,43554
"CCATAAGAGTTGAATG",19,113,51,85,41,309,12960
"CCATAAGTCAGCTCTC",1,18,8,0,7,34,1001
"CCATAAGTCCGTAGTA",95,922,272,73,171,1533,82280
"CCATCACAGGTAAGTT",11,59,52,3,24,149,4940
"CCATCACCAAGCAGGT",1,10,4,0,0,15,84
"CCATCACCATGGGAAC",37,127,160,28,228,580,34792
"CCATCACTCAGGAAAT",30,268,76,24,55,453,20109
"CCCAACTCAGGTTTAC",29,97,140,17,190,473,31673
"CCCAACTGTTACACTG",0,12,4,0,0,16,737
"CCCAACTTCCGTGACG",69,232,585,53,381,1320,92804
"CCCATTGCAAGCCATT",6,41,44,5,35,131,6660
"CCCATTGGTATCGTGT",15,86,98,10,27,236,9751
"CCCGAAGAGTCTTCGA",17,194,53,8,39,311,11132
"CCCGAAGCAACAGATA",9,58,27,14,16,124,2929
"CCCGAAGCAAGCTGCC",18,104,148,14,29,313,16872
"CCCGAAGCATGGTACT",16,72,118,9,70,285,14508
"CCCGAAGGTGGTCTAT",2,10,4,0,0,16,39
"CCCGAAGTCGTTTACT",0,8,2,0,2,12,133
"CCCGGAACAGACACAG",1,8,4,0,0,13,85
"CCCTCAAGTAGTTCCA",16,59,49,6,25,155,6452
"CCCTCTCAGTCGCCCA",0,23,17,0,4,44,1232
"CCCTCTCCATTCCTAT",4,16,8,0,4,32,619
"CCCTCTCGTAAGATAC",154,154,146,28,176,658,35357
"CCCTCTCGTACGATCT",27,111,253,24,52,467,29644
"CCCTGATAGCAGTAAT",12,88,39,6,18,163,3622
"CCCTGATCAAACCACT",6,48,19,3,5,81,2635
"CCCTGATCACGGCACT",16,117,35,9,25,202,10991
"CCGAACGAGAGATGCC",10,60,90,4,32,196,10267
"CCGAACGCATCGCCTT",2,24,13,5,24,68,1480
"CCGAACGGTGAGTTGG",62,199,342,59,532,1194,80987
"CCGATCTAGAGAGCGG",6,24,11,4,6,51,1097
"CCGATCTTCCATGATG",69,643,154,43,118,1027,59929
"CCGATGGAGTTGGGAC",52,536,142,38,92,860,41382
"CCGATGGCACTCGATA",23,82,205,16,42,368,19765
"CCGATGGTCCAAAGGG",6,31,37,5,10,89,3558
"CCGCAAGGTCGTTATG",5,48,26,6,22,107,1578
"CCGCAAGGTCTTTATC",17,139,60,13,40,269,13234
"CCGGACAAGTACTGGG",12,88,27,19,25,171,5212
"CCGGACAAGTAGGAAG",17,168,52,34,37,308,14033
"CCGGACACACAGTGAG",8,59,30,5,61,163,6783
"CCGGACACAGGGCTTC",36,289,90,38,63,516,24957
"CCGGACAGTTCGAGCC",2,17,9,2,2,32,222
"CCGGACATCGCCGTGA",8,45,43,4,17,117,3396
"CCGGTAGGTATGAGGC",29,106,191,25,45,396,17654
"CCGGTGAAGTACTGGG",3,24,7,2,8,44,446
"CCGGTGACACCCTATC",2,12,9,0,0,23,572
"CCGTAGGAGATAACGT",1,29,11,0,11,52,172
"CCGTAGGAGCATCCTA",19,134,169,19,51,392,18688
"CCGTGAGCATAACAGA",7,65,61,5,21,159,8810
"CCGTGAGGTTAAGGAT",1,3,5,0,3,12,252
"CCGTGAGTCGCTACAA",18,254,54,12,36,374,18919
"CCGTTCAAGTCAACAA",52,195,373,52,308,980,59377
"CCGTTCACAACGTTAC",23,244,69,22,60,418,21042
"CCGTTCATCTTCCGTG",81,718,221,54,159,1233,64186
"CCTAACCAGCAAACAT",56,165,67,14,44,346,16532
"CCTAACCCAGGTCCCA",21,75,39,5,18,158,5111
"CCTAACCCAGTAACCT",4,45,20,2,18,89,3245
"CCTAACCTCCGAGATT",25,154,58,9,37,283,12788
"CCTAACCTCGTTGTGA",11,95,53,5,19,183,6551
"CCTAAGATCGCTGTTC",116,1257,336,109,233,2051,123302
"CCTACGTCAGCATCTA",10,72,43,3,17,145,4027
"CCTACGTGTCCATACA",13,61,34,7,64,179,7058
"CCTACGTGTGACCGTC",13,65,89,7,20,194,9221
"CCTACGTTCATCACAG",54,548,137,48,111,898,47274
"CCTACGTTCATTGTGG",3,51,20,0,14,88,2014
"CCTACGTTCTGACCCT",0,0,0,0,2,2,6
"CCTATCGGTACGATTC",122,307,100,26,69,624,34845
"CCTATCGGTGATAGAT",4,33,14,0,28,79,3159
"CCTATCGGTTCAAGTC",20,326,92,17,65,520,24038
"CCTCAACCAATCTAGC",8,65,45,8,18,144,6896
"CCTCAACTCGAAGTGG",15,53,76,4,29,177,9446
"CCTCACAAGGTCGTCC",11,37,25,2,5,80,1883
"CCTCAGTAGTCACTAC",1,12,2,2,6,23,118
"CCTCAGTCACGTATAC",0,7,8,2,4,21,78
"CCTCATGCAAATCAGA",15,130,32,6,24,207,8607
"CCTCATGTCCAATCTT",13,58,60,7,62,200,10139
"CCTCCAAGTCCGGACT",10,69,90,10,30,209,13318
"CCTCCAATCTACAGGT",1,24,4,0,0,29,1128
"CCTCCTCAGTAGATCA",8,42,78,8,21,157,10589
"CCTCCTCCAGAGGACT",7,22,14,4,10,57,528
"CCTCTAGAGTCACTAC",7,69,45,10,50,181,5324
"CCTCTAGCATCACAGT",10,85,66,6,108,275,11373
"CCTCTCCAGACTACGG",7,30,13,4,18,72,2198
"CCTCTCCCAATCGTCA",4,51,27,6,23,111,2721
"CCTCTCCGTCATCCCT",0,4,6,0,2,12,110
"CCTGCATCAGAATGTA",28,263,69,18,52,430,21045
"CCTGCATCAGGGCTTC",14,80,62,11,92,259,13663
"CCTGCATGTGGTCAAG",10,77,60,8,28,183,5169
"CCTGCATTCACCGGGT",22,68,35,5,86,216,10205
"CCTGTTGAGCTCGTGC",31,114,282,20,52,499,29630
"CCTGTTGCATCGTTCC",27,104,220,20,41,412,24263
"CCTGTTGTCTCGCTCA",4,63,17,6,19,109,3871
"CCTTCAGAGATGACAT",79,218,797,53,144,1291,92200
"CCTTCAGCAGAGCCCT",11,51,47,5,17,131,4929
"CCTTGTGCAACAACAA",8,55,33,11,13,120,1954
"CCTTGTGCATTGACAC",2,50,20,6,21,99,1895
"CCTTGTGGTAGACACG",20,95,53,18,218,404,25106
"CCTTGTGTCTACGCGG",19,189,48,8,32,296,14533
"CCTTTGGAGTCGAAAT",10,86,22,8,20,146,4449
"CCTTTGGCAGAAGCGT",13,73,36,14,23,159,5036
"CGAAGTTGTGTTAGCT",33,145,435,38,86,737,47810
"CGAAGTTGTTCGAACT",14,71,27,4,12,128,2314
"CGAATTGAGGTAAACT",1,36,35,2,27,101,3368
"CGAATTGGTGGGCTTC",3,36,27,4,14,84,2063
"CGACAGCAGCCACTCG",14,101,70,14,196,395,20026
"CGACAGCGTGGGACAT",8,106,33,11,19,177,5607
"CGAGAAGAGTCTAACC",1,17,7,0,7,32,150
"CGAGAAGCACACAGCC",8,69,38,6,27,148,5567
"CGAGGCTAGGCTAAAT",9,56,56,3,15,139,5634
"CGAGGCTCACAACGCC",18,206,48,18,29,319,14401
"CGAGTGCAGTTGGACG",23,339,77,23,87,549,28064
"CGAGTGCCAAACCATC",4,30,20,0,9,63,2590
"CGAGTGCCAACCGTGC",8,86,38,4,69,205,12165
"CGAGTGCGTGTTCAGT",6,51,20,6,14,97,1925
"CGAGTTACATCGCCTT",4,44,22,0,22,92,2157
"CGATCGGAGGAGAATG",2,19,10,3,10,44,569
"CGATCGGAGGTGATAT",24,85,128,20,131,388,22659
"CGATGCGAGGGCCAAT",21,234,85,16,42,398,17846
"CGATGCGAGTTTGCTG",2,27,12,0,8,49,169
"CGATGGCTCCCTCGTA",29,37,24,2,15,107,3077
"CGATGGCTCGGACGTC",5,53,23,4,11,96,1385
"CGCAGGTCAAGGATGC",2,13,4,0,3,22,64
"CGCAGGTTCTATACTC",15,143,62,12,29,261,13111
"CGCATAACATAGATGA",3,15,12,2,5,37,485
"CGCATGGGTCCTACGG",17,103,196,14,39,369,18607
"CGCATGGGTTCCTACC",33,132,401,24,59,649,33282
"CGCATGGTCCTTTGAT",1,14,5,0,6,26,405
"CGCCAGACAACACGAG",16,68,123,11,28,246,9869
"CGCCATTAGGATACGC",3,50,38,0,17,108,4323
"CGCCATTCAGGCGTTC",6,54,23,25,9,117,3040
"CGCCATTGTTCTCTCG",1,51,23,4,5,84,1872
"CGCCATTTCCGAAATC",31,231,78,28,47,415,16615
"CGCGTGACACGCTTAA",51,193,91,13,38,386,17730
"CGGAACCCAGTCACGC",62,215,460,45,324,1106,54575
"CGGAATTCATCGTTCC",10,57,45,7,53,172,4869
"CGGAATTTCACAGTGT",104,499,137,31,95,866,42957
"CGGACACAGAGCTGAC",7,63,32,11,16,129,1595
"CGGACACTCGGACTGC",6,47,39,4,15,111,2965
"CGGACACTCTCGCTCA",1,2,2,0,2,7,80
"CGGAGAACAAGTACCT",9,56,70,6,23,164,8781
"CGGAGAACACGTCATA",15,148,70,8,30,271,13329
"CGGCAGTAGATCGACG",32,406,92,32,63,625,29521
"CGGCAGTCAGCTTTCC",23,101,253,20,51,448,23700
"CGGGACTAGGAAACGA",5,64,77,6,16,168,8084
"CGGGACTCAATGTGGG",18,111,71,13,35,248,8585
"CGGGACTGTCTTGCTC",1,40,15,4,8,68,2720
"CGGGCATCACAAAGCG",2,23,20,4,4,53,3185
"CGGGTCAGTTCGGACC",20,84,103,12,94,313,16600
"CGGGTCATCTCTAAGG",0,3,2,0,0,5,38
"CGGGTCATCTTGGAAC",21,74,125,14,34,268,13552
"CGGTCAGAGGCCTAAG",51,491,135,34,92,803,43111
"CGGTCAGGTTGCTAGT",31,85,33,8,23,180,5672
"CGTAATGGTTGTCTAG",10,51,34,5,23,123,2900
"CGTAATGTCATCAGTG",52,165,321,45,321,904,61379
"CGTAGTAGTCCTGGTG",12,63,47,4,21,147,4878
"CGTAGTAGTTCGTACA",12,72,93,11,49,237,11333
"CGTAGTAGTTGCCAAT",18,144,43,17,21,243,8144
"CGTAGTATCGCATTGA",14,72,34,2,59,181,9558
"CGTAGTATCGGCCTTT",2,24,12,0,4,42,238
"CGTAGTATCTCGCTTG",774,321,210,69,153,1527,76769
"CGTCAAACAAGGCCTC",9,49,20,44,21,143,4541
"CGTCCATAGTTTGCTG",107,70,30,5,33,245,8501
"CGTCCATCAATAGAGT",66,718,258,55,135,1232,61309
"CGTCCATGTATCCTTT",26,61,19,5,25,136,3508
"CGTCCATTCTAGGAAA",6,58,44,8,105,221,8914
"CGTGAATCAATTGCGT",26,112,76,22,226,462,23255
"CGTGAATCACCGCTGA",19,169,44,10,37,279,9635
"CGTGAATGTCGGTGTC",20,60,23,3,17,123,3104
"CGTGAATTCATACGAC",8,43,27,3,18,99,1752
"CGTGAATTCCATGAGT",28,121,256,29,63,497,21686
"CGTGATAAGGATGAGA",3,4,0,0,3,10,17
"CGTGATAAGTAGTGCG",11,86,72,7,51,227,10599
"CGTGATATCGTCCTCA",12,164,51,19,35,281,9955
"CGTGCTTCAAGGATGC",11,17,11,5,7,51,856
"CGTGCTTCATCCGTTC",73,685,239,55,139,1191,51189
"CGTGCTTTCATTCTTG",12,93,41,9,17,172,2025
"CGTGCTTTCGTGCACG",1,30,7,0,9,47,683
"CGTGTCTCAAGCTGCC",19,203,52,4,40,318,13487
"CGTGTCTCAAGTGATA",0,7,2,0,0,9,24
"CGTGTCTCATCTTAGG",35,134,342,25,69,605,31106
"CGTGTCTGTATGCTTG",7,77,30,7,18,139,4408
"CGTGTCTGTCTAGATC",20,81,161,15,89,366,18211
"CGTTAGAAGATCGACG",8,50,24,22,11,115,2971
"CGTTAGACAGAGACTG",1,14,11,0,3,29,116
"CGTTAGACAGGGATAC",2,29,14,0,7,52,193
"CGTTAGAGTTGCGGAA",67,394,167,154,229,1011,44386
"CGTTCTGAGCAAATCA",20,117,52,15,164,368,18517
"CGTTCTGAGGCCACTC",6,10,6,0,4,26,1326
"CGTTGGGCACGGGCTT",13,77,48,18,125,281,12673
"CGTTGGGGTGGCCCAT",3,30,30,0,8,71,1868
"CGTTGGGGTGTTAAAG",9,31,97,3,22,162,11557
"CTAACCCAGGTAGATT",4,61,37,8,16,126,2371
"CTAACCCCAAACACCT",1,18,14,2,5,40,460
"CTAACCCGTTGGGTTT",38,333,90,21,61,543,33635
"CTAAGTGAGACAGTCG",534,227,144,142,107,1154,52616
"CTACAGAGTCTGTAAC",3,8,6,0,2,19,162
"CTACAGAGTGATCATC",20,87,187,7,50,351,17862
"CTACATTCATTGGGAG",7,121,37,9,27,201,7058
"CTACATTGTCGAAACG",19,140,38,14,27,238,10336
"CTACCCAAGTCTAACC",168,113,58,31,43,413,18334
"CTACCCATCTATCGGA",0,9,9,0,0,18,220
"CTACGGGAGAGGTCGT",21,44,27,38,18,148,2464
"CTACGGGTCCCGTGTT",5,21,33,2,8,69,2553
"CTACGGGTCGTCGACG",7,101,37,5,22,172,6589
"CTACTATGTCGAACGA",2,64,46,5,18,135,4280
"CTATAGGTCTCCCAAC",4,44,14,7,9,78,3448
"CTATCCGGTCGCACAC",5,55,30,4,16,110,2543
"CTATCTACATCGGAAG",2,30,14,5,5,56,141
"CTATCTAGTACCATAC",3,10,4,0,4,21,89
"CTCAACCTCAAGCCCG",4,91,32,9,16,152,5014
"CTCAAGATCGGTGTTA",90,254,998,81,175,1598,115241
"CTCAATTAGGTGATCG",7,69,60,4,19,159,6076
"CTCACTGCACGGTGTC",0,18,7,0,4,29,247
"CTCACTGGTAGGAGTC",50,360,126,32,357,925,45248
"CTCAGAAGTCCAGCGT",15,71,82,8,78,254,12832
"CTCAGAAGTCTTGAGT",2,43,21,5,12,83,1826
"CTCAGAAGTGGCTACC",14,76,33,7,73,203,8502
"CTCAGAATCGTTACCC",18,53,76,6,20,173,5571
"CTCAGTCCACCCTAAA",2,47,18,2,8,77,511
"CTCATCGAGGTTTACC",9,129,51,10,30,229,11174
"CTCATCGCAATTGAAG",8,59,41,5,43,156,9378
"CTCATCGGTATCAGCT",14,148,38,6,26,232,8728
"CTCATCGGTCTAGGTT",6,58,25,8,16,113,6576
"CTCATGCCAGGTCAAG",5,82,27,5,34,153,4460
"CTCATGCTCGCCAATA",14,68,140,16,33,271,15503
"CTCATTACATTCCTAT",19,206,63,12,54,354,16937
"CTCATTATCTATGCCC",12,73,24,3,22,134,5463
"CTCCAACAGTTGTAGA",14,77,34,23,19,167,5674
"CTCCAACCAACCAGAG",17,174,48,10,30,279,9559
"CTCCAACCAATCGCCG",89,96,52,8,28,273,10251
"CTCCAACCACGTAGTT",44,134,90,333,67,668,33956
"CTCCAACTCACAAGGG",60,217,229,47,549,1102,55951
"CTCCACACAAAGTATG",13,69,57,4,27,170,5102
"CTCCACAGTGCTCTTC",39,111,39,10,23,222,10822
"CTCCATGTCAAAGAAC",13,159,68,14,29,283,11753
"CTCCCAAAGGCTCTAT",21,107,219,15,52,414,25881
"CTCCCTCCAAGAGGCT",20,80,54,8,117,279,14948
"CTCCGATCATGCCGGT",5,21,12,3,13,54,1089
"CTCCGATTCCCTCTTT",22,70,26,3,21,142,4478
"CTCCGATTCTGCGGGT",17,171,40,11,39,278,16122
"CTCCTCCAGATGAATC",12,91,52,11,135,301,13952
"CTCCTCCGTGGAAATT",18,102,177,20,52,369,19396
"CTCCTTTAGTCTCTGA",4,64,17,2,11,98,6071
"CTCCTTTCACAAATCC",8,54,16,3,9,90,3324
"CTCTCAGAGGTACATA",4,19,35,2,10,70,2606
"CTCTCAGTCCAAGCTA",3,12,7,0,3,25,1155
"CTCTCGAAGAATTTGG",7,41,16,4,35,103,2640
"CTCTCGAAGCGATGGT",2,17,13,0,2,34,600
"CTCTCGACAACCGGAA",11,57,52,7,55,182,7671
"CTCTCGACAATCTAGC",291,612,275,665,242,2085,122645
"CTCTCGACACCTCGTT",4,50,19,5,9,87,3544
"CTCTCGAGTGTAACGG",7,53,26,5,20,111,2503
"CTCTGGTCACGAGGAT",1,9,9,0,3,22,116
"CTGAATGCACCCTCTA",30,72,43,7,26,178,6588
"CTGAATGGTCTACATG",1,58,32,3,19,113,3199
"CTGAATGGTGTTGCCG",11,55,35,53,16,170,7428
"CTGAATGTCTGTACAG",9,73,45,6,38,171,5438
"CTGAGCGAGCTGACAG",54,267,328,44,390,1083,67500
"CTGAGCGAGGGAGGCA",0,8,0,0,0,8,32
"CTGAGCGCACAGTCAT",6,40,19,2,7,74,1799
"CTGAGGCAGTGACCTT",2,6,4,0,4,16,43
"CTGAGGCTCATCGGGC",13,78,67,11,68,237,8889
"CTGATCCGTAGCGATG",4,40,24,0,14,82,2611
"CTGATCCTCGCCGAAC",22,256,87,13,68,446,16705
"CTGCAGGCAAGCTACT",3,52,20,0,16,91,2504
"CTGCATCAGCTGACAG",23,141,83,25,266,538,25441
"CTGCATCCAACCACAT",71,690,158,49,130,1098,56532
"CTGCATCCAAGGTCGA",9,118,38,9,27,201,8544
"CTGCATCCATAGGAGC",18,81,36,0,11,146,4668
"CTGCATCCATTGTGCA",17,75,45,91,37,265,10745
"CTGCCATCACCAACAT",0,18,11,0,3,32,142
"CTGCCATGTGTGATGG",160,1510,390,162,358,2580,147540
"CTGCCTAGTCCAGCCA",1,0,4,0,0,5,25
"CTGCCTAGTGTTCGAT",3,20,16,4,8,51,153
"CTGCCTATCTAGCAAC",27,350,110,17,61,565,29842
"CTGCGAGAGATTGAGT",34,142,357,29,64,626,40636
"CTGCGAGAGGCTAAAT",26,278,60,15,55,434,27729
"CTGCGAGCATCCGAAT",2,11,7,2,2,24,109
"CTGCGAGGTGCGTTTA",2,21,15,2,19,59,2701
"CTGCGAGGTTTCACAG",25,98,58,19,254,454,27194
"CTGCTCACATTGGGAG",33,52,25,5,13,128,5113
"CTGGACGAGGCGATAC",16,169,52,10,35,282,11788
"CTGGACGAGGTAAGAG",1,11,4,2,3,21,90
"CTGGACGGTCGCGTCA",14,61,87,8,28,198,6649
"CTGGCAGCACTGTGTA",10,82,46,57,22,217,7932
"CTGGCAGCATGACACT",21,90,36,8,24,179,4677
"CTGGTCTTCTCGTCAC",60,77,41,12,25,215,6841
"CTGTACCGTTCATCGA",7,65,28,6,21,127,3269
"CTGTAGAGTATGATCC",22,124,116,24,155,441,26111
"CTGTAGAGTCACTCAA",1,12,5,0,4,22,145
"CTGTAGAGTTGCCAAT",5,63,28,0,19,115,3081
"CTGTATTCAATGGGTG",3,11,0,0,7,21,284
"CTGTCGTAGCAATTCC",53,180,544,43,112,932,62668
"CTGTCGTCAACAGAGC",48,415,309,35,104,911,50726
"CTGTCGTCATTACTCT",4,44,22,2,11,83,3055
"CTGTCGTGTACGGTTT",15,23,19,4,7,68,1585
"CTGTCGTGTCTCCCTA",2,23,12,0,14,51,1573
"CTTACCGAGACCAGAC",11,68,112,17,26,234,11193
"CTTACCGAGCTAGCCC",31,180,335,20,75,641,34764
"CTTACCGCACTAGAGG",9,49,49,7,44,158,6002
"CTTACCGGTATTTCGG",0,13,5,0,0,18,67
"CTTACCGTCCAGTGCG",1,15,4,0,0,20,157
"CTTAGGATCAGCTGTA",0,13,7,0,5,25,88
"CTTAGGATCTCTCCGA",0,7,3,0,2,12,78
"CTTCAATAGACTGGGT",19,98,61,13,173,364,20775
"CTTCAATTCGGAAACG",31,116,189,17,47,400,21828
"CTTCCTTAGGGCAGTT",9,63,75,10,26,183,8926
"CTTCGGTCAGTGTACT",7,47,35,3,20,112,2690
"CTTCTAAAGCATCCCG",0,2,0,0,0,2,18
"CTTCTAAGTCAACACT",20,274,72,24,56,446,21945
"CTTCTAATCAGTGTCA",10,21,15,0,9,55,1585
"CTTCTCTCAGTTAAAG",32,120,77,106,43,378,17423
"CTTGAGAAGCCAGACA",0,8,0,0,0,8,107
"CTTGAGACATTCAGGT",22,94,54,14,135,319,17353
"CTTGAGATCACGGACC",106,112,56,10,38,322,10716
"CTTGATTAGTATCCTG",2,14,11,0,4,31,311
"CTTGATTCAATCGTCA",52,410,198,40,103,803,38215
"CTTTCAAGTTCGGACC",22,136,75,15,201,449,20956
"CTTTCGGAGGCCCGTT",31,94,38,9,27,199,7195
"CTTTCGGAGTGCGCTC",4,23,9,0,3,39,89
"CTTTCGGAGTGGAAGA",7,90,31,8,17,153,5012
"CTTTCGGTCTTCTGGC",3,20,14,0,3,40,728
"GAAACCTCAAATTGCC",21,54,23,2,13,113,2541
"GAAACCTCACTTGACA",5,64,20,3,9,101,2754
"GAAACCTCACTTGGCG",88,277,1005,63,162,1595,109718
"GAAACCTCAGCTGTTA",16,75,42,10,21,164,3589
"GAACACTAGGGAGATA",12,67,36,10,63,188,7151
"GAACACTGTTTCTTAC",1,16,7,0,4,28,209
"GAACGTTAGAGTCGAC",34,319,82,14,56,505,23546
"GAACGTTAGTACTGGG",37,95,54,9,103,298,14445
"GAACGTTCATGATGCT",146,151,90,26,49,462,22451
"GAACTGTCACATTCTT",43,148,333,28,76,628,35564
"GAAGCCCGTTGGCCTG",60,180,66,11,34,351,11462
"GAAGCGACAGCGTATT",31,92,157,19,165,464,26575
"GAAGCGAGTAGATGTA",8,35,18,30,13,104,4590
"GAAGCGAGTGCAGGAT",89,896,215,61,168,1429,84385
"GAAGCGAGTTTCACTT",7,49,40,4,11,111,2822
"GAAGGGTAGTCATGAA",8,69,24,8,28,137,3709
"GAAGGGTCATACCAGT",25,78,118,10,62,293,13452
"GAAGGGTCATGAGGGT",3,20,19,0,7,49,835
"GAAGGGTTCACCGGTG",18,99,124,12,34,287,14913
"GAAGTAACAGGACGAT",26,109,224,18,45,422,27945
"GAATAGAAGACCTTTG",4,21,17,2,5,49,365
"GAATCACGTCGGCTAC",2,38,31,0,12,83,1002
"GAATCACTCCATTGGA",27,142,174,26,182,551,31013
"GAATCACTCGGTTGTA",28,247,119,26,61,481,20245
"GAATCACTCTCGCAGG",10,85,34,5,26,160,5316
"GAATCGTAGCTTACGT",149,479,174,337,134,1273,71025
"GAATCGTTCCGGTAAT",62,199,558,37,110,966,68596
"GACAGCCAGTCATAGA",0,20,7,2,5,34,417
"GACAGCCTCACGATAC",9,100,38,11,22,180,4519
"GACAGCCTCTCCAAGA",8,45,12,0,20,85,1463
"GACATCAAGTAGCTCT",29,244,67,15,47,402,17438
"GACATCACAATCTAGC",13,66,62,9,19,169,5929
"GACATCATCACGTAGT",1,19,7,2,4,33,781
"GACCAATAGAGGTCGT",27,88,44,7,19,185,6368
"GACCCAGGTTATGTGC",31,120,132,19,260,562,35218
"GACCCTTCATCCCACT",25,115,66,10,198,414,22330
"GACCCTTCATGACGAG",2,54,51,4,22,133,3004
"GACCCTTGTGGCTGAA",26,188,60,14,35,323,12940
"GACCCTTTCGAACTCA",6,32,13,3,6,60,1163
"GACCGTGAGGCTTAAA",20,105,54,109,32,320,15174
"GACCGTGAGTCTTGGT",17,162,42,12,30,263,10079
"GACCTTCCAACACAAA",9,66,36,6,103,220,8618
"GACGCTGGTAGAGACC",34,56,26,3,28,147,4469
"GACGCTGTCATCTCTA",45,144,93,31,328,641,35191
"GACGCTGTCGAATGCT",12,60,45,2,95,214,5667
"GACGTTAAGTGATAGT",11,96,140,11,42,300,13539
"GACTATGAGGTATCTC",21,85,48,11,69,234,9123
"GACTATGCAAATAAGC",3,57,34,4,15,113,1746
"GACTCAAAGCAGATAT",9,72,43,10,23,157,2082
"GACTCAAAGTCAGAGC",218,1439,459,142,258,2516,122061
"GACTCAACAGCTTCCT",1,26,7,0,2,36,450
"GACTCAAGTGAGTTGG",9,32,23,66,19,149,7474
"GACTCAAGTGTCATTG",12,50,39,4,22,127,2913
"GACTGATCAAGGCTTT",14,74,79,12,21,200,8027
"GACTGATCATTGAGGG",78,616,232,71,136,1133,62325
"GACTTCCCAAGAGGTC",11,154,30,14,40,249,12195
"GAGACCCAGCCGGAAT",6,42,14,3,9,74,2874
"GAGACCCGTCCTGTCT",6,69,35,4,18,132,4475
"GAGACCCTCGCATTGA",20,49,23,5,31,128,3090
"GAGAGGTGTTCCGGTG",5,44,18,5,10,82,2653
"GAGATGGCAGCATTGT",10,116,39,7,34,206,7109
"GAGATGGTCGATGCAT",0,8,4,0,2,14,363
"GAGCCTGAGTGCAGGT",30,268,67,22,50,437,22567
"GAGCCTGCAAATGATG",82,250,929,52,170,1483,100834
"GAGCCTGGTAGGTAGC",10,76,33,6,19,144,4472
"GAGCCTGTCCTATGGA",14,61,30,29,20,154,2990
"GAGCCTGTCTTCACGC",41,364,340,35,106,886,56635
"GAGCTGCAGGGACAGG",14,63,28,2,12,119,3083
"GAGCTGCCAGCATTGT",10,109,40,4,28,191,7827
"GAGGCAAAGCTAGATA",5,46,24,6,17,98,2869
"GAGGCCTCAGCTGAAG",12,91,27,7,20,157,7697
"GAGGCCTGTGTTGATC",44,131,246,27,225,673,42476
"GAGGCCTTCACGATCA",28,106,324,20,65,543,31167
"GAGGGATAGACCACGA",10,91,42,2,28,173,2831
"GAGGGATTCCATGATG",1,3,8,0,0,12,68
"GAGGGTAAGCTATCCA",3,13,3,3,5,27,1315
"GAGGGTAAGCTTCATG",11,71,117,7,27,233,11913
"GAGGGTACAAACAGGC",8,61,33,3,30,135,2879
"GAGGGTACAAGCTCTA",4,15,5,0,12,36,531
"GAGGGTACATCAGCAT",31,296,78,18,64,487,26513
"GAGTCATGTACGAAAT",111,1135,269,74,213,1802,92261
"GAGTCATGTGAACTAA",2,11,5,4,32,54,1971
"GAGTCATTCTTTGGAG",14,87,50,7,28,186,6938
"GAGTCTAGTATGACAA",5,80,33,5,15,138,3403
"GAGTCTAGTGTATTCG",17,68,95,9,27,216,9310
"GAGTCTATCCACACCT",1,44,17,2,8,72,415
"GAGTGAGCAACTAGAA",17,106,30,4,27,184,5640
"GAGTGTTCAAGCGCAA",0,12,4,0,4,20,114
"GAGTTACCAGCAGTAG",2,20,7,2,6,37,869
"GAGTTACGTAGAATGT",22,103,175,20,36,356,20546
"GAGTTACTCTCTGCTG",17,93,140,13,47,310,14713
"GAGTTGTAGGGTACAC",0,10,3,0,4,17,45
"GAGTTGTGTACCATAC",24,266,63,18,47,418,17768
"GAGTTGTTCGTAGGAG",24,248,88,18,57,435,18743
"GAGTTTGAGAGAGGTA",61,208,569,37,164,1039,74935
"GAGTTTGCACAACGAG",9,89,23,4,21,146,3537
"GAGTTTGTCCGCACGA",42,400,113,25,77,657,33921
"GATAGAATCAACGAGG",35,122,320,24,64,565,29088
"GATAGCTAGATTGTGA",14,86,30,11,26,167,9021
"GATAGCTCAGGTCCGT",3,46,40,2,26,117,3039
"GATCACACAAGATGTA",5,71,93,8,21,198,8205
"GATCACAGTGGCGCTT",12,132,40,11,24,219,6528
"GATCAGTCAATCCAGT",17,176,70,10,35,308,10879
"GATCAGTTCAAAGCCT",11,47,28,10,18,114,2601
"GATCAGTTCATGCCAA",7,117,45,6,30,205,5342
"GATCATGAGGAAAGTG",12,86,46,6,16,166,3468
"GATCATGAGTGTTCAC",3,17,9,2,2,33,651
"GATCATGCAGTGTGGA",32,131,290,19,72,544,31675
"GATCCCTCACGACGTC",21,60,182,10,44,317,21324
"GATCCCTTCTGCGAGC",74,229,626,59,398,1386,85480
"GATCGTAAGATCCAAA",3,40,25,0,21,89,1788
"GATCGTAAGCCGAACA",2,18,8,2,5,35,934
"GATCGTAAGGCGTCCT",1,11,2,0,14,28,167
"GATCGTACAGCTACCG",42,595,138,46,108,929,56450
"GATGACTAGGGTCTTT",4,85,39,14,20,162,3704
"GATGATCGTACCGTGC",4,16,4,0,8,32,698
"GATGATCTCGCGTCGA",17,74,158,10,36,295,5594
"GATGCTATCCTCAGGG",23,111,242,23,52,451,28577
"GATGCTATCGAGTGAG",142,1183,264,104,222,1915,106543
"GATGGAGGTATGAGCG",120,1014,265,93,204,1696,88928
"GATGGAGTCGAGTCTA",73,778,183,54,134,1222,63518
"GATGGAGTCTGAATCG",8,69,16,2,15,110,2912
"GATGTTGGTTGAGAGC",38,137,383,33,82,673,43368
"GATGTTGTCATGGGAG",5,45,22,3,8,83,1355
"GATGTTGTCTCCAATT",58,143,51,17,34,303,11875
"GATTCGAAGAGATGCC",22,197,56,13,34,322,17136
"GATTCGAGTGCTTATG",11,93,106,9,56,275,12411
"GATTCGATCAAGAGGC",27,328,71,19,51,496,28096
"GATTCTTAGAAACTGT",4,20,6,16,8,54,1522
"GATTCTTCAGGCTTGC",14,81,41,6,20,162,4612
"GATTGGTAGCACGGAT",16,90,157,7,34,304,18636
"GATTTCTAGTTCATGC",22,197,65,16,39,339,21100
"GATTTCTTCCAATGCA",2,49,26,0,8,85,1074
"GATTTCTTCTTCTAAC",16,125,50,9,28,228,9063
"GCAACATGTCACTTCC",32,110,249,19,54,464,31981
"GCAACATTCTCCGTGT",1,10,6,0,2,19,38
"GCAACCGAGTGAGCCA",9,56,48,3,18,134,4267
"GCACATAAGTCGAAGC",20,121,155,21,175,492,26904
"GCACATAGTCGCATCG",6,56,20,0,16,98,1579
"GCACATATCGAGATGG",19,90,82,15,125,331,15365
"GCACGGTTCTGTCGTC",0,10,5,0,5,20,42
"GCACGTGAGTAGGTTA",32,100,54,12,25,223,5824
"GCACGTGGTCAGTCCG",1,14,5,2,7,29,95
"GCACTAAAGAGGTCGT",11,141,48,8,31,239,7966
"GCACTAAAGATCCAAA",2,22,5,0,6,35,111
"GCACTAACAGAGGAAA",2,23,5,0,5,35,249
"GCAGCCAAGAGTATAC",9,120,45,11,31,216,8519
"GCAGCCATCTCCAAGA",7,61,26,3,23,120,1963
"GCAGCTGTCAGCGCGT",2,42,24,5,14,87,1737
"GCAGGCTAGGGCTTCC",1,47,32,5,11,96,2473
"GCAGGCTTCTTCGATT",3,11,8,0,0,22,341
"GCAGTTAAGACAACTA",19,180,59,12,39,309,11469
"GCAGTTAGTTGCTAGT",15,61,28,8,21,133,6271
"GCATCGGCAGAGACTG",138,62,34,8,41,283,9685
"GCATCTCCACGGTAGA",42,138,447,28,81,736,45291
"GCATGATAGTTCACTG",2,58,43,6,15,124,3573
"GCATGATGTGCAACAG",18,82,73,5,22,200,7276
"GCATTAGCATACCGTA",13,83,49,9,82,236,9357
"GCCAACGCAAGCCATT",5,41,18,3,8,75,1741
"GCCAACGCAGTAACGG",19,280,80,19,63,461,23334
"GCCAACGGTCGTGTTA",13,123,29,7,21,193,5584
"GCCAACGTCATGCCCT",28,63,41,12,24,168,3638
"GCCAACGTCGCCGAAC",6,53,22,4,15,100,1552
"GCCAACGTCGGATAAA",0,9,0,0,2,11,539
"GCCAGCACAGTCAGTT",7,91,35,8,18,159,5099
"GCCAGGTGTTCTCACC",19,37,19,6,11,92,2353
"GCCAGTGCAAGTGGGT",1,16,5,0,4,26,417
"GCCAGTGCAGATCACT",8,66,28,6,13,121,4159
"GCCAGTGTCGAGTCCG",10,70,33,2,15,130,1404
"GCCAGTGTCTGATTCT",162,1114,291,90,224,1881,84324
"GCCATGGCACGGTGTC",6,102,26,4,18,156,4736
"GCCATGGGTAGAATAC",13,81,145,12,44,295,9774
"GCCATGGGTCGCAACC",71,27,19,7,15,139,4728
"GCCATTCTCATGAAAG",35,308,86,21,60,510,21078
"GCCCAGAAGAGGACTC",82,301,719,47,313,1462,91938
"GCCCAGATCAAACGTC",19,78,194,14,40,345,18179
"GCCCGAAAGCTGACCC",30,104,230,10,33,407,22171
"GCCGATGAGTAACCGG",8,74,70,5,27,184,7963
"GCCGATGTCCGATCGG",87,138,89,333,80,727,33263
"GCCGTGACAAGCGCAA",1,5,0,0,6,12,215
"GCCTGTTCAGAGAGGG",14,78,119,10,25,246,10874
"GCCTGTTCATCCGATA",5,56,31,6,18,116,1871
"GCCTGTTCATGTTCAG",13,67,130,13,28,251,13587
"GCCTGTTGTACAGCGA",12,69,103,6,22,212,12241
"GCCTGTTGTGAGTTTC",7,45,39,4,17,112,2558
"GCGAGAAAGCATGGGT",47,481,155,42,84,809,48169
"GCGAGAAGTCAATGGG",0,16,4,0,2,22,62
"GCGAGAATCCTATTTG",19,81,104,9,40,253,13705
"GCGAGAATCCTGCTAC",4,67,45,7,19,142,5447
"GCGATCGAGGGTGGGA",0,11,6,0,2,19,74
"GCGATCGTCCAATCCC",38,389,111,31,72,641,34177
"GCGGAAAGTATGGTAA",15,168,48,7,29,267,9291
"GCGGAAATCAAGTGTC",29,69,41,12,18,169,5135
"GCGGAAATCATGTCTT",37,142,388,41,91,699,43548
"GCGGAAATCTGCATGA",59,185,611,37,113,1005,60725
"GCGGATCCAGAGAGGG",7,44,65,6,15,137,9432
"GCGGATCCATGGCTAT",5,68,24,12,18,127,3424
"GCGTGCAAGGCTGGAT",5,64,26,2,17,114,3071
"GCGTGCACAGCTACTA",5,39,12,2,8,66,2578
"GCGTTTCAGTTGAAGT",1,11,10,0,8,30,511
"GCTACAAAGATACAGT",5,62,19,3,9,98,2643
"GCTACAACAATTCTCT",5,51,47,4,30,137,4238
"GCTACAACAGTAGTGG",5,64,24,4,11,108,4030
"GCTACCTCAAGACCGA",6,71,27,5,13,122,3806
"GCTACCTCAAGTTCGT",23,211,93,7,49,383,17505
"GCTACCTGTATCATGC",17,149,52,7,38,263,11676
"GCTACCTTCTTCCCGA",0,36,12,3,13,64,1463
"GCTGGGTAGTCCCTAA",7,51,44,4,45,151,5619
"GCTGGGTGTTATGTCG",20,82,196,13,39,350,18754
"GCTTCACGTGTCACAT",91,531,176,48,155,1001,53644
"GCTTCACGTTCCTAAG",12,52,89,4,20,177,10041
"GCTTCACTCGCCCAGA",5,45,22,3,6,81,1935
"GCTTGGGAGGTGCCAA",15,60,24,2,15,116,2215
"GCTTGGGAGTATGGAT",4,25,24,4,10,67,2063
"GCTTGGGCAAAGGCGT",2,67,29,6,18,122,3378
"GCTTGGGCACTTCAGA",1,21,11,0,4,37,121
"GCTTGGGTCGACGAGA",2,60,21,2,11,96,2026
"GCTTTCGAGGCGTTAG",137,1606,378,88,243,2452,115354
"GCTTTCGAGTGGTTGG",12,147,45,8,32,244,13328
"GCTTTCGGTGCCTAAT",11,128,41,5,31,216,9184
"GCTTTCGTCGTGGGAA",0,3,5,0,2,10,50
"GGAACCCAGCAATTAG",5,48,18,0,11,82,632
"GGAACCCAGTTGCCTA",13,74,51,4,13,155,4965
"GGAACCCGTATCTTCT",7,57,28,3,18,113,2031
"GGAACCCGTGATACTC",35,379,99,20,55,588,26670
"GGAACCCTCGCGGACT",3,27,29,0,12,71,2495
"GGAATCTAGAGTCACG",5,40,12,5,10,72,2080
"GGAATCTAGTGGTGAC",4,63,20,3,33,123,2964
"GGAATCTGTACGTGAG",29,309,77,15,53,483,23775
"GGAATGGGTACGATCT",12,84,53,7,164,320,15645
"GGACGTCCACGCGTCA",1,11,8,0,0,20,343
"GGAGAACCAGCATACT",21,115,235,22,86,479,23873
"GGAGATGAGTAGCCAG",2,17,9,0,9,37,134
"GGAGCAACACTACCGG",33,291,117,26,57,524,26771
"GGAGCAAGTATGCTAC",107,411,130,26,81,755,29919
"GGAGCAATCGGAAACG",5,92,43,5,20,165,3531
"GGAGGATCAGCAGACA",29,100,244,12,50,435,23397
"GGAGGATCATCAGCGC",12,35,28,6,44,125,4341
"GGAGGATTCGATACAC",9,48,25,4,25,111,2489
"GGAGGTACACAGCCTG",9,106,26,8,25,174,6949
"GGAGGTACATTGTGCA",25,122,75,20,290,532,30267
"GGAGGTATCAGCTTGA",16,103,71,15,141,346,16261
"GGATCTAGTCACGTGC",9,54,36,9,63,171,6169
"GGATGTTGTAAGTCAA",26,114,276,18,60,494,27118
"GGATGTTTCAATCGGT",29,128,332,27,57,573,32763
"GGCACGTGTGCTCGTG",7,49,25,9,34,124,2626
"GGCACGTTCGCCTTTG",1,13,32,2,9,57,1495
"GGCAGTCAGAGGGTGG",29,111,385,20,59,604,19425
"GGCTGTGAGCCGGAAT",8,66,129,8,15,226,6502
"GGCTGTGAGGAAGTAG",10,22,11,0,8,51,568
"GGCTTGGAGTTGCTCA",27,127,360,19,124,657,20503
"GGCTTGGTCTCCATAT",16,22,8,3,11,60,1024
"GGCTTTCGTAGCACGA",2,33,20,5,6,66,1345
"GGCTTTCGTATACGGG",1,4,6,0,0,11,234
"GGGAAGTAGACTTCGT",6,60,38,6,30,140,5270
"GGGAAGTAGGGTAGCT",4,35,20,0,16,75,1173
"GGGACAAAGCCTTTGA",10,55,80,4,23,172,7655
"GGGACAACAGAGTTCT",2,19,14,0,8,43,119
"GGGACTCAGAAGTATC",35,451,113,30,75,704,31364
"GGGACTCTCTAGGCAT",4,33,28,4,20,89,4201
"GGGAGATAGAGTTGCG",10,66,31,5,76,188,6131
"GGGAGATGTACTGACT",6,51,31,7,22,117,1812
"GGGATCCCATCCGGCA",63,190,665,42,147,1107,61460
"GGGATCCGTCTCAAGT",42,398,110,34,74,658,32016
"GGGATCCTCCAGCTCT",4,65,28,3,17,117,3752
"GGGATCCTCGAAGCCC",13,36,21,0,14,84,3191
"GGGATGAAGTGGTGGT",15,93,35,4,24,171,8095
"GGGATGACATCTCAAG",95,115,149,28,168,555,31009
"GGGATGACATGGCTGC",20,100,195,15,55,385,19388
"GGGATGAGTATACCCA",2,7,2,0,5,16,286
"GGGCCATGTAGCGATG",4,40,18,5,13,80,1935
"GGGCCATGTGTTACTG",9,51,21,5,16,102,1360
"GGGCCATTCTCTATGT",4,24,5,4,6,43,1333
"GGGCGTTAGACATAAC",53,124,47,8,41,273,6743
"GGGCGTTAGGGCTGAT",14,76,94,16,134,334,18979
"GGGCGTTCAATCCTAG",4,39,21,0,12,76,1199
"GGGCTACAGAAGCCTG",4,56,54,3,19,136,3200
"GGGCTACCAGTGGGTA",6,62,22,10,13,113,2274
"GGGCTCAAGAGGGTAA",136,1336,361,103,246,2182,112302
"GGGCTCACACCCTAAA",25,329,83,18,60,515,21366
"GGGCTCAGTCATCAGT",0,12,4,0,6,22,250
"GGGCTCATCGGACAAG",16,96,98,9,74,293,14019
"GGGTAGATCCAACTGA",18,88,55,12,117,290,13736
"GGGTATTAGAAACTCA",21,137,37,3,35,233,7708
"GGGTATTAGCGCCCAT",3,57,44,5,71,180,6249
"GGGTATTTCACTTCTA",16,105,40,11,23,195,7791
"GGGTATTTCTATACGG",64,233,78,18,66,459,20068
"GGGTCACCAAAGGATT",0,4,3,0,0,7,42
"GGGTCACCAGCATTGT",218,157,77,19,50,521,19335
"GGGTCACCATAACTCG",7,55,26,5,18,111,2931
"GGGTCACGTTCACGAT",36,134,206,26,212,614,35681
"GGGTCTGTCGTAGCCG",46,620,142,42,101,951,40956
"GGGTCTGTCGTCCTTG",11,82,55,98,43,289,10246
"GGGTGAAGTTGCATCA",19,31,27,5,16,98,1888
"GGGTGAATCTCCCATG",246,284,92,28,72,722,29666
"GGGTTATAGAGTCAGC",8,19,9,0,4,40,1115
"GGGTTATGTTTCAGAC",39,490,108,30,87,754,38726
"GGGTTATTCACCTCGT",31,108,241,26,111,517,28906
"GGGTTATTCATTATCC",16,117,62,22,199,416,20511
"GGGTTTAAGTCACAGG",10,95,26,6,20,157,4919
"GGGTTTACACACCAGC",38,149,489,33,96,805,51056
"GGGTTTATCCAATGCA",9,82,50,3,16,160,3949
"GGTAACTCATGACAGG",52,176,511,42,106,887,49933
"GGTAACTCATTGTACG",16,161,70,16,35,298,7948
"GGTAACTGTGAGACCA",4,22,11,4,7,48,624
"GGTAACTTCACTTCTA",28,167,70,14,42,321,15869
"GGTAATCAGACACACG",0,4,4,0,0,8,25
"GGTAATCAGACCTGGA",12,47,62,8,25,154,4973
"GGTAATCAGCGGGTAT",19,161,62,9,39,290,11597
"GGTAATCCACAAGCAG",0,23,5,0,9,37,510
"GGTAATCTCACCGCTT",24,245,68,17,49,403,18847
"GGTAGAGAGGGTCAAC",17,120,81,21,147,386,13872
"GGTAGAGCAGCAGACA",22,178,50,9,27,286,10750
"GGTAGAGGTCACTTCC",4,51,20,3,18,96,2341
"GGTAGAGGTGATTGGG",34,109,174,26,142,485,26842
"GGTCACGCAACACTAC",7,60,19,3,13,102,1860
"GGTCACGCACCAGTAT",12,89,38,10,112,261,11120
"GGTCACGGTTAAGCAA",13,74,95,8,27,217,5527
"GGTCACGTCTAGCATG",20,82,250,12,43,407,20381
"GGTCTGGAGGATGTTA",3,48,31,8,16,106,2294
"GGTCTGGCAAATACGA",58,240,394,37,341,1070,62027
"GGTGAAGAGTCATGGG",9,76,40,9,19,153,3437
"GGTGAAGCAGTGCGCT",14,66,43,11,57,191,6999
"GGTGATTGTATCCCAA",64,174,382,42,194,856,37404
"GGTGATTGTCGCGTCA",1,19,8,0,19,47,1378
"GGTGATTGTTCAGCGC",29,237,101,22,62,451,19370
"GGTGGCTGTTCGAAGG",4,53,30,10,26,123,2485
"GGTGTCGGTACTGCGC",1,33,10,3,9,56,1457
"GGTGTTAAGAGGATGA",26,244,68,16,51,405,17776
"GGTGTTAAGCGTTGTT",38,351,127,28,75,619,32385
"GGTGTTAAGGTAATCA",4,16,9,2,2,33,283
"GGTGTTACATGACGGA",6,47,27,0,43,123,3916
"GGTGTTATCATTGTTC",0,2,11,0,2,15,41
"GGTGTTATCGTTCCTG",2,13,3,0,0,18,100
"GGTTAACAGACCATAA",38,70,46,2,29,185,4500
"GGTTAACAGAGAGGTA",24,83,129,20,36,292,10134
"GGTTAACCACGCCACA",30,364,91,23,63,571,22959
"GGTTCTCGTGGACTGA",5,61,21,5,21,113,2958
"GGTTCTCTCGGAGCAA",9,71,27,3,16,126,3178
"GGTTGTAAGGTTAAAC",5,38,31,4,9,87,1216
"GGTTGTACACATAGCT",8,58,21,3,11,101,3558
"GGTTGTAGTAAGATCA",18,119,34,10,27,208,9759
"GGTTGTATCCGGGACT",20,91,62,15,161,349,17153
"GTAACACTCTGGCTGG",0,14,7,0,3,24,124
"GTAACCAAGTGTTCCA",46,361,191,34,83,715,30590
"GTAACCACAGCTCCTT",7,65,22,5,15,114,2539
"GTAACCATCGTAGGAG",53,183,432,27,235,930,62639
"GTAATCGAGTAGACCG",6,57,58,8,21,150,5679
"GTAATGCGTCTGCGCA",49,192,117,430,86,874,36358
"GTACAGTAGTGGTCAG",12,131,33,9,29,214,10313
"GTAGAAAAGCATCCTA",9,26,56,4,9,104,3571
"GTAGATCAGGGAGGAC",28,125,365,17,72,607,37312
"GTAGATCGTCAAAGAT",11,54,41,3,112,221,10683
"GTAGCTAAGTATTGCC",12,78,112,10,37,249,8789
"GTAGCTAGTCTTGAAC",5,56,29,6,14,110,2177
"GTAGCTATCACGGTCG",1,8,0,0,2,11,55
"GTAGGAGAGCTTGTTG",2,47,25,2,12,88,1447
"GTAGGAGAGTTGCCTA",8,50,36,75,24,193,7500
"GTAGGAGGTGCCTTTC",5,104,34,5,20,168,6648
"GTAGGAGTCCACAAGT",7,77,38,3,19,144,4613
"GTAGGTTAGATTAGCA",4,36,25,2,16,83,1883
"GTAGGTTTCTCCCAAC",8,69,33,10,18,138,1894
"GTAGTACGTATTGACC",4,22,9,2,10,47,712
"GTAGTACGTCCCAAAT",48,183,504,27,98,860,48009
"GTATTTCAGGCACTAG",5,58,18,0,14,95,2681
"GTATTTCCAGAGGCTA",13,77,34,4,65,193,7361
"GTATTTCTCACGGGCT",20,133,87,17,88,345,13580
"GTCAAACAGCACTCCG",19,90,26,7,16,158,4388
"GTCAAGTAGAGAATCT",2,14,7,0,0,23,47
"GTCACTCAGGCGTTGA",3,30,15,3,12,63,1284
"GTCACTCCAATTAGGA",19,79,159,10,46,313,11954
"GTCACTCTCAACTTTC",5,58,24,4,21,112,3304
"GTCAGCGAGCATTGAA",17,49,26,3,12,107,1653
"GTCAGCGCACCCATAA",1,4,0,0,0,5,23
"GTCAGCGCATACCAGT",8,79,59,6,25,177,6884
"GTCAGCGTCAATGTCG",2,39,20,4,12,77,991
"GTCAGCGTCAGCATTG",7,42,18,5,51,123,4244
"GTCAGCGTCGGTCTGG",0,58,16,5,8,87,1461
"GTCATCCAGCTCCATA",4,26,54,6,16,106,2694
"GTCATCCAGGCGTTGA",161,177,66,12,48,464,21406
"GTCATCCAGTGCCTCG",1,9,11,3,4,28,370
"GTCATCCTCAGCGCAC",5,43,20,2,11,81,1476
"GTCATGAGTCCTCCTA",3,39,36,2,17,97,2032
"GTCATTTAGATGATTG",10,53,24,3,20,110,1527
"GTCATTTTCGCATAGT",5,18,10,0,6,39,106
"GTCCACTCACTTCATT",13,161,41,13,36,264,15043
"GTCCACTTCCATCTCG",8,68,32,8,20,136,4181
"GTCCCATAGGTCATAA",276,2728,724,223,519,4470,243442
"GTCCCATCAATGGCCC",1,6,10,0,2,19,142
"GTCCTCAAGAGATTCA",15,93,62,8,18,196,4458
"GTCCTCAAGTACCGGA",21,88,204,17,39,369,14572
"GTCCTCAAGTGAGTTA",20,63,50,17,128,278,10824
"GTCCTCACAAGTGGCA",18,217,73,10,41,359,10653
"GTCGAATCAATTGAGA",11,98,30,6,22,167,5911
"GTCGAATTCCCTGGTT",13,67,39,6,78,203,8033
"GTCGTAACAACACGAG",2,11,5,0,6,24,561
"GTCGTAATCCTCACGT",18,78,233,10,33,372,18239
"GTCGTTCCACATACTG",7,66,31,7,82,193,5708
"GTCGTTCGTCATCGGC",10,64,81,5,18,178,4809
"GTCGTTCTCACGATCA",8,84,26,5,23,146,5065
"GTCTACCGTCACTCAA",20,179,55,17,42,313,12005
"GTCTAGAAGCTAAATG",28,106,57,7,31,229,6013
"GTCTAGAGTCTTCGAA",7,107,29,2,25,170,6444
"GTCTCACCAAGACGGT",5,57,19,6,22,109,1923
"GTCTCACCACGGGCTT",2,25,16,0,5,48,877
"GTCTCACGTGGGTCAA",3,33,32,4,15,87,2728
"GTCTCACGTTCTAAGC",40,339,175,30,61,645,30608
"GTCTCACTCACGGTCG",13,93,104,13,36,259,7871
"GTCTGTCCACTCATAG",5,69,24,5,15,118,5211
"GTCTGTCCAGCTACTA",7,37,24,29,13,110,4277
"GTCTGTCCAGCTCTGG",55,89,60,6,25,235,4950
"GTCTGTCTCCCAACTC",35,161,310,28,174,708,31782
"GTCTTTATCGATACAC",31,136,72,15,205,459,24501
"GTGACGCAGTTACGGG",3,9,8,6,4,30,666
"GTGACGCGTCTAGGCC",3,44,19,2,8,76,1100
"GTGACGCTCAAGCCAT",31,111,74,27,224,467,21606
"GTGACGCTCGGCTTGG",18,66,42,60,20,206,5532
"GTGAGCCAGAATTGTG",23,105,149,23,158,458,26346
"GTGAGCCGTAGCACGA",13,147,52,13,26,251,9478
"GTGAGGACAATAGTGA",6,71,27,4,16,124,2300
"GTGAGGAGTCCAGAAG",8,65,23,9,14,119,5374
"GTGAGGAGTTAGCGGA",16,101,38,8,24,187,6578
"GTGAGTTCAAGGCTTT",4,51,24,0,21,100,2446
"GTGATGTGTCTGCAAT",0,5,4,2,0,11,31
"GTGCACGCACAGCATT",9,66,31,45,25,176,5947
"GTGCACGGTAACTGCT",0,8,4,0,0,12,89
"GTGCAGCGTTTGGCTA",7,88,31,5,18,149,4293
"GTGCAGCTCATGTCAG",6,85,43,4,22,160,6904
"GTGCTGGCATCCGAGC",2,9,7,0,4,22,110
"GTGCTGGCATGCCATA",6,76,31,6,23,142,3097
"GTGCTGGTCATTCACT",4,41,29,5,16,95,3598
"GTGCTTCAGGTAGTCG",3,13,6,0,3,25,289
"GTGCTTCAGTACTGTC",15,134,42,8,26,225,8588
"GTGCTTCAGTCAGGGT",1,14,3,0,5,23,911
"GTGCTTCCATCATCTT",73,226,612,55,248,1214,73681
"GTGCTTCGTGGAGGTT",2,5,0,0,0,7,31
"GTGGAAGAGGTGAGCT",15,68,63,8,93,247,12904
"GTGGAAGCAAGCAATA",4,47,23,4,13,91,1981
"GTGGAAGGTAACATAG",29,309,85,28,60,511,22604
"GTGGAAGTCACAACCA",8,62,26,5,19,120,1309
"GTGGAGAAGGTAAGAG",18,143,59,60,30,310,11621
"GTGGAGAGTGGACAGT",2,12,6,3,10,33,1345
"GTGGCGTGTTCCATTT",8,63,98,9,27,205,8466
"GTGGCGTGTTCGGCTG",0,8,5,0,2,15,41
"GTGGGAATCTCGGCTT",30,123,80,17,296,546,38220
"GTGTCCTAGTTCCAGT",11,65,59,3,11,149,4684
"GTGTCCTCAAGTTGGG",5,69,28,6,22,130,2710
"GTGTCCTTCGATTTCT",3,25,5,2,3,38,99
"GTGTGATAGATTGAGT",21,290,66,24,61,462,24900
"GTGTGATGTCTCTCAC",578,369,182,79,151,1359,61408
"GTGTGATTCCCGTTGT",1,10,8,0,6,25,926
"GTGTGATTCTAAGCCA",3,54,24,0,20,101,1391
"GTGTGGCAGTGAATAC",48,507,136,36,84,811,38874
"GTGTTAGCACAAAGTA",13,44,39,10,93,199,9522
"GTGTTCCCAACAACAA",13,82,139,11,42,287,14956
"GTGTTCCTCCTTGACC",72,102,48,10,28,260,10600
"GTTACAGAGTAAATGC",3,23,14,2,4,46,145
"GTTACCCAGACCAAGC",3,12,5,0,8,28,460
"GTTACGAAGGGTACGT",8,69,34,6,11,128,3896
"GTTACGACAATGTCTG",13,80,77,9,31,210,10251
"GTTACGAGTCGCAACC",24,27,15,3,16,85,2949
"GTTACGATCCATTTAC",7,57,22,4,50,140,4826
"GTTAGACCACCAGCCA",1,17,7,0,2,27,449
"GTTAGTGAGCGGTATG",28,126,247,19,65,485,24238
"GTTAGTGCACGTCGGT",16,62,47,7,122,254,12906
"GTTAGTGTCCGAGGCT",16,88,59,2,161,326,17084
"GTTAGTGTCGGTAAGG",4,35,19,0,12,70,2477
"GTTATGGAGTCACAGG",15,68,94,6,33,216,8086
"GTTATGGCAGGAGGTT",15,120,44,10,29,218,8548
"GTTATGGGTTACGTAC",28,118,246,15,59,466,31838
"GTTCATTAGCTCCACG",15,106,44,0,25,190,3018
"GTTCCGTGTAGTTACC",4,58,100,5,53,220,4236
"GTTCTATAGAGGATGA",0,16,13,0,2,31,384
"GTTCTATGTGTTCCTC",14,98,94,9,38,253,10437
"GTTGAACCACGGCACT",2,17,9,2,5,35,309
"GTTGAACTCACGGGCT",85,65,39,12,31,232,7581
"GTTGAACTCCCTTGTG",14,121,69,19,179,402,19474
"GTTGAACTCTGGAAGG",11,52,32,48,25,168,5006
"GTTGCGGAGTACCATC",9,123,35,9,23,199,6576
"GTTGCGGTCGCTCTCA",1,17,6,0,2,26,475
"GTTGTAGAGCCATTGT",12,83,86,8,28,217,11913
"GTTGTGACATGTGGCC",13,82,37,6,71,209,10424
"GTTGTGAGTGCCTGAC",4,34,18,0,13,69,1257
"GTTGTGAGTTGGACTT",5,40,18,5,14,82,1579
"GTTGTGATCCTAGCTC",15,73,87,4,20,199,7262
"GTTTACTAGGTCCTGC",16,88,143,16,36,299,18525
"GTTTACTGTGCAATGG",28,205,87,13,39,372,15297
"GTTTGGAGTGCCCTTT",19,283,82,52,51,487,23420
"GTTTGGAGTTCAATCG",5,11,28,4,4,52,2581
"GTTTGGATCCCTTGTG",12,70,33,3,15,133,2811
"TAACACGAGTAACCTC",21,57,24,3,12,117,2964
"TAACACGGTTAGAAAC",48,78,41,7,24,198,7084
"TAACCAGAGCGGTATG",8,60,19,4,16,107,2471
"TAACCAGAGTAGTCCT",269,119,75,16,62,541,27029
"TAACCAGAGTTAACAG",5,29,16,0,6,56,1212
"TAACCAGGTAACATGA",11,60,26,3,17,117,2632
"TAACGACCACATGAAA",10,48,21,0,7,86,2370
"TAACGACCATACCACA",36,443,103,29,75,686,33489
"TAACGACGTCTCCCTA",7,85,27,10,13,142,3695
"TAACTTCCAGTGCCTG",10,52,31,3,7,103,3372
"TAACTTCTCGCCTATC",10,76,27,7,22,142,3445
"TAAGCACAGTATAGGT",1,24,13,2,21,61,2187
"TAAGCCAAGGCGAAGG",23,279,61,25,47,435,19092
"TAAGCCAAGTTCCTGA",0,11,2,0,0,13,49
"TAAGCCAGTTCCACGG",9,44,46,2,20,121,4418
"TAAGCCATCAGCACCG",113,135,56,14,35,353,13455
"TAAGCGTAGTTACGTC",30,102,172,21,150,475,22637
"TAAGCGTGTCAGGTGA",5,51,22,0,18,96,2735
"TAAGCGTGTTGCATAC",22,25,8,2,11,68,1860
"TAAGTCGAGGCAGCTA",11,88,30,5,23,157,7885
"TAAGTCGAGTTGCCTA",7,80,32,8,12,139,3006
"TAAGTCGCACGCTTAA",6,65,23,0,29,123,3531
"TAAGTCGGTGCCCACA",15,69,36,10,97,227,9134
"TAAGTCGGTGGTCAAG",4,58,36,2,21,121,2604
"TAAGTCGTCCGAAGGA",14,126,40,11,20,211,7116
"TAATTCCCAGGCATGA",36,197,135,26,129,523,21385
"TAATTCCGTACTAACC",17,101,189,11,43,361,21055
"TACAACGGTTAAGGAT",104,336,463,76,949,1928,127281
"TACAACGTCTTCGACC",7,37,43,9,49,145,8661
"TACAGGTGTCCTCATC",32,296,62,23,55,468,25770
"TACAGGTGTGTCTTAG",21,124,88,16,222,471,25717
"TACAGGTGTTGCCGAC",10,48,21,3,19,101,2194
"TACATTCAGATGCTGG",11,89,24,8,16,148,4789
"TACATTCCAAAGGCAC",3,42,7,0,5,57,2336
"TACATTCCATGCGGTC",12,110,39,7,21,189,8805
"TACCCACGTTGGTAGG",27,90,115,17,94,343,14694
"TACCCGTCAGTGCGCT",2,23,4,0,2,31,1341
"TACCCGTGTTAGTTCG",5,62,33,3,12,115,2617
"TACCGAAAGTAGTCTC",4,47,19,4,5,79,1613
"TACCGAAGTTGATGTC",40,405,146,29,82,702,38968
"TACCGGGAGGCTAGCA",68,193,163,41,629,1094,71374
"TACCGGGCATGGTACT",12,82,107,12,26,239,11838
"TACCGGGGTACCGTGC",2,7,0,0,11,20,622
"TACGCTCAGCACTAGG",16,110,31,11,29,197,10993
"TACGCTCTCCATTTGT",7,21,37,0,7,72,3709
"TACGCTCTCCGTGGCA",17,93,181,10,38,339,19255
"TACGGTAAGTCGGCCT",14,101,45,5,33,198,4263
"TACGGTACAATGTCAC",3,27,2,2,2,36,915
"TACGTCCAGAGTATAC",8,51,19,5,11,94,3061
"TACGTCCCACGGTGTC",18,174,57,13,43,305,11299
"TACGTCCTCCGGACGT",31,340,73,18,54,516,24999
"TACGTCCTCGCTCTCA",17,154,82,14,32,299,12654
"TACTGCCAGCAGGTCA",13,78,24,5,74,194,10342
"TACTGCCGTACGCGTC",11,106,34,9,22,182,7724
"TACTTACAGGTTGAGC",2,14,5,0,5,26,321
"TACTTCAAGTGCCCGT",0,19,7,2,0,28,491
"TACTTCAGTCCAGCAC",14,56,29,2,22,123,3210
"TACTTGTCAAATGATG",44,173,61,14,48,340,15254
"TACTTGTCAGCATGCC",16,119,42,9,30,216,10494
"TACTTGTTCAAGAAAC",27,89,38,7,18,179,4605
"TAGACCAAGATAGCTA",14,69,27,5,18,133,2473
"TAGACCATCTTCCCAG",70,713,188,47,137,1155,57268
"TAGACTGAGCTACTGT",4,53,21,2,12,92,1510
"TAGACTGGTGACTGAG",29,259,85,18,58,449,23597
"TAGACTGGTTCCACAA",13,97,44,10,118,282,12162
"TAGAGTCTCCAACTGA",8,52,30,5,13,108,2631
"TAGATCGAGAGTCTTC",43,458,138,18,86,743,35868
"TAGCACACATCGCTCT",6,107,32,12,19,176,7055
"TAGCACAGTACAAGCG",37,403,109,31,75,655,29132
"TAGGAGGTCCCGATCT",16,101,62,13,133,325,15118
"TAGGGTTCAAGCGCAA",48,294,154,31,82,609,35027
"TAGGGTTCATGGAGAC",11,88,102,6,23,230,9228
"TAGGGTTGTCACGCTG",15,17,16,2,9,59,3470
"TAGGGTTGTTCCGCGA",12,62,48,6,39,167,7276
"TAGGGTTTCTCAATCT",32,186,92,25,217,552,29134
"TAGGGTTTCTGGGTCG",69,163,51,9,46,338,11418
"TAGGTACCAGGCAATG",12,58,24,4,31,129,3094
"TAGGTACGTCCGTACG",4,45,40,3,19,111,3498
"TAGGTACTCTCTCGCA",6,67,36,7,13,129,2232
"TAGGTTGAGACCCTTA",1,19,7,4,4,35,1105
"TAGGTTGAGGTTACCT",31,123,110,20,241,525,27367
"TAGGTTGCAGTAGAAT",4,55,43,8,23,133,4919
"TAGGTTGCATCAGCTA",6,26,7,0,11,50,267
"TAGGTTGTCACGTAGT",19,72,117,6,28,242,11256
"TAGGTTGTCCATCGTC",5,45,17,5,13,85,1532
"TAGGTTGTCTACAGGT",5,43,16,6,15,85,1037
"TAGTGCAAGAGAGTTT",3,9,4,0,2,18,92
"TAGTGCAGTACAACGG",60,659,147,36,111,1013,49402
"TATACCTAGTCGCCCA",16,198,54,20,68,356,15362
"TATACCTCAGAATGTA",77,642,279,57,175,1230,59867
"TATATCCCAAATGATG",12,70,117,8,33,240,10040
"TATCAGGTCGACGTCG",28,137,48,9,34,256,8754
"TATCAGGTCTTGTTAC",13,76,40,8,26,163,2245
"TATCCTAGTCAGGCAA",66,739,300,41,139,1285,89892
"TATCCTATCATGCGGC",18,81,58,9,161,327,19989
"TATCGCCGTCAAGTTC",1,4,6,0,8,19,104
"TATCTGTCAATAACGA",10,147,45,7,35,244,10464
"TATCTGTGTACACGCC",12,74,90,9,32,217,10529
"TATCTGTGTCTACGAT",47,369,94,27,85,622,29616
"TATCTTGAGAGTCAAT",10,88,37,6,24,165,6126
"TATCTTGAGCTACGTT",56,227,202,49,574,1108,59686
"TATCTTGTCTCGGTCT",19,193,94,13,61,380,23124
"TATGTTCCAAGAGCTG",6,45,22,6,12,91,2223
"TATGTTCTCTTCTGGC",4,56,28,3,16,107,2481
"TATTCCAAGGTCCGAA",7,67,51,5,21,151,6472
"TATTCCAAGGTTCCGC",16,119,287,24,84,530,31583
"TATTCCACATGTCGTA",22,124,304,22,58,530,33316
"TATTGCTCAACCGGAA",7,76,39,4,92,218,11055
"TATTGCTTCCCGAAAT",16,148,47,5,28,244,13021
"TATTGCTTCGTGGAAG",3,22,13,2,11,51,746
"TATTGGGCAAATGAAC",70,231,668,46,145,1160,68124
"TATTGGGGTGTCCATA",38,331,120,22,68,579,34852
"TATTGGGTCAAGATAG",6,71,32,4,16,129,3428
"TATTTCGCAGGCTTGC",15,115,38,7,37,212,6608
"TATTTCGCATAGATCC",11,187,54,12,38,302,13298
"TATTTCGGTCAAGTTC",14,147,68,12,47,288,11380
"TCAAGACCACCCTATC",14,75,132,5,30,256,10396
"TCAAGCAAGGTTCCGC",76,318,98,18,69,579,25049
"TCAAGCAGTAGCTTTG",152,150,74,21,87,484,23164
"TCAAGTGAGAGTCTTC",7,69,22,0,17,115,4083
"TCAAGTGAGCGCCATC",12,142,33,10,36,233,8801
"TCAATCTAGTCCCTAA",17,133,47,9,30,236,7471
"TCAATCTGTACCTAAC",70,309,533,38,243,1193,81282
"TCAATCTGTCGTATTG",4,29,10,2,17,62,659
"TCAATCTTCCTAAGTG",45,382,98,30,85,640,28492
"TCAATCTTCCTTTAGT",4,16,15,3,8,46,270
"TCAATTCAGGCTTAAA",7,51,16,7,16,97,3382
"TCAATTCGTCTTGAGT",6,54,27,5,23,115,2253
"TCAATTCTCATAGCAC",20,139,125,15,208,507,29210
"TCACAAGGTCAGTTTG",10,42,75,6,16,149,8363
"TCACAAGTCCTGGCTT",0,14,10,0,4,28,71
"TCACACCCAGTCGCTG",9,76,44,2,95,226,8777
"TCACACCGTATGACAA",172,530,131,46,106,985,48571
"TCACACCTCAGACCCG",21,92,139,16,48,316,13023
"TCACACCTCCTTGGAA",32,118,219,20,53,442,26090
"TCACATTAGCCTCTTC",25,112,170,13,70,390,21101
"TCACATTAGTGGATAT",6,27,18,0,4,55,161
"TCACATTCATGTGACT",195,850,204,69,179,1497,87919
"TCACATTGTCTAGGTT",13,96,45,5,35,194,4122
"TCACATTGTGAAGCGT",1,10,11,0,5,27,609
"TCACATTGTTTACGTG",15,77,65,6,11,174,5662
"TCACGCTCAATCAAGA",23,89,191,9,46,358,22698
"TCACGCTCATCACAGT",2,15,6,3,19,45,2113
"TCACGGGCATTGAAAG",8,95,46,10,23,182,6662
"TCACGGGGTCACTGAT",9,92,44,4,22,171,6770
"TCACTATTCTAAGCGT",7,54,16,3,8,88,2731
"TCACTCGGTAGGCAGT",2,34,7,3,8,54,2419
"TCACTCGTCTCGACGG",28,120,37,10,30,225,7030
"TCAGCAAAGGGTTTCT",4,58,31,5,10,108,2181
"TCAGCAACACTTTATC",25,203,66,17,46,357,16486
"TCAGCCTAGCGCATCC",8,98,30,4,17,157,8181
"TCAGCCTCACGATAGG",6,74,66,5,27,178,7393
"TCAGGGCGTCCTGTTC",12,56,107,9,21,205,9244
"TCAGGGCTCGCCTTGT",11,68,31,2,25,137,2985
"TCAGGGCTCGCGTGAC",17,91,192,17,40,357,17138
"TCAGGTAAGCGGACAT",3,70,29,4,27,133,2815
"TCAGGTAGTAAGTTGA",23,105,138,19,129,414,21908
"TCAGGTATCGCGTCGA",0,19,8,0,3,30,247
"TCAGTGACAATAGTGA",7,62,24,6,12,111,2728
"TCAGTGAGTGACAGCA",25,40,18,3,11,97,4382
"TCAGTTTCAGCAATTC",7,61,42,4,34,148,5409
"TCATACTGTGCACAAG",127,1211,271,109,215,1933,95500
"TCATACTTCCGTGCGA",145,148,53,18,39,403,17093
"TCATATCCAAGTAGTA",314,411,142,55,115,1037,46423
"TCATATCGTGGTCTGC",2,18,19,3,7,49,869
"TCATCATAGGCCTAGA",9,99,32,7,19,166,5230
"TCATCCGAGTCCTGTA",7,96,139,6,45,293,14771
"TCATCCGCAGTCAGCC",2,27,10,0,4,43,2485
"TCATCCGTCGAGCCTG",35,98,38,7,25,203,6087
"TCATCCGTCGTCAACA",25,114,81,11,178,409,16867
"TCATCCGTCTCTGGTC",30,81,22,8,14,155,6079
"TCATGCCTCCTTCGAC",13,86,55,9,120,283,14469
"TCATTACAGGATGCGT",1,9,8,0,2,20,274
"TCATTCACAACCCTAA",38,77,29,6,16,166,5566
"TCATTCACACACACTA",5,56,25,4,12,102,3010
"TCATTCATCCGTTTCG",30,170,156,17,52,425,22774
"TCATTGTGTATCACCA",148,243,102,17,79,589,23890
"TCATTGTTCGTAGCCG",12,55,32,3,30,132,3529
"TCATTTGAGCTGACCC",1,12,5,0,0,18,61
"TCATTTGTCAGGACGA",18,78,50,12,106,264,13723
"TCCACCATCTCTTGCG",235,2148,642,186,410,3621,186981
"TCCAGAAAGTGTGTTC",2,27,26,2,7,64,1831
"TCCAGAACAGTGGCTC",5,78,63,5,15,166,4646
"TCCAGAAGTCTCCTGT",7,70,32,9,13,131,3842
"TCCAGAATCTTGGCTC",18,203,87,17,63,388,17426
"TCCATCGGTTTCGACA",2,16,10,4,18,50,635
"TCCATGCAGGTTCATC",4,13,9,2,3,31,195
"TCCATGCCAAGCGCAA",8,36,20,4,17,85,2003
"TCCATGCGTTGCATAC",18,144,54,13,22,251,7586
"TCCATGCTCGTGTGGC",33,438,102,30,69,672,28819
"TCCCACAAGTCATGCT",16,109,45,14,147,331,14532
"TCCCACACACACCAGC",9,77,81,2,27,196,11164
"TCCCACATCAAGCCGC",19,84,41,10,106,260,11465
"TCCCAGTGTACTCGAT",5,74,31,2,23,135,2903
"TCCCAGTGTTGCGGCT",1,6,3,0,0,10,259
"TCCCATGAGGCGAAGG",6,34,18,6,35,99,2748
"TCCCATGCATGTGACT",3,39,10,0,5,57,493
"TCCCATGGTAGGTGCA",14,131,42,11,24,222,12969
"TCCCATGTCTGGGCAC",18,88,56,126,30,318,12172
"TCCGAAAGTTCTGACA",13,53,27,5,22,120,4215
"TCCGAAATCGGAGTGA",3,45,25,4,25,102,3810
"TCCGTGTGTAACACCT",44,174,375,41,222,856,49536
"TCCTAATCAACATACC",19,112,156,15,40,342,15106
"TCCTAATCAACCGTGC",38,471,110,33,81,733,48125
"TCCTAATGTCCCTGAG",0,4,0,0,0,4,40
"TCCTAATGTCTGTGGC",6,49,22,0,16,93,2076
"TCCTAATTCTGTACAG",94,206,63,15,68,446,24226
"TCCTCTTAGGCTAAAT",9,78,69,5,28,189,8581
"TCCTCTTCACGCTATA",1,45,18,3,10,77,1733
"TCCTCTTCAGCTAACT",38,157,349,28,69,641,34075
"TCCTTCTCACCGTGAC",1,14,5,0,3,23,1239
"TCCTTCTCAGAATTCC",59,581,159,44,110,953,48313
"TCCTTCTGTCCAGCCA",266,2835,579,201,472,4353,237521
"TCCTTCTGTTACCGTA",14,71,38,5,18,146,5014
"TCCTTCTTCATTTCCA",9,26,22,6,27,90,2885
"TCCTTCTTCGTGTCAA",15,87,117,8,45,272,12638
"TCCTTTCCAAAGTGTA",7,67,37,6,17,134,3816
"TCCTTTCCATAGCACT",20,198,63,5,40,326,14146
"TCGAACAAGCAATAAC",17,187,56,9,41,310,12459
"TCGAACAAGTCGGCCT",77,96,52,11,37,273,8687
"TCGAACAGTCCGCAGT",14,81,38,10,118,261,13442
"TCGAACAGTGTCATCA",7,75,29,7,13,131,5128
"TCGAAGTGTTACAGCT",3,45,17,4,11,80,2176
"TCGAAGTTCCCTCATG",6,53,19,32,17,127,4068
"TCGACCTGTATGTCAC",22,127,305,22,55,531,30564
"TCGACGGGTAGGTACG",7,60,25,2,12,106,2012
"TCGACGGGTTGGGACA",10,32,13,3,10,68,1446
"TCGACGGTCCGAAATC",7,56,15,5,9,92,2664
"TCGATTTGTCCTCATC",2,23,12,0,5,42,270
"TCGCACTCAAAGGTTA",29,130,276,22,57,514,27669
"TCGCACTCAGCCATTA",17,238,114,14,49,432,20256
"TCGCAGGTCTAGTGTG",15,86,50,11,72,234,5894
"TCGCTCAAGTTGCTGT",11,79,30,4,29,153,3481
"TCGCTCATCGTCGCTT",13,66,264,6,33,382,10648
"TCGCTTGAGCGACATG",8,69,20,2,15,114,2027
"TCGCTTGCAGACATCT",3,10,15,0,5,33,1255
"TCGCTTGTCGAATCCA",20,90,201,17,50,378,18678
"TCGGATAGTTCTAACG",63,200,551,28,109,951,65528
"TCGGATATCTTTGCTA",2,19,11,0,2,34,747
"TCGGGACGTAAGTTAG",24,330,93,27,45,519,25926
"TCGGGACTCCATTCGC",0,15,3,2,4,24,72
"TCGGGCAAGCACTTTG",7,61,20,5,14,107,2959
"TCGGGCACAGTGGGTA",36,200,83,15,64,398,18170
"TCGGGCAGTGTAAATG",109,306,89,27,72,603,31660
"TCGGGTGTCCGCCTAT",0,19,8,2,7,36,437
"TCGGTCTTCAGAGCGA",36,377,88,25,76,602,26414
"TCGTAGATCGGCCCAA",119,219,78,23,60,499,23423
"TCGTCCAGTTCAGCGC",35,187,72,59,40,393,15186
"TCGTGCTAGATCCCGC",6,47,69,3,18,143,4377
"TCGTGCTAGTATGGAT",2,6,2,2,4,16,254
"TCGTGCTCATCCTGTC",17,88,181,16,179,481,14981
"TCGTGCTTCCACGGGT",15,163,56,11,33,278,6752
"TCGTGGGGTAAGTAGT",19,90,45,19,123,296,10298
"TCGTGGGGTGATTAGA",0,8,2,0,3,13,40
"TCTAACTGTATGAAGT",7,60,20,5,12,104,3771
"TCTAACTTCAAGAAAC",4,68,30,4,20,126,2559
"TCTACATCAGCATCTA",22,206,72,14,51,365,17361
"TCTACATGTTCGGTTA",23,122,71,26,198,440,26905
"TCTACATGTTCTCCCA",24,97,142,13,35,311,15836
"TCTACATGTTGGAGGT",8,69,28,2,19,126,4687
"TCTACCGAGATGTTAG",2,16,11,0,49,78,4524
"TCTACCGCACAGTACT",10,60,34,4,57,165,6839
"TCTACCGTCGGCATTA",3,23,9,7,13,55,1101
"TCTATACAGTGGTGAC",57,113,59,9,31,269,7419
"TCTATACCACACCGAC",22,230,129,15,54,450,20891
"TCTATACTCGCAGATT",21,101,207,21,48,398,17602
"TCTATACTCTTCACAT",27,287,88,48,74,524,24778
"TCTATCAGTGGACTAG",60,135,36,11,33,275,10969
"TCTATCAGTTGCCTAA",10,57,23,8,18,116,2671
"TCTATCATCCTCCACA",17,57,41,7,21,143,4718
"TCTATCATCTCTGGTC",17,115,127,9,37,305,12573
"TCTCACGTCACTGCTC",48,315,76,24,63,526,25345
"TCTCAGCGTGGCTTGC",40,140,112,21,362,675,42117
"TCTCAGCTCTCCCAAC",4,51,22,3,15,95,3253
"TCTCCGAAGTTGGGAC",4,61,19,5,18,107,2299
"TCTCCGACATAGGAGC",17,140,48,14,41,260,10352
"TCTCCGATCTCCGAAA",8,84,96,4,32,224,9599
"TCTGCCATCCTGTAGA",177,132,92,107,137,645,33763
"TCTGCCATCGATACGT",7,46,31,2,13,99,1909
"TCTGGCTGTCCATACA",28,100,285,14,55,482,34498
"TCTGGCTGTTCTCCTG",12,101,32,4,23,172,7707
"TCTGTCGGTGTACGCC",2,31,7,4,6,50,847
"TCTTAGTAGCCGCACT",39,94,39,8,31,211,9068
"TCTTAGTAGCGAACTG",7,60,36,2,22,127,3197
"TCTTAGTAGGCCACTC",6,69,38,3,17,133,3858
"TCTTAGTGTCACCGAC",21,81,127,10,38,277,13302
"TCTTAGTTCCTCACTG",88,836,292,75,165,1456,66145
"TCTTCCTCACAGCTTA",17,94,95,7,53,266,14495
"TCTTCCTGTGAGTCAG",5,48,23,0,13,89,1644
"TCTTCCTTCGACACCG",20,232,82,18,43,395,19162
"TCTTGCGAGCGGGTTA",9,67,45,6,49,176,5934
"TCTTTGAAGTTGCTGT",3,23,33,5,7,71,3359
"TCTTTGAGTGCACGCT",18,117,46,10,34,225,7655
"TCTTTGAGTGTTTCTT",7,62,27,2,17,115,3486
"TCTTTGAGTTGCTCAA",4,38,16,2,14,74,947
"TGAACGTCACAGTCCG",18,144,57,10,47,276,12391
"TGAATCGAGAGATTCA",35,66,23,6,17,147,5517
"TGAATCGCACAGAAGC",81,240,563,65,499,1448,99568
"TGAATCGTCCAAGCAT",4,45,17,4,9,79,2117
"TGAATGCGTCACCTTC",4,69,39,6,23,141,4394
"TGACAGTAGCAATAAC",165,614,195,48,123,1145,58198
"TGACAGTCAAATCGGG",7,120,15,4,11,157,6407
"TGACAGTGTTGTGGCC",7,75,25,5,18,130,6055
"TGACAGTTCAGTGATC",52,441,123,34,82,732,40504
"TGACTCCAGTCATGCT",40,145,91,26,322,624,35062
"TGACTCCCAATCAAGA",35,67,25,3,16,146,5033
"TGACTCCCAATGTCTG",0,23,19,3,12,57,872
"TGACTCCTCGTTATCT",19,90,138,9,26,282,13872
"TGAGCGCGTCCACGCA",15,73,176,5,41,310,20901
"TGAGGAGAGTATCTGC",10,60,27,5,28,130,2418
"TGAGGAGGTTCCGCTT",3,11,3,3,2,22,162
"TGAGGAGTCCTTCGAC",96,71,47,8,28,250,11643
"TGAGGGAAGCAGCCTC",57,128,44,10,39,278,8185
"TGAGGGACAGCTACAT",18,86,169,13,37,323,18290
"TGAGGGATCGCTAGCG",3,48,12,6,14,83,3289
"TGAGGTTAGTATGAGT",14,177,54,7,36,288,12583
"TGAGGTTGTTGAATCC",41,137,282,19,163,642,38729
"TGAGTCAAGCCAAGGT",8,69,23,3,8,111,6507
"TGAGTCACAACCGGAA",9,150,41,9,42,251,7377
"TGAGTCATCATAGAGA",20,119,50,174,55,418,15985
"TGATCAGCAGACGCTC",21,95,61,11,147,335,16230
"TGATCAGGTGGCAGAT",11,107,31,7,57,213,7999
"TGATCAGGTTACCCTC",33,272,86,31,58,480,17377
"TGATCTTAGTAGAATC",5,67,45,7,23,147,6478
"TGATCTTCAGCATCTA",22,148,85,15,251,521,27323
"TGATCTTCAGCCATTA",16,65,37,4,19,141,3128
"TGATCTTCAGGACTTT",7,56,39,5,14,121,6922
"TGATCTTTCATTTGTC",12,80,36,4,17,149,4573
"TGATGCAAGCAAGTCG",36,128,416,26,73,679,38259
"TGATGCAGTCAGACGA",42,60,55,8,28,193,6089
"TGATGCATCACGAGGA",22,95,124,15,123,379,18935
"TGATGCATCTCGCCTA",13,154,51,13,26,257,12313
"TGATGGTAGACCAGCA",11,80,43,9,99,242,9463
"TGATGGTAGCGCATCC",3,66,21,4,19,113,3313
"TGATGGTGTAACCCGC",20,69,45,17,162,313,15852
"TGATGGTGTTGATCGT",3,11,13,0,6,33,307
"TGATTCTCACCTAAAC",14,71,26,2,16,129,2605
"TGATTCTGTTGCCAAT",6,36,33,2,18,95,2540
"TGATTCTTCCAAAGGG",9,69,36,6,34,154,4280
"TGATTTCCAGTGGCTC",7,112,42,9,24,194,6811
"TGATTTCGTTGCCGCA",86,891,201,66,158,1402,75008
"TGCACGGGTACGGGAT",48,99,120,9,89,365,15211
"TGCAGATCAGATTAAG",2,17,9,0,18,46,2116
"TGCAGATTCCCATGGG",17,133,38,9,29,226,7239
"TGCAGATTCGGTATGT",29,112,72,20,158,391,15799
"TGCAGGCCAATAAGGT",26,100,279,19,50,474,28648
"TGCAGGCCACCCTGAG",19,115,240,25,49,448,20063
"TGCAGGCCATCTAGAC",0,18,4,0,6,28,153
"TGCAGGCTCGGCCTTT",40,120,178,24,289,651,35146
"TGCAGTAAGGACATCG",19,71,94,11,28,223,8729
"TGCAGTATCCGCGATG",0,24,8,0,0,32,843
"TGCAGTATCTCTGCTG",8,73,39,6,13,139,4950
"TGCATCCCAATCCAGT",41,233,314,22,73,683,33436
"TGCATGAAGTTGTAAG",44,441,123,28,96,732,29977
"TGCATGACAACGTTAC",8,75,21,4,14,122,5461
"TGCATGATCCGTACGG",28,284,83,16,62,473,16564
"TGCCGAGCATCATTTC",9,51,21,5,8,94,3259
"TGCGACGAGAAACTCA",0,3,0,0,0,3,19
"TGCGACGAGTCATGCT",10,50,68,7,18,153,5472
"TGCGACGTCCTCACCA",0,9,8,0,2,19,60
"TGCGATAAGAAACTCA",13,76,55,7,26,177,7766
"TGCGATAAGTGATTCC",1,39,22,0,10,72,2176
"TGCGATACACACTTAG",14,100,60,17,168,359,18975
"TGCGATATCATTTACC",2,16,9,0,6,33,111
"TGCGGCAAGTGCGACA",9,77,39,0,21,146,4688
"TGCGGCATCAGACATC",4,71,29,7,12,123,1977
"TGCGGGTCACTGCTTC",179,359,132,33,95,798,42436
"TGCGGGTGTAGCCCTG",95,743,238,64,492,1632,89837
"TGCGGGTGTTCAAGTC",20,89,52,13,195,369,19404
"TGCTCCAAGTCGGGAT",40,119,211,11,42,423,25439
"TGCTCCAAGTGCACTT",8,36,24,2,14,84,2689
"TGCTGAATCAACTCTT",24,118,195,12,48,397,21945
"TGCTTCGCACAATTCG",16,87,150,20,33,306,12583
"TGCTTCGCACTCACTC",1,27,6,0,3,37,1839
"TGCTTGCCAACGGCTC",25,111,269,14,46,465,24331
"TGCTTGCGTTGCATTG",6,91,31,8,23,159,3413
"TGCTTGCTCGAGAAAT",59,228,522,39,119,967,48671
"TGGAACTGTGGTCCGT",21,149,68,61,35,334,12115
"TGGAGAGCAGGGCTTC",4,72,51,0,16,143,4259
"TGGAGGATCACGGGCT",0,12,4,0,6,22,372
"TGGATCAAGAAGTGTT",3,23,20,0,6,52,902
"TGGATCACAAATGAGT",28,110,169,15,39,361,17312
"TGGATGTGTGCGTTTA",19,159,51,14,35,278,10408
"TGGATGTTCCTTCTTC",17,77,50,11,159,314,20047
"TGGCGTGCACCTGCAG",1,4,5,0,2,12,63
"TGGCGTGCATAAGATG",22,209,214,23,61,529,27545
"TGGCGTGGTCGAACAG",7,48,13,3,16,87,1755
"TGGGAAGCAAGGCGTA",43,132,340,26,71,612,35483
"TGGGAAGGTTTACTTC",33,118,220,21,151,543,33452
"TGGGAGACACTGCGTG",13,46,36,3,17,115,4408
"TGGGAGACAGAGAATT",18,146,74,15,71,324,10327
"TGGGAGAGTTGTTGTG",3,42,11,5,16,77,2632
"TGGGATTCAGGCCTGT",6,36,15,6,6,69,1838
"TGGGATTGTGGCCACT",4,49,18,0,17,88,168
"TGGGATTGTTTCCATT",4,44,26,2,8,84,186
"TGGGCGTCAAAGCTCT",15,77,61,9,99,261,11559
"TGGGCGTCAATCTCGA",5,77,30,2,19,133,2920
"TGGGCGTCAGCAGTAG",18,240,87,23,48,416,15338
"TGGGCGTTCCACCTGT",5,53,30,3,18,109,3819
"TGGGCGTTCCAGCAAT",11,125,43,8,17,204,7547
"TGGGCTGAGACGCTCC",3,59,11,5,10,88,3540
"TGGGCTGGTGTCCTAA",1,22,5,0,4,32,482
"TGGGTTACAGACAAGC",5,85,26,32,20,168,9979
"TGGGTTATCGACCTAA",6,52,30,3,19,110,1932
"TGGTACACAAGGGTCA",8,27,10,2,8,55,271
"TGGTACATCCACTGAA",8,84,23,7,20,142,2476
"TGGTAGTAGCAAGCCA",13,71,43,13,91,231,11112
"TGGTAGTAGGTGGGTT",64,599,199,47,178,1087,71938
"TGGTAGTCATCTCGTC",24,179,96,17,47,363,15217
"TGGTAGTGTTAAACCC",17,114,49,6,67,253,8763
"TGGTGATAGGCGACAT",14,112,49,10,87,272,9239
"TGGTGATCATATGAAG",0,6,4,0,0,10,29
"TGGTGATTCACTCTTA",10,79,37,6,34,166,3143
"TGGTGATTCGCGTTTC",4,21,21,6,13,65,1866
"TGGTGATTCTCGTGGG",86,212,128,463,103,992,49604
"TGGTTAGAGGTCGCCT",8,31,28,3,36,106,4198
"TGGTTAGCAGAGAGGG",1,13,9,0,3,26,268
"TGGTTAGTCATCGTAG",32,94,45,8,26,205,5403
"TGTAACGTCCTGGCTT",16,63,55,10,82,226,12749
"TGTAAGCAGTTCGCAT",3,24,13,0,7,47,713
"TGTAAGCCACAGTACT",38,292,77,21,54,482,23049
"TGTAAGCGTAGACACG",7,53,28,0,13,101,2133
"TGTAAGCGTTAGGGAC",23,129,62,88,44,346,15264
"TGTAAGCTCTGACAGT",8,66,26,2,9,111,2154
"TGTACAGCAAAGGCAC",7,54,55,11,15,142,6432
"TGTACAGGTGGACCAA",5,39,12,6,10,72,2354
"TGTACAGGTTGTACGT",4,46,36,3,22,111,2316
"TGTACAGTCGATACAC",54,45,41,20,24,184,6671
"TGTCAGAAGGGAGGCA",8,51,58,3,25,145,6216
"TGTCAGAAGTGGTCAG",84,861,187,68,148,1348,69317
"TGTCAGACACTTCATT",2,49,21,7,17,96,2258
"TGTCCACAGAATGTTG",10,92,172,6,36,316,16043
"TGTCCACCAGTGTATC",51,537,121,36,90,835,41500
"TGTCCCAAGTGCTCGC",45,141,311,40,140,677,33941
"TGTCCCATCGAGCCAC",3,64,22,0,9,98,1947
"TGTCCTGCAATCGCAT",48,255,105,39,390,837,45325
"TGTCCTGTCACGGACC",4,20,14,2,9,49,1432
"TGTGAGTAGTATGAGT",21,104,40,7,27,199,9064
"TGTGAGTAGTTCTCTT",99,426,146,80,103,854,42174
"TGTGAGTCATCCGAGC",10,48,23,2,8,91,1706
"TGTGAGTTCGGACCAC",15,79,99,11,23,227,10124
"TGTGATGGTGAATAAC",49,406,126,31,107,719,42729
"TGTGATGTCACTTCTA",45,126,67,154,44,436,18803
"TGTGATGTCATCGCCT",5,50,27,6,15,103,1976
"TGTGCGGAGACTCTTG",30,147,57,15,41,290,9597
"TGTGCGGAGAGCCGAT",6,53,23,3,8,93,1880
"TGTGGCGAGAGTCAAT",4,42,16,3,8,73,1933
"TGTGGCGAGCAATTAG",19,125,58,18,182,402,18701
"TGTGGCGAGGTGCTTT",10,45,54,6,33,148,5113
"TGTGGCGAGTGGCCTC",17,87,64,14,147,329,16164
"TGTGGCGCAGCGACCT",25,93,276,30,61,485,32039
"TGTGGCGGTAACTGCT",8,79,33,6,26,152,4797
"TGTGGCGGTCACTACA",9,77,47,7,17,157,5263
"TGTGGCGGTGCGAGTA",1,6,0,0,0,7,31
"TGTGGCGGTGGGAGAG",32,97,48,9,29,215,7203
"TGTGGCGTCCATCTAT",2,15,10,5,4,36,108
"TGTGTGAAGCGAGTAC",25,165,46,14,40,290,17468
"TGTGTGAGTCTACGAT",8,51,68,7,16,150,7274
"TGTGTGAGTTCGAACT",20,97,189,15,48,369,22606
"TGTTACTAGCACACCC",2,19,15,2,8,46,82
"TGTTCCGCACAAAGTA",66,728,214,43,137,1188,56824
"TGTTCCGCATCAGTGT",27,112,63,14,174,390,19474
"TGTTCTAGTCCATACA",10,56,32,4,16,118,1918
"TGTTCTAGTGCTGCAC",8,137,52,10,32,239,13561
"TGTTCTATCTAAGAAG",3,21,14,0,6,44,389
"TGTTGAGAGCTCCGAC",14,74,113,8,55,264,12722
"TGTTGAGCAGTAACAA",8,66,39,2,17,132,2718
"TGTTTGTAGGACGCAT",45,113,87,230,60,535,26902
"TGTTTGTGTGAGAACC",74,225,739,54,133,1225,82509
"TGTTTGTTCGAGATAA",9,65,18,0,12,104,3610
"TGTTTGTTCGGTGTTA",9,113,50,10,28,210,8933
"TTAATCCAGGCTATCT",2,3,3,0,0,8,23
"TTACCATGTAGTGCGA",21,85,153,18,75,352,20730
"TTACCATGTCCTGGTG",11,59,30,4,86,190,8494
"TTACCATTCTTCGGTC",45,117,390,37,86,675,33242
"TTACGCCGTAGCTTTG",36,67,29,39,20,191,5881
"TTACGCCGTTGACGGA",282,502,137,46,119,1086,57027
"TTACGCCTCCACGTAA",266,366,126,49,94,901,55121
"TTAGGCAGTGTCTAAC",1,10,5,0,3,19,418
"TTAGGGTAGTAAACAC",58,487,121,34,105,805,39761
"TTAGGGTTCCCACAGG",16,81,107,13,27,244,11514
"TTAGTCTAGCTGTTCA",8,86,33,3,20,150,5747
"TTAGTCTTCCCGAAAT",10,21,14,0,7,52,768
"TTAGTCTTCTTAAGGC",64,83,42,11,35,235,7040
"TTATTGCAGGTCCCGT",4,32,12,5,7,60,2025
"TTATTGCCAAGTGGCA",0,7,0,0,3,10,20
"TTCAATCAGGCGAAGG",22,286,72,15,48,443,22180
"TTCACCGAGGTCGAGT",0,0,2,0,0,2,26
"TTCACCGGTAGATCGG",1,5,2,0,2,10,54
"TTCACCGGTTGCAAGG",18,96,90,19,94,317,16082
"TTCACCGTCCATATGG",49,468,111,35,91,754,46078
"TTCACGCCAATGTTGC",17,80,162,8,31,298,18550
"TTCACGCCAGAGGTAC",9,80,74,9,15,187,6929
"TTCACGCCATTGTCGA",20,217,44,15,33,329,15443
"TTCAGGACAACGGCCT",22,177,53,14,37,303,17164
"TTCAGGACAGTGTATC",10,81,44,2,21,158,5518
"TTCAGGAGTTGCCTAA",4,34,12,0,8,58,115
"TTCAGGATCATTGTGG",11,148,51,8,35,253,12055
"TTCAGGATCCTCACCA",3,14,11,0,6,34,269
"TTCATGTCAGGACGAT",5,51,32,0,15,103,1655
"TTCATTGAGAAGGCTC",6,69,28,6,19,128,3293
"TTCCAATGTGGAGGTT",3,39,9,2,6,59,3165
"TTCCAATGTGTCGCTG",1,14,11,0,2,28,405
"TTCCACGGTATGAAGT",5,70,18,2,18,113,4892
"TTCCACGTCAGTGTCA",4,31,24,3,13,75,2165
"TTCCGTGCAGGACTAG",15,89,44,11,101,260,11903
"TTCCGTGTCCATTTGT",3,26,11,0,8,48,210
"TTCCTCTCAATTGTGC",1,7,5,2,6,21,346
"TTCCTCTTCATTATCC",27,228,57,16,45,373,16001
"TTCCTTCCAAAGCGTG",1,59,24,5,14,103,2328
"TTCCTTCGTATGGAAT",5,62,18,4,19,108,1742
"TTCCTTCTCGAGAAGC",38,324,70,29,50,511,24845
"TTCGATTAGCTGGCTC",1,15,4,0,4,24,656
"TTCGATTAGTCTGCGC",6,40,17,0,8,71,161
"TTCGCTGAGACGGTCA",16,75,51,11,109,262,13446
"TTCGCTGCAAAGGCAC",6,62,22,4,22,116,3087
"TTCGCTGCAACTTGGT",7,72,22,5,11,117,3942
"TTCGGTCCATTGAAAG",15,116,49,7,88,275,16539
"TTCGGTCTCAGCTTCC",22,86,39,0,20,167,5183
"TTCGGTCTCGTTATCT",22,198,54,62,34,370,16301
"TTCTAACAGTGACCTT",6,83,53,5,76,223,8559
"TTCTAACTCATCAGTG",55,93,38,3,31,220,7911
"TTCTAGTAGGAAGTCC",0,19,6,0,7,32,344
"TTCTAGTAGGTAGACC",8,58,38,0,12,116,3052
"TTCTAGTAGTCTAGAA",44,370,161,33,82,690,34242
"TTCTAGTCAGCAATTC",64,638,156,52,110,1020,56871
"TTCTAGTGTATCGCTA",19,178,45,12,37,291,15283
"TTCTCTCAGTCTCCTC",16,129,33,4,24,206,9682
"TTCTCTCCACTACCCT",9,59,32,4,40,144,4548
"TTCTCTCCAGGTCTCG",15,147,36,8,31,237,12134
"TTCTTCCAGAATCGTA",12,49,23,5,5,94,2016
"TTCTTCCTCACCGGGT",2,46,23,6,12,89,2030
"TTCTTGAAGATCGCTT",4,57,31,8,36,136,4564
"TTCTTGAGTACAGAAT",33,174,242,30,129,608,38456
"TTGAACGGTATATGGA",0,14,4,0,4,22,619
"TTGAACGTCACCCTGT",16,57,36,64,23,196,7257
"TTGAGTGAGGTGAGAA",15,55,15,5,14,104,2299
"TTGAGTGCAAACTAAG",5,56,42,4,31,138,5278
"TTGATGGCATGTGCTA",29,335,75,26,59,524,28782
"TTGATGGGTCAAATCC",20,93,32,7,18,170,5558
"TTGCATTAGCCTGAAG",12,77,74,14,56,233,9352
"TTGCATTAGTGCAGGT",12,75,37,5,21,150,3731
"TTGCATTTCGTCTACC",5,8,5,0,2,20,723
"TTGCCTGCAGCTTCGG",9,73,45,4,53,184,9857
"TTGCCTGTCTCTTAAC",5,14,18,0,13,50,1369
"TTGCGTCAGTCCTACA",164,234,213,30,96,737,32831
"TTGCGTCCATGTTCAG",13,74,132,12,32,263,16154
"TTGCGTCTCCTCAGAA",29,354,128,21,55,587,26544
"TTGGGATAGCTAGCCC",12,81,90,5,33,221,10835
"TTGGGCGCATCGCTCT",5,72,34,5,55,171,6906
"TTGGTTTAGACCTTTG",20,115,149,12,47,343,15070
"TTGGTTTAGTGCAAAT",14,99,54,6,29,202,9083
"TTGGTTTCATTACTCT",476,3059,1045,289,698,5567,314273
"TTGGTTTGTACGGTTT",9,79,60,3,26,177,6622
"TTGGTTTGTCTTCCGT",26,96,173,16,41,352,16680
"TTGGTTTTCGACGCTG",8,49,32,6,71,166,7482
"TTGTGGACAGAATTCC",18,190,71,22,35,336,15200
"TTGTGGAGTACTGAGG",22,95,141,18,77,353,18682
"TTGTGTTAGGTAAAGG",8,51,49,9,37,154,6240
"TTGTGTTAGTCCGTCG",3,52,25,2,10,92,2549
"TTGTGTTCAAGAGTGC",10,67,38,4,40,159,4720
"TTGTGTTCAGAACTAA",3,44,19,3,12,81,2978
"TTGTGTTCAGCTACTA",1,33,33,0,14,81,2024
"TTGTGTTCATAGCTGT",3,45,30,6,17,101,3381
"TTGTGTTCATTGTCGA",33,321,82,28,58,522,20427
"TTGTGTTGTGTTGACT",11,36,21,8,69,145,6289
"TTGTTCAAGCCTCTTC",3,85,31,8,16,143,4123
"TTGTTCAAGCTTGTTG",11,145,36,10,28,230,10420
"TTGTTCAGTGGTATGG",4,55,30,8,15,112,3105
"TTGTTGTGTCTTGGTA",1,89,28,5,14,137,3603
"TTGTTGTGTGAGGAAA",31,124,270,28,67,520,32950
"TTGTTTGGTGAATAAC",9,80,35,4,27,155,2474
"TTTACCAGTCTCGCGA",20,183,48,10,27,288,11146
"TTTACCAGTGCTCCGA",64,243,76,20,50,453,20548
"TTTACGTAGACCATAA",0,8,3,0,0,11,54
"TTTACGTAGGGTGAGG",10,62,25,0,20,117,2542
"TTTACGTCACAGTCCG",32,80,44,9,22,187,5920
"TTTACGTTCTCTGCTG",4,40,15,3,10,72,2040
"TTTACTGAGAGGTTTA",18,80,86,17,90,291,10744
"TTTACTGAGCTTGTTG",8,79,27,5,14,133,3892
"TTTACTGAGGATGTTA",3,32,23,2,14,74,196
"TTTACTGCAACGGTAG",14,118,38,10,21,201,6920
"TTTAGTCAGGCACAAC",45,168,151,38,305,707,38924
"TTTAGTCCAGCATCTA",1,20,8,0,0,29,1370
"TTTAGTCTCGAGCACC",28,116,278,26,68,516,30369
"TTTAGTCTCTGTCTCG",14,108,43,6,26,197,8082
"TTTATGCAGGACCCAA",16,183,44,6,47,296,11726
"TTTCACAAGCTGGCTC",32,316,106,19,53,526,31364
"TTTCACAGTAGCTTAC",10,129,41,6,20,206,8295
"TTTCACAGTTGCAACT",10,63,39,4,17,133,2730
"TTTCAGTCAGACACCC",30,92,52,22,164,360,18028
"TTTCAGTGTAGAATAC",1,25,21,0,10,57,1492
"TTTCATGGTGAGTGAC",13,40,22,0,12,87,2444
"TTTCATGTCGCAGTGC",32,216,160,29,144,581,25192
"TTTCATGTCGGTAGGA",10,63,48,5,21,147,5497
"TTTCCTCGTATGTCCA",65,333,97,26,63,584,25594
"TTTCGATAGTCCTGTA",18,207,57,5,33,320,13231
"TTTCGATGTAGGTGCA",4,38,11,0,7,60,2298
"TTTCGATTCGAATGCT",17,130,54,12,27,240,9142
"TTTGACTGTATCGTGT",6,71,24,5,14,120,2209
"TTTGATCAGTTGGAAT",3,21,0,0,6,30,1001
"TTTGATCGTCTACACA",84,86,52,15,33,270,8490
"TTTGATCTCGGTTAGT",48,150,60,14,31,303,13569
"TTTGATCTCTTCGTGC",3,15,10,0,4,32,78
"TTTGGAGAGAGGATGA",12,91,41,45,32,221,8358
"TTTGGTTAGGTCGTAG",45,145,406,33,93,722,48543
"TTTGGTTGTAGGGTAC",36,111,263,28,56,494,31612
"TTTGGTTTCGGACTTA",5,74,30,2,24,135,2911
"TTTGTTGGTCGACTTA",5,64,30,3,21,123,2867
"TTTGTTGGTTTGGCTA",0,38,14,0,7,59,573
"TTTGTTGTCGTAATGC",0,6,8,3,3,20,370
