"","Bar1","Bar2","Bar3","Bar4","Bar5","nUMI","nUMI_total"
"AAACCCAAGTGGATAT",3,12,0,0,0,15,106
"AAACCCACACAGTGAG",3,19,2,2,3,29,554
"AAACCCACAGAGGACT",0,0,2,0,0,2,63
"AAACCCATCAACTCTT",1,6,2,0,0,9,220
"AAACCCATCAGACATC",1,2,0,0,0,3,19
"AAACGAAAGCGATGAC",7,35,41,4,11,98,4218
"AAACGAACAAGGTCAG",1,20,3,3,4,31,480
"AAACGAACAGCTTCCT",0,3,3,0,2,8,139
"AAACGAACATATGAAG",1,6,2,2,0,11,75
"AAACGAAGTACCAATC",2,13,2,0,2,19,759
"AAACGAAGTCAAGTTC",0,3,3,0,0,6,185
"AAACGAAGTCTTGGTA",3,9,7,0,0,19,463
"AAACGCTAGACCTCAT",1,3,0,0,0,4,219
"AAACGCTAGGTAAGAG",0,3,0,0,0,3,78
"AAACGCTAGGTGATAT",5,28,3,0,3,39,640
"AAACGCTAGTCCCTAA",1,3,3,0,0,7,174
"AAACGCTAGTGCGTCC",0,23,6,2,4,35,1464
"AAACGCTAGTTGTAAG",0,9,3,0,0,12,112
"AAACGCTCAAGGCTTT",13,111,26,12,26,188,5888
"AAACGCTCAAGTCCAT",3,7,0,0,0,10,173
"AAACGCTCAGAGTCAG",1,15,4,0,0,20,800
"AAACGCTGTCCATAGT",2,22,4,0,2,30,858
"AAACGCTGTGTTCAGT",4,24,8,0,8,44,1344
"AAACGCTTCCAGTGTA",0,3,0,0,0,3,24
"AAACGCTTCGTTCCCA",2,4,0,0,0,6,140
"AAAGAACAGGACGGAG",68,255,171,35,493,1022,44763
"AAAGAACAGGGTGAGG",1,28,2,0,4,35,323
"AAAGAACCACCTGCTT",2,18,4,0,4,28,529
"AAAGAACCAGCAGAAC",0,0,0,0,0,0,24
"AAAGAACGTAGTGATA",1,7,2,0,0,10,156
"AAAGAACGTATGAGCG",0,2,2,0,0,4,66
"AAAGAACGTCAAATCC",0,4,0,0,0,4,241
"AAAGAACTCACCTGTC",1,6,4,0,0,11,323
"AAAGAACTCGAGTACT",0,5,0,0,0,5,102
"AAAGAACTCGGAGATG",0,2,0,0,2,4,81
"AAAGAACTCTATGTGG",4,28,31,3,8,74,3039
"AAAGGATAGCACACCC",3,8,7,0,0,18,115
"AAAGGATAGCTTTCCC",11,59,149,11,27,257,13560
"AAAGGATCACAAGGTG",17,62,35,5,90,209,9275
"AAAGGATGTATGAGGC",0,7,2,0,0,9,102
"AAAGGATGTCCAGGTC",9,37,26,0,8,80,3257
"AAAGGATGTCTTGCTC",0,6,2,0,0,8,133
"AAAGGATGTTTCCATT",0,0,0,0,0,0,22
"AAAGGATTCTTGGGCG",0,0,2,0,0,2,17
"AAAGGGCAGCACACCC",0,4,0,0,0,4,173
"AAAGGGCAGCCAGAGT",2,2,0,0,4,8,63
"AAAGGGCAGCCGAACA",0,0,2,0,2,4,27
"AAAGGGCCATAATCGC",0,0,0,0,0,0,19
"AAAGGGCGTGACACAG",72,171,423,40,145,851,42991
"AAAGGTAAGACGGTCA",2,17,7,0,0,26,626
"AAAGGTAAGCACCAGA",4,21,2,0,3,30,72
"AAAGGTAAGGACGCTA",0,0,0,0,0,0,83
"AAAGGTAGTACAAGTA",0,8,0,0,2,10,224
"AAAGGTATCGATGCTA",7,36,10,0,4,57,1083
"AAAGTCCAGAGTGTTA",0,0,0,0,0,0,4
"AAAGTCCAGCTTGTGT",65,471,140,37,80,793,41777
"AAAGTCCAGGTTGCCC",3,29,14,0,10,56,1376
"AAAGTCCAGTAAACGT",0,4,0,0,0,4,34
"AAAGTCCAGTCCGCCA",1,2,0,0,0,3,103
"AAAGTCCCAAAGCTCT",1,19,5,0,2,27,603
"AAAGTCCCACCTGAAT",1,13,4,2,6,26,1027
"AAAGTCCCAGGTTCGC",1,4,0,0,0,5,84
"AAAGTCCCATCCGTGG",1,6,0,0,0,7,189
"AAAGTCCGTACCTAAC",1,21,3,0,4,29,593
"AAAGTGAAGAGAATCT",20,37,14,2,13,86,2844
"AAAGTGAAGCACTGGA",6,67,17,5,11,106,7194
"AAAGTGACAGGAGGAG",1,6,0,0,3,10,114
"AAAGTGACATGACTGT",2,23,7,2,2,36,770
"AAAGTGACATTCTCCG",0,0,0,0,0,0,21
"AAAGTGAGTACGACAG",0,2,2,0,0,4,74
"AAAGTGAGTGCGGTAA",0,12,4,0,2,18,298
"AAAGTGAGTTTACCAG",1,14,2,2,3,22,257
"AAAGTGATCTAGAGCT",0,3,0,0,0,3,20
"AAAGTGATCTCCAATT",1,6,0,0,2,9,189
"AAATGGAAGATCCCGC",2,22,7,0,6,37,580
"AAATGGAAGCACGGAT",4,21,19,0,5,49,1929
"AAATGGAAGCAGTAAT",1,26,5,2,5,39,544
"AAATGGACAAGCCTGC",1,5,2,0,0,8,121
"AAATGGACACCATATG",12,51,18,67,25,173,7800
"AAATGGAGTAACCCTA",316,147,77,21,63,624,24716
"AAATGGATCCTTGAAG",0,2,0,0,0,2,15
"AAATGGATCGCGCTGA",0,0,0,0,0,0,9
"AACAAAGAGGCACTAG",1,0,0,0,0,1,4
"AACAAAGCACATTCGA",0,5,3,2,3,13,419
"AACAAAGCAGCTGAAG",0,2,2,0,0,4,21
"AACAAAGCATGCCGGT",2,4,2,0,2,10,216
"AACAAAGGTAAGCAAT",14,59,97,7,19,196,9895
"AACAAAGGTTCGGTTA",1,0,0,0,2,3,5
"AACAAAGGTTGCCATA",19,68,50,13,142,292,14861
"AACAAAGGTTTCGTAG",0,3,0,0,0,3,66
"AACAACCAGAATCCCT",6,23,22,2,31,84,3865
"AACAACCAGAGGCGGA",0,3,0,0,0,3,114
"AACAACCAGCTCTTCC",4,25,13,2,6,50,1064
"AACAACCAGGTGCTAG",9,85,13,7,16,130,6373
"AACAACCAGTCATTGC",39,142,37,13,36,267,10622
"AACAACCAGTGCACTT",1,2,0,0,0,3,123
"AACAACCAGTGGTTGG",0,12,5,0,0,17,153
"AACAACCGTGTGTCCG",3,9,3,4,4,23,628
"AACAACCGTTGCTGAT",0,3,0,0,0,3,15
"AACAACCTCTATGTGG",2,18,3,0,2,25,462
"AACAAGACACTCTAGA",0,6,0,2,0,8,144
"AACAAGACAGCACCCA",35,98,227,13,45,418,18105
"AACAAGATCACTGAAC",1,4,3,0,0,8,180
"AACAAGATCCGTGCGA",0,4,3,0,0,7,76
"AACACACCAAGTTTGC",1,30,8,2,0,41,759
"AACACACCACACCTAA",1,7,0,0,0,8,151
"AACACACCAGAGTTCT",2,15,8,0,0,25,239
"AACACACCATAGTCAC",2,34,7,0,5,48,1434
"AACACACTCATAGACC",0,2,0,0,0,2,16
"AACACACTCGCTTGAA",0,4,0,0,0,4,19
"AACAGGGAGCGCCTCA",14,77,22,3,17,133,6608
"AACAGGGAGGTAGCAC",0,0,0,0,2,2,145
"AACAGGGGTGTTGAGG",30,85,165,11,37,328,16070
"AACAGGGTCACGAGGA",1,6,0,0,2,9,163
"AACAGGGTCCCTAGGG",47,112,337,17,63,576,30265
"AACCAACAGCTCGCAC",1,17,4,0,2,24,601
"AACCAACCAAAGAACT",1,7,3,0,0,11,80
"AACCAACCAAGTTTGC",90,249,699,37,153,1228,58724
"AACCAACCACGACAAG",1,10,2,0,0,13,748
"AACCAACCAGTCGTTA",561,627,120,31,82,1421,34666
"AACCAACGTGATATAG",5,55,25,0,6,91,2226
"AACCAACTCGTGGGTC",1,8,3,0,0,12,245
"AACCAACTCTAGCCAA",0,2,0,0,0,2,13
"AACCACAAGCGTTGTT",0,3,0,0,0,3,182
"AACCACAAGGTATAGT",19,78,135,8,22,262,13169
"AACCACACAACACTAC",0,5,2,0,0,7,146
"AACCACACACGGTCTG",5,42,16,4,28,95,3479
"AACCACAGTGCTTATG",5,18,12,4,26,65,3373
"AACCACAGTTCTCCAC",0,3,0,0,0,3,24
"AACCACATCAAAGCCT",2,23,5,0,3,33,2215
"AACCACATCAGGAAGC",3,13,4,0,3,23,456
"AACCATGAGACCATAA",72,442,153,37,81,785,36349
"AACCATGCAAACTGCT",4,23,9,0,7,43,542
"AACCATGGTCGGCACT",0,4,0,0,0,4,118
"AACCATGGTTTGGAGG",13,84,28,4,51,180,7294
"AACCATGTCCCGATCT",0,3,4,0,0,7,88
"AACCATGTCGGACAAG",32,272,73,17,45,439,18327
"AACCATGTCGGTTAGT",1,2,0,0,0,3,38
"AACCCAACAACGAGGT",0,0,0,0,2,2,170
"AACCCAACAATAGTAG",18,102,50,120,36,326,13693
"AACCCAAGTACAGTCT",0,4,3,0,2,9,228
"AACCCAAGTTAACCTG",2,0,2,0,0,4,89
"AACCCAAGTTGGTACT",13,40,64,8,10,135,5540
"AACCCAATCTTCTTCC",1,4,0,0,0,5,175
"AACCTGAAGGGAGGAC",0,4,0,0,0,4,16
"AACCTGAAGTCATACC",0,2,0,0,0,2,15
"AACCTGAAGTTTCGGT",41,121,115,21,282,580,27536
"AACCTGACAAATGCTC",1,7,2,0,2,12,239
"AACCTGACATCCAATG",2,25,3,0,4,34,876
"AACCTGAGTACCAATC",0,5,0,0,0,5,52
"AACCTGATCCGTCAAA",1,21,7,0,6,35,803
"AACCTTTAGACCAGCA",4,3,0,0,0,7,164
"AACCTTTAGCCTGGAA",1,4,0,0,0,5,174
"AACCTTTCAACAGCCC",4,13,0,0,0,17,400
"AACCTTTCAAGAGTAT",0,7,0,2,0,9,161
"AACCTTTCACAATCTG",2,18,7,0,0,27,1044
"AACCTTTCACCAAATC",5,21,8,0,4,38,621
"AACCTTTCATCCTATT",2,3,2,0,0,7,37
"AACCTTTGTGCAAGAC",109,703,227,37,142,1218,60098
"AACCTTTGTGGGATTG",0,0,0,0,0,0,3
"AACCTTTTCGAACGCC",1,14,2,0,0,17,549
"AACCTTTTCGACGATT",0,0,0,0,0,0,16
"AACGAAAAGCTACAAA",1,16,4,2,0,23,564
"AACGAAACAAGCGAAC",4,23,8,0,11,46,1296
"AACGAAACATCGTGCG",2,20,7,3,9,41,673
"AACGGGAAGACATGCG",0,0,0,0,0,0,18
"AACGGGAAGACTAGAT",0,5,0,0,0,5,132
"AACGGGAAGACTTCGT",0,9,4,0,0,13,287
"AACGGGAAGCGCTTCG",0,0,0,0,0,0,55
"AACGGGAAGGGTACAC",5,26,19,2,10,62,2330
"AACGGGAAGGTAGACC",0,2,0,0,0,2,70
"AACGGGAAGGTTAGTA",58,130,254,25,166,633,27566
"AACGGGAAGTCTCGTA",40,115,232,17,70,474,21539
"AACGGGAGTCATATGC",0,2,0,0,0,2,7
"AACGGGATCTGTGCTC",0,0,0,0,0,0,7
"AACGTCACAGTCGGTC",32,408,75,17,47,579,24092
"AACGTCACATAACTCG",0,5,3,0,0,8,64
"AACGTCAGTTCGTACA",4,17,8,2,2,33,837
"AACGTCATCCGACGGT",1,5,0,0,0,6,141
"AACGTCATCGATACAC",0,3,0,0,0,3,31
"AACGTCATCTCTGCTG",2,7,5,0,0,14,341
"AACTTCTAGACGCATG",25,87,49,189,42,392,18079
"AACTTCTAGTAATCCC",0,3,0,0,2,5,141
"AACTTCTCAGTGTATC",1,4,3,0,0,8,174
"AACTTCTGTTGCATCA",0,2,2,0,0,4,40
"AACTTCTTCAACTGGT",0,6,2,0,3,11,134
"AACTTCTTCCCAGCGA",0,2,0,0,0,2,119
"AACTTCTTCGCTACGG",0,6,4,0,0,10,52
"AACTTCTTCTGTCGTC",1,14,5,0,2,22,102
"AAGAACAAGGTGCGAT",0,12,3,0,0,15,87
"AAGAACACAACTTGGT",1,8,0,0,2,11,233
"AAGAACACACTACAGT",2,24,7,0,0,33,99
"AAGAACACATCTTAGG",1,3,0,0,0,4,96
"AAGAACATCATCACTT",152,66,50,10,34,312,11970
"AAGACAAAGCCGATTT",2,38,13,2,7,62,2307
"AAGACAACAAATCGTC",0,0,0,0,0,0,105
"AAGACAACACCAGCCA",3,11,3,0,4,21,147
"AAGACAACACTGTGTA",0,8,0,0,2,10,251
"AAGACAATCACAGTGT",1,4,3,0,0,8,258
"AAGACAATCTCTAGGA",0,10,3,0,0,13,130
"AAGACTCAGACGCCAA",0,4,0,0,2,6,139
"AAGACTCCAAAGGATT",0,6,2,0,3,11,229
"AAGACTCGTCAGCGTC",1,2,0,0,0,3,4
"AAGACTCGTTCCCAAA",0,5,0,0,0,5,64
"AAGACTCGTTGTTGTG",1,13,3,0,4,21,415
"AAGACTCTCATGGAGG",4,30,9,0,3,46,820
"AAGACTCTCGAGAATA",3,16,10,0,4,33,116
"AAGACTCTCGATACGT",0,9,0,0,0,9,436
"AAGACTCTCTCTAGGA",0,0,5,0,0,5,88
"AAGACTCTCTGACCCT",74,48,20,7,23,172,6494
"AAGATAGAGCCAACCC",13,56,94,6,39,208,8778
"AAGATAGGTCGGTGTC",0,6,2,0,0,8,126
"AAGATAGGTCTCGCGA",1,3,0,0,0,4,144
"AAGATAGGTTTAGTCG",7,38,31,3,6,85,3478
"AAGATAGTCACCTCAC",0,7,0,0,3,10,169
"AAGATAGTCAGCGGAA",1,2,0,0,0,3,14
"AAGCATCAGAGATCGC",0,5,2,0,2,9,16
"AAGCATCAGGTTCACT",0,5,4,0,0,9,222
"AAGCATCAGGTTCTAC",1,5,0,0,0,6,150
"AAGCATCCATTGCTGA",5,44,11,2,11,73,573
"AAGCATCGTATGAAAC",0,12,3,0,0,15,110
"AAGCATCTCTCGCAGG",2,13,11,0,4,30,1317
"AAGCCATCAACCAGAG",12,57,21,6,50,146,4708
"AAGCCATCAACTGATC",1,4,0,0,4,9,105
"AAGCCATGTGTCCAAT",7,30,34,4,8,83,2612
"AAGCCATTCGATACGT",0,2,0,0,0,2,64
"AAGCCATTCGCAATGT",8,29,17,4,21,79,3081
"AAGCGAGAGCAAGCCA",1,17,7,0,4,29,469
"AAGCGAGAGCGACAGT",23,183,39,12,34,291,15201
"AAGCGAGAGTAGTGCG",0,2,0,0,0,2,85
"AAGCGAGGTACAAGTA",2,22,10,0,5,39,565
"AAGCGAGTCCCGGTAG",1,5,4,0,3,13,152
"AAGCGAGTCGAGATGG",1,6,3,0,0,10,424
"AAGCGAGTCTCCTGCA",4,11,5,0,0,20,1326
"AAGCGTTAGGACACTG",1,0,2,0,3,6,129
"AAGCGTTCAGCTTCCT",63,195,245,35,295,833,39854
"AAGCGTTGTACGAGTG",2,20,20,2,5,49,1681
"AAGCGTTGTATGAAAC",0,0,0,0,0,0,3
"AAGGAATCAATCCAGT",11,42,68,9,15,145,6063
"AAGGAATCACAAGCAG",0,3,3,0,0,6,242
"AAGGAATGTATTTCGG",5,24,7,0,7,43,914
"AAGGAATTCCACCTCA",0,0,0,0,0,0,27
"AAGGAATTCGGTCGAC",16,86,89,53,22,266,12415
"AAGGTAAAGAGATCGC",6,29,37,5,10,87,3955
"AAGGTAAAGATTGATG",2,3,0,0,0,5,53
"AAGGTAAAGCCAGACA",0,6,0,0,2,8,85
"AAGGTAAAGCGTCGAA",0,3,0,0,0,3,44
"AAGGTAACACGGTGCT",2,23,5,0,8,38,1461
"AAGGTAAGTTCAGCTA",31,67,41,8,134,281,11009
"AAGGTAATCAGCTAGT",92,507,221,48,116,984,47157
"AAGGTAATCGTAGGAG",0,2,0,0,0,2,55
"AAGTACCCAACAAGTA",332,159,78,23,76,668,28398
"AAGTACCCACTGGATT",1,29,11,0,5,46,473
"AAGTACCCAGTAGGAC",1,10,4,3,4,22,284
"AAGTACCGTAACATGA",2,14,4,0,6,26,108
"AAGTACCGTTCTCTCG",0,8,3,2,0,13,278
"AAGTACCTCAACGTGT",2,14,5,2,6,29,642
"AAGTCGTAGCCTCCAG",1,8,5,0,6,20,342
"AAGTCGTCACTGTGTA",1,13,5,0,2,21,409
"AAGTCGTCAGTTGTTG",0,3,4,0,0,7,76
"AAGTCGTTCTAAGGAA",11,37,46,4,12,110,3621
"AAGTGAACAGATTCGT",6,33,15,0,5,59,1059
"AAGTGAAGTGTAGGAC",2,26,15,0,11,54,1019
"AAGTGAATCCACGTGG",0,14,3,0,0,17,81
"AAGTTCGAGACGAGCT",1,5,0,0,0,6,90
"AAGTTCGAGCTAGAAT",0,4,0,0,2,6,262
"AAGTTCGAGTGCACAG",0,5,0,0,0,5,210
"AAGTTCGAGTGCCTCG",0,8,2,0,0,10,335
"AAGTTCGAGTGGACTG",0,0,0,0,0,0,97
"AAGTTCGCACAACGTT",4,15,4,0,6,29,213
"AAGTTCGGTAGCACGA",2,2,2,0,0,6,87
"AAGTTCGGTTGCATGT",0,4,0,0,0,4,152
"AAGTTCGTCAAATAGG",18,124,42,12,25,221,10300
"AAGTTCGTCCCGTTGT",2,3,0,0,0,5,151
"AAGTTCGTCGAGAGAC",0,5,2,0,2,9,62
"AAGTTCGTCGGCCTTT",42,123,286,12,52,515,22727
"AATAGAGAGGGCAGGA",18,31,9,0,8,66,1907
"AATAGAGGTCGCTTGG",2,9,0,0,0,11,25
"AATAGAGTCGAACCTA",15,137,39,12,22,225,6571
"AATAGAGTCTGCGAGC",2,22,4,0,4,32,128
"AATCACGCATTGAAAG",4,20,28,5,12,69,3323
"AATCACGCATTGCAAC",0,0,0,0,0,0,0
"AATCACGGTGCATTTG",1,4,6,0,7,18,854
"AATCACGGTTGGGCCT",2,11,4,0,2,19,535
"AATCACGGTTTGGAAA",23,74,165,13,38,313,15381
"AATCACGTCACACGAT",0,2,0,0,0,2,42
"AATCACGTCCCGAGTG",2,20,4,0,0,26,781
"AATCGACCATTCACAG",0,12,0,0,2,14,267
"AATCGACGTGCTGTCG",1,7,5,0,0,13,71
"AATCGACTCAAATGAG",3,32,10,2,6,53,873
"AATCGACTCAAGAGGC",4,40,3,2,2,51,629
"AATCGACTCCCTTTGG",3,12,4,0,3,22,49
"AATCGACTCGACATAC",6,44,10,0,15,75,1500
"AATCGACTCTCCCATG",0,0,0,0,0,0,59
"AATCGACTCTTCACAT",0,6,2,0,2,10,260
"AATCGTGAGGCATCAG",1,11,7,0,0,19,443
"AATCGTGAGGTCGACA",1,3,0,0,0,4,21
"AATCGTGCACGGTGCT",2,3,4,0,0,9,57
"AATCGTGCAGTCGAGA",10,72,13,7,11,113,3679
"AATCGTGGTAGATCGG",9,55,15,4,12,95,2004
"AATCGTGGTAGTCGGA",1,8,0,0,0,9,262
"AATCGTGGTCGATTCA",2,6,0,0,0,8,165
"AATCGTGGTGGATGAC",1,11,5,0,0,17,283
"AATCGTGGTTATCTTC",1,0,2,0,0,3,13
"AATCGTGTCTGACAGT",15,25,14,12,6,72,2555
"AATGAAGAGAGAATCT",19,33,11,0,10,73,1463
"AATGAAGAGAGAGTTT",6,21,13,2,7,49,612
"AATGAAGAGCACTAAA",2,12,0,0,2,16,117
"AATGAAGCATGCAGGA",1,6,5,0,3,15,399
"AATGAAGGTACCCAGC",1,22,13,0,2,38,546
"AATGAAGTCAACTACG",1,10,0,0,0,11,196
"AATGAAGTCATTTGGG",0,0,0,0,0,0,30
"AATGACCAGACGACTG",1,4,0,0,0,5,99
"AATGACCCAACGCCCA",2,19,3,0,5,29,755
"AATGACCCACTGTCGG",0,0,0,0,0,0,12
"AATGACCTCGTTGTAG",4,32,41,4,9,90,3906
"AATGCCAAGCTCAGAG",0,4,3,0,0,7,249
"AATGCCACACACGCCA",32,72,221,14,35,374,17766
"AATGCCACATCGTTCC",1,6,0,0,0,7,309
"AATGCCAGTCTTGAGT",0,5,0,0,0,5,215
"AATGCCAGTGATTGGG",16,132,41,12,29,230,10289
"AATGCCAGTGGGTCAA",1,2,0,0,0,3,134
"AATGCCATCCGAAATC",0,3,0,0,0,3,60
"AATGCCATCGGTCACG",1,7,0,0,0,8,205
"AATGGAACAAGATGTA",7,18,11,0,2,38,455
"AATGGAACAAGTTCGT",1,2,0,0,0,3,18
"AATGGAACATCACCAA",3,18,3,0,3,27,209
"AATGGAAGTCTTACTT",2,10,0,0,3,15,165
"AATGGAATCAACCCGG",0,0,0,0,0,0,1
"AATGGCTAGATCGGTG",2,7,2,3,2,16,502
"AATGGCTCACCGCTAG",19,134,29,8,14,204,11359
"AATGGCTCACTTACAG",20,182,40,8,23,273,13731
"AATGGCTCAGGCACAA",7,46,16,2,12,83,2972
"AATGGCTCATCTGCGG",1,28,9,0,4,42,1356
"AATGGCTGTCAAGGCA",7,30,12,3,6,58,1901
"AATGGCTGTCGCTCGA",6,23,5,0,5,39,740
"AATGGCTGTCTAATCG",0,0,0,0,0,0,15
"AATGGCTTCCGTGGGT",0,0,0,0,0,0,42
"AATGGCTTCTAGCAAC",196,1296,327,98,250,2167,101679
"AATTCCTAGATAACAC",0,0,0,0,0,0,17
"AATTCCTAGCTAGCCC",0,19,4,2,5,30,902
"AATTCCTAGGTCCAGA",124,800,231,58,165,1378,72111
"AATTCCTCACGTAGAG",6,20,6,0,5,37,1711
"AATTCCTCAGTATTCG",3,20,2,0,4,29,710
"AATTCCTTCCCAACTC",0,8,2,0,0,10,283
"AATTTCCAGAGCAACC",0,7,0,0,0,7,60
"AATTTCCAGATGCTGG",3,27,6,4,15,55,1848
"AATTTCCAGCGTCTGC",0,0,0,0,0,0,4
"AATTTCCAGTCTCCTC",68,181,110,24,456,839,43750
"AATTTCCGTGTTTGCA",0,2,0,0,0,2,21
"AATTTCCTCCCTCTCC",1,6,2,0,5,14,139
"AATTTCCTCTGCGTCT",1,38,10,0,12,61,832
"ACAAAGAAGCAGTCTT",0,11,0,0,0,11,210
"ACAAAGAAGCATCAAA",0,8,2,0,0,10,151
"ACAAAGAAGCTGACAG",2,5,0,0,5,12,223
"ACAAAGAAGGAAGTAG",307,2033,465,138,368,3311,164611
"ACAAAGAAGGTAATCA",4,8,2,0,2,16,181
"ACAAAGAGTCATCGCG",0,7,2,0,3,12,247
"ACAAAGATCTGAACGT",13,86,33,7,26,165,5428
"ACAACCAAGACTCAAA",2,36,8,0,7,53,677
"ACAACCAAGCGGATCA",5,14,3,0,0,22,436
"ACAACCAAGCTCACTA",0,6,3,0,0,9,57
"ACAACCACAGGCTACC",0,0,0,0,0,0,6
"ACAACCAGTAATGCGG",15,52,23,8,88,186,8606
"ACAACCAGTTGATCGT",1,7,5,0,2,15,497
"ACAACCATCCTACTGC",0,0,0,0,0,0,8
"ACAACCATCGAACGGA",0,4,0,0,0,4,76
"ACAAGCTAGGCGAAGG",5,20,22,0,3,50,1832
"ACAAGCTCAACGATTC",5,31,13,0,5,54,1580
"ACAAGCTGTAACCAGG",0,4,0,0,0,4,156
"ACAAGCTGTTGGACTT",11,35,30,3,14,93,3553
"ACAAGCTTCAGCGTCG",5,40,12,2,10,69,1283
"ACACAGTAGTTGCTGT",0,8,0,0,2,10,177
"ACACAGTCACGACGTC",21,68,42,5,116,252,11829
"ACACAGTCATCGAACT",58,205,61,82,47,453,18153
"ACACAGTGTGTAACGG",0,0,0,0,0,0,4
"ACACAGTTCACACCCT",22,86,51,11,215,385,18762
"ACACAGTTCAGCGCGT",0,17,3,0,3,23,514
"ACACAGTTCCGTGCGA",2,3,0,0,0,5,71
"ACACCAAAGAGCCCAA",0,2,0,0,0,2,216
"ACACCAAAGGACAGTC",0,9,0,0,0,9,107
"ACACCAAAGGGCGAGA",0,4,2,0,0,6,50
"ACACCAAAGTACCCTA",0,0,0,0,0,0,14
"ACACCAACAAATGATG",72,565,141,31,101,910,38859
"ACACCAACAATCGCCG",1,10,0,0,0,11,109
"ACACCAACATAACTCG",1,11,4,0,2,18,111
"ACACCAACATCCCACT",2,22,5,2,5,36,744
"ACACCAACATGCGGTC",0,4,0,0,0,4,146
"ACACCAATCCTACTGC",1,4,2,0,0,7,237
"ACACGCGAGCATGTTC",1,4,2,0,0,7,361
"ACACGCGCACGGCGTT",5,14,4,0,5,28,572
"ACACGCGGTGAACCGA",1,0,2,0,0,3,14
"ACACGCGTCAAGTCTG",2,23,2,0,0,27,454
"ACACGCGTCACTCGAA",2,22,6,0,0,30,520
"ACACTGAAGACTTCGT",72,360,97,32,71,632,32086
"ACACTGAAGCATCCCG",0,0,3,0,0,3,164
"ACACTGACAAGATTGA",0,8,4,0,0,12,220
"ACACTGACACTGAGGA",1,3,0,0,0,4,12
"ACACTGACAGCTTTGA",17,53,23,2,81,176,7700
"ACACTGAGTTCCATTT",0,4,0,0,0,4,62
"ACACTGATCCGCAACG",2,6,0,0,0,8,182
"ACAGAAAAGCAACTCT",0,5,2,0,0,7,177
"ACAGAAAAGCTCATAC",0,0,0,0,0,0,13
"ACAGAAATCATCACCC",19,171,39,12,28,269,11357
"ACAGCCGAGCCTGGAA",3,17,15,0,3,38,1256
"ACAGCCGCAGTGCGCT",1,11,0,0,2,14,867
"ACAGCCGGTGAGAACC",2,10,0,0,0,12,208
"ACAGCCGGTGTCCATA",1,6,0,0,2,9,15
"ACAGCCGTCATCCTGC",0,6,0,0,0,6,169
"ACAGCCGTCGGAATGG",2,11,2,0,0,15,153
"ACAGCCGTCTACTCAT",3,21,13,0,6,43,1401
"ACAGGGAAGGGTAATT",6,20,14,0,4,44,585
"ACAGGGAAGGTTAAAC",4,12,3,2,0,21,197
"ACAGGGACAGTATGAA",1,10,0,0,2,13,25
"ACAGGGACATGAATCC",2,28,6,2,10,48,1161
"ACAGGGATCTGACAGT",2,6,0,0,0,8,90
"ACATCCCAGGGCCCTT",0,3,0,0,0,3,139
"ACATCCCAGTAAGGGA",2,19,6,0,0,27,343
"ACATCCCCACGTGAGA",69,184,519,35,99,906,47518
"ACATCCCGTAGCGCCT",1,2,0,0,0,3,31
"ACATCCCGTTCCGGTG",21,97,118,9,40,285,12479
"ACATCCCTCACTGCTC",2,13,2,0,4,21,622
"ACATCGAAGATGCCGA",33,94,240,15,45,427,19582
"ACATCGAAGGAAGTGA",7,21,7,0,4,39,1280
"ACATCGACATATACCG",37,255,82,44,57,475,20134
"ACATCGACATCTAGAC",0,11,3,0,0,14,68
"ACATCGAGTCCCTCAT",0,4,0,0,0,4,26
"ACATCGATCACATACG",6,30,3,0,5,44,2092
"ACATCGATCGAGCCAC",3,24,14,3,3,47,938
"ACATGCAAGAATTCAG",1,0,0,0,0,1,58
"ACATGCACAGGAATAT",4,19,8,0,5,36,817
"ACATGCAGTCATATGC",0,0,0,0,0,0,33
"ACATGCAGTCCTCCAT",2,9,6,0,3,20,1347
"ACATGCAGTGAAAGTT",0,2,3,0,0,5,84
"ACATGCATCCATATGG",20,41,90,7,15,173,7859
"ACATGCATCTCCATAT",0,5,3,0,0,8,28
"ACATGCATCTCTGGTC",1,9,2,3,2,17,271
"ACATTTCAGTAGTCTC",0,4,0,0,2,6,133
"ACATTTCCAGCACACC",0,3,0,0,0,3,373
"ACATTTCTCAGACAAA",1,7,5,2,0,15,133
"ACATTTCTCCATCTCG",3,4,2,0,0,9,281
"ACATTTCTCTGCTTTA",5,23,14,0,15,57,1873
"ACCAAACAGAAACTAC",0,0,0,0,0,0,5
"ACCAAACAGCACCAGA",1,19,7,0,0,27,977
"ACCAAACAGCCTCATA",0,0,0,0,0,0,1
"ACCAAACAGGGTAATT",2,27,7,0,6,42,966
"ACCAAACCACGGCTAC",139,1264,308,72,172,1955,87834
"ACCAAACCAGGTAGTG",19,153,32,11,21,236,12948
"ACCAAACCATCGATAC",0,0,0,0,0,0,26
"ACCAAACCATGTTACG",265,1688,507,195,360,3015,132114
"ACCAAACGTAGCTGAG",1,4,0,0,0,5,151
"ACCAACAAGCATTGAA",0,9,0,0,0,9,150
"ACCAACACAAACCACT",1,7,3,0,0,11,92
"ACCAACACACGTAGTT",0,10,2,0,0,12,554
"ACCAACACAGATACCT",2,27,6,0,3,38,703
"ACCAACAGTCGTTATG",1,9,0,0,6,16,509
"ACCAACAGTCTAGGCC",1,12,8,0,2,23,506
"ACCAACAGTGCCCGTA",0,7,2,0,2,11,134
"ACCAACATCAGATGCT",3,22,6,0,3,34,687
"ACCAACATCGCAATTG",0,0,0,0,0,0,12
"ACCAACATCTGTTCAT",0,11,0,0,0,11,205
"ACCACAAAGAGTGACC",17,78,43,19,154,311,13501
"ACCACAAAGATGTTAG",139,345,888,91,277,1740,90561
"ACCACAAAGGCTCTCG",1,11,0,0,2,14,86
"ACCACAACATCGTGCG",24,201,47,17,33,322,16446
"ACCACAATCATCACCC",4,24,23,2,6,59,1545
"ACCATTTAGAAATTGC",75,505,124,37,89,830,34225
"ACCATTTCAAGTTTGC",53,142,93,25,298,611,31673
"ACCATTTCAGTAACGG",0,2,0,0,0,2,80
"ACCATTTCATAACGGG",1,5,0,0,3,9,95
"ACCATTTCATGGGAAC",3,14,8,0,3,28,815
"ACCATTTGTACAGAAT",0,9,0,0,4,13,265
"ACCATTTGTATGCGGA",0,0,0,0,0,0,7
"ACCATTTGTCCGACGT",16,54,40,14,120,244,11362
"ACCATTTGTGGCAACA",0,0,0,0,0,0,50
"ACCATTTGTTTCCCAC",0,9,0,0,0,9,110
"ACCATTTTCAGAATAG",2,14,2,0,4,22,524
"ACCATTTTCGCGTGAC",11,35,73,3,12,134,6827
"ACCCAAACACAGTGAG",1,18,4,0,5,28,474
"ACCCAAACATCATGAC",1,10,6,0,3,20,268
"ACCCAAAGTCACTCAA",0,0,0,0,0,0,7
"ACCCAAAGTGTTCGAT",6,35,16,4,6,67,1731
"ACCCAAATCCTCTAGC",35,231,52,25,42,385,16668
"ACCCAAATCTCAGTCC",1,5,3,0,0,9,161
"ACCCAAATCTGCACCT",1,4,0,0,0,5,115
"ACCCTCAAGAAGCGCT",29,146,57,42,33,307,11577
"ACCCTCAAGAGTTGAT",0,4,0,0,2,6,105
"ACCCTCAAGGCTCAAG",1,3,0,0,0,4,53
"ACCCTCAGTAGGTTTC",0,21,7,0,4,32,787
"ACCCTCAGTTCGGCGT",0,4,0,0,0,4,183
"ACCCTCAGTTGATCGT",0,0,0,0,0,0,15
"ACCCTCATCACCGCTT",0,4,0,0,0,4,162
"ACCCTCATCAGCTAGT",2,14,4,0,2,22,45
"ACCCTCATCTGACGCG",7,59,13,3,8,90,4773
"ACCCTCATCTGGAGAG",6,26,29,0,9,70,2920
"ACCCTTGAGCCTCTGG",2,23,12,2,6,45,659
"ACCCTTGAGTAAACTG",1,6,3,0,5,15,408
"ACCCTTGCAAATTAGG",0,5,0,0,0,5,232
"ACCCTTGCACTCTAGA",0,3,0,0,2,5,113
"ACCCTTGGTCGTTATG",0,0,2,0,0,2,91
"ACCCTTGTCACTTCTA",2,0,0,0,0,2,42
"ACCCTTGTCCTGTAAG",99,680,158,55,141,1133,51766
"ACCGTTCAGCAGTAAT",1,0,0,0,0,1,16
"ACCGTTCAGGGCTAAC",0,4,0,0,2,6,94
"ACCGTTCAGGTCATCT",0,9,0,0,0,9,128
"ACCGTTCAGTGCAACG",107,266,729,50,135,1287,66479
"ACCGTTCCAAGAGGTC",2,8,0,0,2,12,604
"ACCGTTCGTATCTCTT",1,17,5,0,5,28,1529
"ACCGTTCGTTACGTAC",2,11,4,0,3,20,191
"ACCGTTCGTTCGTAAC",0,2,0,0,0,2,182
"ACCGTTCGTTGCTGAT",1,4,0,0,0,5,115
"ACCTACCAGGTCACCC",0,5,0,0,0,5,100
"ACCTACCCAGGCGTTC",1,9,0,0,0,10,89
"ACCTACCCATCCGATA",2,17,6,0,0,25,1298
"ACCTACCGTGTTGATC",3,14,3,0,3,23,491
"ACCTACCGTTAGAAGT",0,4,0,0,3,7,96
"ACCTACCTCAAGTCTG",0,6,2,0,0,8,317
"ACCTACCTCTATCACT",51,424,87,27,77,666,36139
"ACCTGAAAGTATCCTG",1,5,2,0,0,8,171
"ACCTGAACAATTGGTC",2,12,3,0,0,17,550
"ACCTGAACATGTCAGT",2,17,11,3,2,35,716
"ACCTGAATCATTCATC",11,54,103,5,20,193,8866
"ACCTGAATCGTAGGAG",1,4,0,0,0,5,166
"ACCTGAATCTACGGGC",5,29,6,0,2,42,957
"ACCTGTCAGCTGACAG",3,14,4,0,2,23,681
"ACCTGTCAGTCGCCAC",16,48,82,3,17,166,9566
"ACCTGTCCAAACGAGC",8,41,56,0,9,114,5059
"ACCTGTCCAACCGGAA",1,6,2,0,0,9,211
"ACCTGTCGTGAGTTTC",0,2,0,0,0,2,37
"ACCTGTCGTGGACCAA",0,3,2,0,2,7,111
"ACCTGTCTCCACTTTA",26,153,44,16,62,301,14512
"ACCTGTCTCGCGTGAC",0,4,0,0,0,4,18
"ACGATCAAGAGAGGGC",2,3,4,0,0,9,113
"ACGATCAAGGGCTAAC",0,5,3,0,2,10,86
"ACGATCAAGTCTGGAG",1,6,0,0,2,9,260
"ACGATCACACGAGAAC",2,22,7,3,5,39,344
"ACGATCAGTACATACC",3,9,6,0,3,21,490
"ACGATCAGTACCGGCT",1,7,0,0,0,8,520
"ACGATCAGTGGTCTAT",0,3,0,0,0,3,17
"ACGATCAGTTAGCTAC",2,16,11,0,6,35,771
"ACGATCATCAAGCCCG",0,4,0,0,0,4,479
"ACGATCATCGGACGTC",0,19,5,0,2,26,441
"ACGATGTAGGTGCATG",1,11,5,0,0,17,76
"ACGATGTAGTCGAAGC",3,2,3,0,0,8,148
"ACGATGTAGTTCTACG",0,2,0,0,0,2,11
"ACGATGTCACACCGAC",1,8,2,0,5,16,148
"ACGATGTCAGACGCTC",0,2,0,0,0,2,116
"ACGATGTGTCGCATCG",0,6,2,0,0,8,207
"ACGATGTGTTCCGTTC",1,3,0,0,0,4,144
"ACGATGTTCTCTAGGA",7,22,12,3,17,61,1991
"ACGCACGAGGTGCTTT",2,4,0,0,0,6,129
"ACGCACGAGGTTTGAA",1,3,3,0,0,7,63
"ACGCACGCAAGAGAGA",0,0,0,0,0,0,127
"ACGCACGCATTGCCGG",0,3,0,0,2,5,267
"ACGCACGGTATGGGAC",0,3,0,2,0,5,110
"ACGCACGGTATTCTCT",1,6,0,0,0,7,233
"ACGCACGGTGAAAGTT",2,3,8,0,3,16,760
"ACGCACGTCACTTCTA",0,6,0,0,2,8,153
"ACGCACGTCCGGTAGC",3,22,4,2,4,35,560
"ACGCACGTCGACTCCT",0,0,0,0,0,0,116
"ACGCACGTCGCCAGTG",0,0,2,0,0,2,120
"ACGGAAGAGGTTGACG",0,4,0,0,0,4,111
"ACGGAAGAGTACCGGA",1,2,0,0,0,3,41
"ACGGAAGAGTCCCAGC",1,11,0,0,2,14,283
"ACGGAAGAGTTGTCGT",0,0,0,0,0,0,3
"ACGGAAGGTCGCTGCA",1,6,8,0,2,17,207
"ACGGAAGGTGAGACCA",0,3,2,0,2,7,87
"ACGGAAGGTTATAGAG",7,66,13,4,13,103,3131
"ACGGAAGTCAAGCCGC",1,15,5,0,0,21,437
"ACGGAAGTCACTTATC",0,5,0,0,0,5,47
"ACGGGTCAGAGATCGC",5,17,5,0,4,31,395
"ACGGGTCAGCAGGCTA",0,0,0,0,0,0,21
"ACGGGTCAGCTGAAGC",1,7,0,0,0,8,168
"ACGGGTCCACTTGAAC",4,35,7,2,7,55,1056
"ACGGGTCCATAACAGA",0,2,0,0,0,2,10
"ACGGGTCGTAGCGCTC",0,6,0,0,0,6,251
"ACGGGTCGTCGTGCCA",0,0,0,0,0,0,14
"ACGGGTCGTCTTACTT",0,4,0,0,0,4,168
"ACGGGTCGTGATATAG",22,65,80,7,54,228,6888
"ACGGGTCTCAGACCGC",4,11,7,0,4,26,456
"ACGGGTCTCGAGAGCA",3,8,5,0,3,19,568
"ACGGGTCTCGGCATTA",1,2,0,0,0,3,79
"ACGGTCGAGGACAAGA",1,11,4,0,6,22,120
"ACGGTCGAGGTCTGGA",0,6,0,0,0,6,85
"ACGGTCGCACGTCTCT",1,15,3,0,0,19,738
"ACGGTCGCAGTAGGAC",14,51,30,10,78,183,5464
"ACGGTCGCATGAAGCG",2,12,4,0,4,22,347
"ACGGTCGTCCCTGTTG",0,5,2,0,0,7,159
"ACGGTTAAGAGTCTGG",4,40,14,2,4,64,950
"ACGGTTAAGTTCATGC",5,48,12,3,4,72,2591
"ACGGTTACAGGCTTGC",3,10,6,0,0,19,577
"ACGGTTACATGGGTTT",50,126,252,24,52,504,25571
"ACGGTTAGTACTCAAC",0,17,6,0,4,27,96
"ACGGTTAGTAGTGATA",0,5,0,0,0,5,120
"ACGGTTAGTATACCCA",1,10,0,0,2,13,154
"ACGTAACAGACAGCGT",22,117,37,9,19,204,9547
"ACGTAACCAAACAGGC",0,0,0,0,0,0,0
"ACGTAACCACACAGCC",5,7,3,0,0,15,123
"ACGTAACCACTCAAGT",6,46,20,5,8,85,994
"ACGTAACGTGCGAGTA",0,9,3,0,0,12,204
"ACGTAACTCCATTCGC",6,11,4,0,2,23,566
"ACGTAACTCCGAGGCT",2,13,0,2,2,19,706
"ACGTACAAGTCAGCCC",2,23,7,2,6,40,2043
"ACGTACAAGTGGAAAG",2,8,0,0,3,13,202
"ACGTACACAGTACTAC",0,10,0,0,0,10,378
"ACGTACACAGTCTTCC",0,6,0,0,0,6,366
"ACGTACACATGGAATA",0,8,0,0,0,8,317
"ACGTACAGTCTGTGAT",0,4,0,0,0,4,106
"ACGTACATCATCTGTT",1,2,0,0,0,3,55
"ACGTACATCCTACAAG",0,6,0,0,4,10,172
"ACGTAGTAGAGTATAC",1,13,5,0,8,27,690
"ACGTAGTAGCAGGCTA",5,21,10,2,3,41,638
"ACGTAGTCAGGTTCAT",0,5,2,0,0,7,44
"ACGTAGTCATGTGGCC",0,4,0,0,0,4,188
"ACGTAGTGTCATCCCT",9,38,47,3,13,110,4160
"ACGTAGTTCACGATAC",2,5,4,0,0,11,318
"ACGTAGTTCCAAACCA",0,3,0,0,2,5,107
"ACGTAGTTCCGGGACT",29,92,42,158,40,361,14937
"ACGTAGTTCGCACGAC",0,10,3,0,5,18,459
"ACGTCCTAGGTTTACC",1,4,2,0,0,7,112
"ACGTCCTAGTGGTTGG",0,21,4,0,3,28,415
"ACGTCCTGTGAATTGA",3,13,0,0,2,18,339
"ACGTCCTTCGCACTCT",2,11,3,0,0,16,201
"ACGTTCCAGCTTCATG",0,4,0,0,0,4,203
"ACGTTCCAGGTCCCGT",2,3,0,0,0,5,183
"ACGTTCCCACAAAGTA",0,6,3,0,3,12,242
"ACGTTCCCACTTCAAG",0,0,0,0,0,0,5
"ACGTTCCCATCTAACG",1,0,3,0,0,4,11
"ACGTTCCTCCATCGTC",1,11,2,0,0,14,239
"ACGTTCCTCCCGTTCA",1,13,0,2,2,18,838
"ACTACGAAGCTTCGTA",252,1585,523,110,301,2771,148027
"ACTACGAAGGCGAACT",0,0,0,0,0,0,1
"ACTACGAAGTGCGACA",0,9,2,0,0,11,162
"ACTACGACACTTCTCG",15,128,33,12,23,211,9028
"ACTACGAGTTCGAGCC",10,10,2,0,4,26,812
"ACTACGATCCGCACTT",0,0,0,0,0,0,21
"ACTACGATCCGTACGG",1,0,3,0,0,4,243
"ACTACGATCTAACGGT",1,25,7,0,11,44,860
"ACTACGATCTAGTGTG",2,25,4,0,3,34,47
"ACTATCTAGCGGTAGT",2,23,6,2,13,46,644
"ACTATCTCACGAGGTA",2,6,4,0,0,12,164
"ACTATCTCATGACGGA",0,0,0,0,0,0,7
"ACTATCTGTTCCCACT",0,0,0,0,0,0,6
"ACTATCTGTTGTGCAT",0,14,0,0,0,14,269
"ACTATCTTCAGCAGAG",33,127,27,5,24,216,9229
"ACTATGGAGAATAGTC",10,92,24,8,19,153,4879
"ACTATGGAGCAGCCCT",0,2,0,0,0,2,355
"ACTATGGAGTTACTCG",0,6,0,0,0,6,166
"ACTATGGCAATCAAGA",2,35,10,0,6,53,925
"ACTATGGCACCTTCCA",1,12,5,0,0,18,366
"ACTATGGCAGACAAAT",6,52,14,5,8,85,2253
"ACTATGGTCAACACGT",5,20,5,2,2,34,780
"ACTATGGTCCCTTTGG",4,36,15,0,6,61,286
"ACTATGGTCCTTATGT",11,58,65,3,20,157,5275
"ACTATTCAGCCAAGTG",132,764,214,60,128,1298,67742
"ACTATTCAGCTTAGTC",0,8,5,0,0,13,154
"ACTATTCAGTTAACGA",1,4,0,0,0,5,199
"ACTATTCCAAACTCTG",2,7,3,0,0,12,143
"ACTATTCCAAGAATGT",19,188,48,10,34,299,13611
"ACTATTCCAGGGTCTC",4,28,9,0,5,46,1193
"ACTATTCCATGGATCT",1,6,0,2,0,9,125
"ACTATTCGTACTCCCT",28,67,146,10,31,282,15254
"ACTATTCTCGAGTGGA",0,11,0,0,2,13,357
"ACTATTCTCGCTCTCA",15,112,25,4,19,175,8839
"ACTCCCAAGGTCCAGA",2,0,0,0,0,2,79
"ACTCCCAAGTTAGTGA",0,4,0,0,0,4,109
"ACTCCCACATGCCGAC",3,23,5,0,3,34,887
"ACTCCCACATTCCTAT",106,862,173,66,145,1352,68389
"ACTCCCATCTATACTC",1,4,0,0,0,5,164
"ACTCTCGAGAATACAC",4,13,5,0,2,24,53
"ACTCTCGAGATACGAT",69,518,124,33,106,850,46055
"ACTCTCGAGGAGGTTC",0,2,0,0,0,2,147
"ACTCTCGCAAGGCTTT",0,0,0,0,0,0,11
"ACTCTCGCATGCAGGA",2,8,0,0,0,10,580
"ACTCTCGGTACTGCGC",355,696,248,62,189,1550,61471
"ACTCTCGGTTAGCGGA",0,2,0,0,0,2,81
"ACTCTCGTCAGCTTGA",0,0,0,0,0,0,21
"ACTGATGAGAGATTCA",1,5,0,0,4,10,77
"ACTGATGAGCGATGAC",0,0,0,0,0,0,7
"ACTGATGAGCGTTCAT",1,13,4,0,4,22,435
"ACTGATGAGGACAAGA",0,12,2,0,0,14,357
"ACTGATGCAACTAGAA",0,9,3,0,0,12,81
"ACTGATGCAAGTCCCG",61,542,196,39,111,949,52784
"ACTGATGCACTGTTCC",91,237,588,36,113,1065,58730
"ACTGATGCAGCTCGGT",0,18,5,0,0,23,1181
"ACTGATGCAGTCCCGA",10,64,26,3,11,114,3865
"ACTGATGCATGAAGCG",13,49,43,9,73,187,8829
"ACTGATGGTGTAGGAC",0,0,3,0,0,3,120
"ACTGATGTCTCTCAAT",5,24,8,2,4,43,808
"ACTGATGTCTGGAAGG",4,13,4,0,2,23,490
"ACTGCAAAGCTGACCC",4,31,6,0,3,44,2336
"ACTGCAAAGTGAGGCT",1,2,0,0,0,3,10
"ACTGCAACAACTGTGT",0,2,2,0,0,4,241
"ACTGCAACAATGCAAA",23,80,57,15,210,385,18075
"ACTGCAACACCCGTAG",0,11,9,0,0,20,40
"ACTGCAAGTATCCTCC",15,115,30,11,15,186,7039
"ACTGTCCAGTGACACG",1,26,14,4,0,45,1173
"ACTGTCCCACAGCATT",18,132,39,9,26,224,9876
"ACTGTCCCAGAGACTG",2,21,5,2,3,33,526
"ACTGTCCCATAACGGG",0,13,5,0,0,18,422
"ACTGTCCCATAGATCC",0,4,0,0,2,6,113
"ACTGTCCGTCCAATCA",1,2,0,0,0,3,60
"ACTGTCCGTCCAGCGT",2,14,4,0,2,22,438
"ACTGTCCTCCGTGTAA",0,23,6,0,2,31,755
"ACTGTCCTCGAGTGAG",3,3,2,0,0,8,330
"ACTGTCCTCGCGCTGA",1,10,0,0,2,13,168
"ACTGTCCTCGTGCATA",1,7,0,0,5,13,212
"ACTGTGAAGATCCCAT",0,2,0,2,0,4,128
"ACTGTGAAGGAGCAAA",0,0,0,0,0,0,20
"ACTGTGAGTCACCGCA",0,2,0,0,0,2,241
"ACTGTGAGTGATTAGA",2,7,3,0,0,12,36
"ACTGTGAGTTAGTTCG",0,2,0,0,0,2,31
"ACTGTGATCAACACGT",8,48,20,8,45,129,6041
"ACTGTGATCACAAGAA",4,30,11,0,8,53,730
"ACTGTGATCATGCTAG",1,5,0,0,0,6,134
"ACTGTGATCCAAATGC",3,16,3,0,4,26,556
"ACTGTGATCCTGGCTT",0,2,0,0,0,2,31
"ACTGTGATCGGTGTAT",0,10,2,0,2,14,474
"ACTGTGATCTTAGCTT",0,13,0,0,0,13,263
"ACTTAGGAGACCTCAT",10,30,13,0,27,80,3302
"ACTTAGGAGGAGGTTC",1,20,3,0,0,24,267
"ACTTAGGAGGTTCTAC",22,43,15,3,9,92,1941
"ACTTAGGCAACATCGT",1,0,0,0,0,1,107
"ACTTAGGCAAGAGTAT",27,81,132,11,33,284,13322
"ACTTAGGCACCTTCGT",1,11,2,0,3,17,419
"ACTTAGGGTTCGGTTA",2,8,6,0,0,16,642
"ACTTAGGTCAGAATAG",0,3,0,0,0,3,8
"ACTTAGGTCAGACATC",0,0,0,0,0,0,63
"ACTTAGGTCATGGGAG",0,4,0,0,0,4,83
"ACTTATCCATGACTCA",2,9,3,0,2,16,489
"ACTTATCGTCCCGTGA",4,21,11,0,2,38,1337
"ACTTATCGTTGGTACT",2,17,3,0,5,27,80
"ACTTATCTCGGCTTCT",0,2,0,0,0,2,201
"ACTTCCGAGAGCAAGA",1,2,2,0,0,5,94
"ACTTCCGAGCGAGGAG",0,0,0,0,0,0,11
"ACTTCCGAGCTGCGAA",0,5,0,0,0,5,72
"ACTTCCGAGGGAGTGG",4,19,2,0,2,27,964
"ACTTCCGAGGGCAAGG",0,5,2,0,0,7,106
"ACTTCCGAGTAGAGTT",0,5,0,0,0,5,64
"ACTTCCGCACCGTACG",1,9,3,0,3,16,56
"ACTTCCGCAGGGTTGA",0,3,0,0,0,3,104
"ACTTCCGCATAGGTAA",0,9,2,0,0,11,130
"ACTTCCGGTCATCTAG",4,12,4,0,3,23,783
"ACTTCCGGTCTTGCTC",0,4,0,0,0,4,18
"ACTTCCGGTGAGACGT",2,0,0,0,0,2,69
"ACTTCCGGTGCAACAG",0,5,0,0,0,5,272
"ACTTCCGTCTCCGCAT",3,24,12,0,4,43,1321
"ACTTCGCAGCCTTCTC",0,2,0,0,0,2,6
"ACTTCGCAGGCATCTT",1,5,0,0,0,6,144
"ACTTCGCCATAGGAGC",1,20,7,0,0,28,696
"ACTTCGCTCCATAGAC",0,2,2,0,2,6,114
"ACTTCGCTCGTGCGAC",0,6,0,0,0,6,189
"ACTTTCAAGACTTGTC",4,30,11,0,2,47,720
"ACTTTCACAAATGCGG",1,10,7,0,3,21,461
"ACTTTCACACACGTGC",2,14,4,0,2,22,471
"ACTTTCACACTGAATC",0,20,7,3,3,33,888
"ACTTTCACAGCATCTA",0,6,2,0,0,8,211
"ACTTTCACATATACCG",1,6,4,2,0,13,188
"ACTTTCAGTCACTGAT",0,12,0,0,0,12,211
"ACTTTCAGTGGAACAC",0,4,0,0,0,4,99
"ACTTTCATCCGGTTCT",3,32,8,0,4,47,950
"ACTTTCATCTATCGGA",1,9,0,0,2,12,83
"ACTTTGTAGAGATTCA",17,54,15,10,16,112,4409
"ACTTTGTAGCGACTAG",0,9,0,0,0,9,144
"ACTTTGTGTAGTGATA",1,8,0,0,0,9,104
"ACTTTGTTCAAACGAA",1,5,0,0,0,6,206
"ACTTTGTTCACCGACG",34,217,59,16,42,368,18460
"ACTTTGTTCCTAGCTC",0,0,0,0,0,0,2
"ACTTTGTTCTGCGATA",1,23,4,2,7,37,83
"AGAAATGAGACAACTA",0,12,2,0,0,14,382
"AGAAATGAGGCCTTGC",4,44,12,3,4,67,1026
"AGAAATGCACCCTGTT",0,6,0,0,0,6,266
"AGAAATGCACCGTGCA",15,38,88,7,15,163,8362
"AGAAATGCAGCAGTCC",1,17,3,0,2,23,513
"AGAAATGGTGTCTAAC",2,0,0,0,0,2,55
"AGAAATGTCCTATGGA",8,31,8,0,10,57,1035
"AGAAATGTCTCGTGGG",0,3,2,0,0,5,117
"AGAACAAAGACCAAGC",0,2,0,0,0,2,35
"AGAACAAAGTAAACTG",0,4,3,0,0,7,207
"AGAACAAAGTTCATGC",0,10,4,0,0,14,222
"AGAACAACAAACTAAG",0,6,7,0,0,13,208
"AGAACAACACCGCTGA",16,47,81,5,20,169,8422
"AGAACAACATGTACGT",3,16,4,2,4,29,726
"AGAACAAGTACGTGTT",57,415,107,26,74,679,36208
"AGAACAAGTAGGGTAC",5,30,11,0,5,51,665
"AGAACAAGTCTTCATT",0,8,2,2,0,12,190
"AGAACAATCCGACGGT",0,7,4,0,0,11,136
"AGAACCTAGTCCGCCA",2,14,5,0,4,25,674
"AGAACCTCAGAGACTG",0,10,4,0,3,17,506
"AGAACCTCATAGAGGC",2,10,0,0,0,12,127
"AGAACCTGTACTCGCG",0,7,2,0,0,9,745
"AGAACCTGTCGAGTGA",0,19,3,0,3,25,538
"AGAACCTGTTTCACAG",1,7,0,0,0,8,65
"AGAAGCGCATAACGGG",0,10,2,0,0,12,71
"AGAAGCGGTATGTCTG",0,2,0,0,2,4,291
"AGAAGTAAGGCAATGC",1,6,0,0,0,7,234
"AGAAGTAGTATCATGC",0,8,2,0,0,10,350
"AGAAGTATCCCGAGAC",0,3,2,0,0,5,79
"AGAAGTATCTCGTTTA",5,25,4,2,7,43,737
"AGACAAAAGTTGTAAG",12,80,17,6,15,130,5471
"AGACAAACAAATAAGC",0,0,0,0,0,0,13
"AGACAAACAATTCGTG",1,10,4,0,0,15,186
"AGACAAACAGTCGGAA",0,0,0,0,0,0,4
"AGACAAACATGTAACC",1,7,2,0,0,10,152
"AGACAAACATTACTCT",27,114,47,14,171,373,18823
"AGACAAAGTAAGAACT",11,80,12,3,18,124,3261
"AGACAAAGTGGTTTAC",1,5,2,0,0,8,139
"AGACAAAGTTCAGTAC",7,45,47,3,9,111,3241
"AGACAAATCCAAAGGG",0,0,0,0,0,0,27
"AGACAAATCCATTGTT",0,20,7,0,3,30,74
"AGACAAATCCGAACGC",135,638,192,150,129,1244,52247
"AGACAAATCTTACCAT",3,18,6,0,2,29,687
"AGACACTAGGTTCAGG",4,33,7,0,0,44,905
"AGACACTCACCATATG",1,4,0,0,2,7,122
"AGACACTCAGCACCCA",1,10,3,0,2,16,342
"AGACACTTCTCCGATC",67,151,33,15,30,296,12385
"AGACACTTCTTAATCC",0,7,4,0,0,11,190
"AGACAGGAGTCCTGCG",28,147,32,10,24,241,11125
"AGACAGGGTCCGAAAG",1,2,0,0,0,3,65
"AGACAGGGTGTCCGGT",1,11,5,0,4,21,480
"AGACAGGTCCTATTTG",1,7,0,0,0,8,148
"AGACAGGTCTAACGGT",1,5,2,0,0,8,151
"AGACCATAGCATCTTG",2,34,11,0,7,54,2767
"AGACCATCAAGTATAG",2,10,2,0,0,14,151
"AGACCATGTAGGCTGA",0,5,0,0,0,5,94
"AGACCATGTTTCACTT",34,124,77,20,254,509,20572
"AGACCATTCACAGTGT",0,0,0,0,2,2,48
"AGACCATTCCTCCACA",1,16,4,0,6,27,588
"AGACCCGCAGATTCGT",1,9,2,0,0,12,133
"AGACCCGGTGACTGTT",11,19,13,0,3,46,625
"AGACCCGTCAAGGAGC",1,3,0,0,0,4,39
"AGACCCGTCCGCAGTG",27,262,54,19,42,404,17278
"AGACCCGTCTTACCAT",16,135,29,7,15,202,10323
"AGACTCAAGGGTTTCT",2,7,0,0,0,9,125
"AGACTCACAACGTTAC",0,7,11,0,2,20,267
"AGACTCACAGAGGTAC",3,31,3,2,2,41,643
"AGACTCACAGCAGTCC",785,316,194,70,159,1524,62552
"AGACTCACATGGAAGC",77,567,142,51,105,942,40451
"AGACTCAGTCTACGTA",4,17,8,0,3,32,715
"AGACTCAGTCTATGAC",1,9,0,0,2,12,240
"AGACTCAGTGTTCATG",1,6,0,0,2,9,208
"AGACTCATCAGAGTTC",1,0,0,0,0,1,16
"AGAGAATAGCATCTTG",0,6,0,0,0,6,51
"AGAGAATAGTTCGGTT",0,3,0,0,0,3,11
"AGAGAATGTCAAAGTA",0,7,0,0,0,7,77
"AGAGAATTCCCTGGTT",1,3,0,0,0,4,28
"AGAGAGCAGCAATTAG",1,7,0,0,2,10,217
"AGAGAGCAGCAGCACA",12,54,38,8,114,226,10960
"AGAGAGCAGTGGATTA",0,20,0,0,2,22,222
"AGAGAGCCAGCCGTTG",42,294,92,20,178,626,27672
"AGAGAGCTCATGGATC",89,683,191,48,126,1137,55664
"AGAGCAGCATGGAACG",0,8,3,0,0,11,189
"AGAGCAGGTGGTTTAC",10,32,13,6,23,84,2315
"AGAGCAGTCATTGGTG",7,20,3,0,2,32,762
"AGAGCCCAGCTGGAGT",0,5,0,0,0,5,88
"AGAGCCCAGGACTAAT",0,0,0,0,0,0,60
"AGAGCCCGTCCCTGAG",1,6,0,0,0,7,112
"AGAGCCCTCACCTCTG",0,9,3,0,2,14,377
"AGAGCCCTCCGATGTA",5,22,13,2,4,46,1026
"AGATAGAAGATAACAC",3,37,10,2,3,55,886
"AGATAGAAGCTACTAC",0,2,3,0,0,5,295
"AGATAGAAGGCGCTCT",0,2,0,0,0,2,74
"AGATAGACAGGAAGTC",0,8,0,0,0,8,61
"AGATAGAGTCGAAGCA",0,6,0,0,0,6,160
"AGATAGAGTGAGCGAT",3,24,4,3,3,37,1360
"AGATAGATCAACCTTT",2,9,4,0,2,17,206
"AGATCCACAGAACCGA",0,0,0,0,0,0,24
"AGATCCACATCGGAAG",2,17,3,2,0,24,395
"AGATCCACATGTCTAG",4,29,8,0,0,41,1060
"AGATCCAGTGGACCTC",1,5,4,0,0,10,127
"AGATCCAGTTGTATGC",250,490,146,30,121,1037,44073
"AGATCCATCCTAGCGG",2,13,14,2,23,54,2522
"AGATCCATCGACGCGT",1,2,0,0,0,3,24
"AGATCCATCTTCACAT",5,16,11,2,4,38,728
"AGATCGTAGCGGTAGT",18,111,37,11,31,208,10728
"AGATCGTAGTGGAAGA",0,7,0,0,0,7,97
"AGATCGTAGTGTACAA",2,5,6,0,0,13,130
"AGATCGTGTCCACATA",0,0,0,0,0,0,16
"AGATCGTGTGCCCGTA",5,32,6,4,3,50,1154
"AGATCGTTCATAGCAC",6,39,53,3,15,116,6113
"AGATCGTTCCATGATG",2,15,3,0,2,22,190
"AGATCGTTCTCTCCGA",0,3,0,0,0,3,63
"AGATGAAAGACCATGG",0,0,0,0,0,0,21
"AGATGAAAGTCTGTAC",5,24,7,0,0,36,624
"AGATGAACACAAAGTA",0,0,0,0,2,2,169
"AGATGAACACCCTCTA",1,7,5,0,2,15,220
"AGATGAACATCACCAA",1,11,0,0,2,14,275
"AGATGAACATCCTTGC",2,18,7,2,6,35,265
"AGATGAAGTGCCTACG",1,6,5,0,2,14,154
"AGATGAAGTGTTAGCT",1,2,2,0,0,5,143
"AGATGAAGTTGCATCA",1,12,0,0,0,13,179
"AGATGAAGTTGCCAAT",1,10,4,0,4,19,265
"AGATGAAGTTGGGACA",20,31,13,4,8,76,2783
"AGATGAATCCAGTACA",3,24,9,0,4,40,866
"AGATGAATCCTTTGAT",1,5,3,0,0,9,297
"AGATGCTAGAGCATAT",0,2,0,0,0,2,7
"AGATGCTAGGGAACAA",0,6,2,0,0,8,99
"AGATGCTAGTAGCAAT",1,32,15,3,9,60,859
"AGATGCTAGTTGCGAG",0,0,0,0,0,0,139
"AGATGCTCAAGAAATC",22,167,31,12,33,265,10092
"AGATGCTCAATACGCT",0,4,0,0,0,4,172
"AGATGCTCATGGAGAC",2,9,0,0,2,13,187
"AGATGCTGTACCGTCG",11,50,204,9,17,291,8684
"AGATGCTGTTCAATCG",0,2,0,0,0,2,68
"AGATGCTGTTGCATTG",0,6,0,0,0,6,99
"AGATGCTTCAACTGAC",1,3,0,0,2,6,120
"AGATGCTTCACCGGGT",0,2,2,0,0,4,98
"AGCATCAAGCTTCGTA",1,5,2,2,3,13,131
"AGCATCAAGGATTCAA",3,16,4,0,5,28,233
"AGCATCACACACTTAG",7,53,8,2,7,77,2276
"AGCATCACACTGCGAC",1,12,4,0,2,19,184
"AGCATCAGTAGAGCTG",13,51,97,4,28,193,7786
"AGCATCAGTCAATGGG",1,5,0,0,0,6,276
"AGCATCAGTGTATCCA",1,4,0,0,2,7,136
"AGCATCAGTTCGTTCC",2,17,7,0,2,28,505
"AGCCAATCAAATAGCA",2,22,9,2,2,37,667
"AGCCAATCATAGCACT",2,26,3,0,4,35,554
"AGCCAATGTTGAGAGC",0,6,0,0,0,6,140
"AGCCAATTCACCGACG",1,3,2,0,0,6,131
"AGCCAATTCAGGTAAA",36,42,17,0,12,107,2806
"AGCCAATTCATTTGGG",13,54,59,5,23,154,6304
"AGCCAATTCCTGGGTG",0,12,4,0,0,16,511
"AGCCACGCAGGGAATC",0,2,0,0,0,2,222
"AGCCACGGTCGACTGC",2,19,8,0,2,31,945
"AGCCACGTCAGACTGT",823,290,160,45,137,1455,56656
"AGCCACGTCATTACCT",28,150,51,21,115,365,14481
"AGCCACGTCCACACAA",35,343,71,20,51,520,23750
"AGCCACGTCGCAGAGA",2,12,2,0,0,16,332
"AGCCAGCCACTGAGGA",1,2,0,0,0,3,67
"AGCCAGCGTAGTCACT",1,7,4,0,2,14,261
"AGCCAGCGTATAGGGC",136,99,46,15,32,328,14992
"AGCCAGCTCAACCTCC",1,6,0,0,0,7,437
"AGCCAGCTCATGGAGG",7,57,15,4,8,91,2968
"AGCGATTAGATGGGCT",0,4,0,0,0,4,110
"AGCGATTAGCATGGGT",1,4,0,0,0,5,47
"AGCGATTAGGTACAAT",1,17,4,0,3,25,1167
"AGCGATTCAAGAGAGA",3,39,7,3,5,57,893
"AGCGATTCAAGCAGGT",3,15,12,0,7,37,1959
"AGCGATTCACTGAGTT",0,15,4,0,0,19,485
"AGCGATTGTATACGGG",0,2,4,0,0,6,139
"AGCGATTGTCAGTTTG",0,3,0,0,0,3,100
"AGCGATTGTCATAGTC",0,2,0,0,0,2,11
"AGCGATTGTGACCTGC",7,99,32,8,13,159,6257
"AGCGATTGTTAGAAAC",0,11,3,0,2,16,133
"AGCGATTGTTTGGCTA",2,28,6,0,6,42,801
"AGCGCCAAGCATCCTA",0,6,3,2,0,11,343
"AGCGCCAAGGTAGACC",1,2,6,0,0,9,442
"AGCGCCAGTACTCCCT",12,142,23,6,16,199,9432
"AGCGCCAGTTGGGACA",0,0,0,0,0,0,74
"AGCGCCATCTCGAGTA",0,2,0,2,2,6,54
"AGCGCTGAGCGTATGG",3,20,7,0,4,34,776
"AGCGCTGCAGCCATTA",2,19,6,0,3,30,637
"AGCGCTGCAGTGACCC",66,158,460,25,83,792,36241
"AGCGCTGGTAGAGGAA",1,3,4,0,2,10,91
"AGCGCTGGTAGGTTTC",3,22,5,0,4,34,608
"AGCGCTGGTTTCGACA",7,34,52,5,10,108,5399
"AGCGCTGTCCAGGACC",2,13,7,3,0,25,621
"AGCGCTGTCCGTCCTA",10,15,3,0,5,33,1391
"AGCGCTGTCCTCAGAA",0,5,0,0,0,5,48
"AGCGCTGTCGACACTA",0,4,3,0,4,11,337
"AGCGCTGTCTCCCATG",2,16,5,3,3,29,662
"AGCGTATAGCTGACAG",1,20,4,0,6,31,575
"AGCGTATCAAACTAGA",0,18,2,0,0,20,150
"AGCGTATCAGCTGGTC",2,7,0,0,0,9,210
"AGCGTATGTCGAGCAA",1,3,0,0,0,4,30
"AGCGTATGTCTACAGT",1,9,0,0,0,10,663
"AGCGTATTCATGAGGG",87,57,27,7,22,200,7105
"AGCGTATTCTTTGGAG",7,30,22,5,28,92,2221
"AGCGTCGAGGCACTAG",1,3,0,0,0,4,20
"AGCGTCGCAACTGAAA",0,0,0,0,0,0,14
"AGCGTCGTCACTGTTT",0,0,0,0,0,0,11
"AGCGTCGTCCATACAG",0,0,0,0,0,0,6
"AGCTACAAGACATCCT",0,9,2,0,0,11,283
"AGCTACAAGGCAGCTA",0,4,0,0,0,4,109
"AGCTACACAAATCCCA",1,4,2,0,0,7,218
"AGCTACACACGCAAAG",1,6,0,0,0,7,186
"AGCTACACAGAGTGAC",0,4,0,0,0,4,55
"AGCTACAGTACCGGAA",2,12,4,2,0,20,380
"AGCTACATCATAGCAC",98,231,455,43,339,1166,57949
"AGCTACATCCGCAACG",4,18,9,2,2,35,873
"AGCTACATCTAGCCTC",3,22,13,0,23,61,2638
"AGCTCAACAGAAGCGT",2,10,0,0,0,12,204
"AGCTCAAGTCTCGGAC",1,2,0,0,0,3,7
"AGCTCAAGTGGGACAT",9,32,19,4,29,93,3982
"AGCTCAATCATTACCT",2,17,4,0,3,26,757
"AGCTCAATCTCAGGCG",2,6,0,0,0,8,83
"AGCTTCCAGAAGGTAG",0,3,0,0,0,3,25
"AGCTTCCAGCAGCCCT",1,11,2,2,5,21,58
"AGCTTCCGTCACTCTC",6,34,48,6,11,105,3349
"AGCTTCCGTTTCACAG",4,24,8,3,3,42,565
"AGCTTCCTCCACTGGG",35,237,97,20,44,433,20518
"AGCTTCCTCGACCAAT",212,432,131,30,103,908,41854
"AGGAAATCAATGACCT",0,0,0,0,0,0,1
"AGGAAATCACACTGGC",1,5,3,0,0,9,205
"AGGAAATCACATTACG",77,209,574,42,101,1003,49151
"AGGAAATCACGAAGAC",0,6,0,0,0,6,226
"AGGAAATCAGGTGAGT",2,16,8,3,5,34,473
"AGGAAATGTAATGCTC",1,15,8,0,0,24,240
"AGGAAATGTAGCCAGA",0,9,2,0,0,11,435
"AGGAATAAGGTCCCGT",3,29,4,0,3,39,800
"AGGAATACAATAGAGT",9,12,5,0,7,33,455
"AGGAATACAGAACTCT",0,0,0,0,0,0,7
"AGGAATACAGGCGATA",1,3,0,0,0,4,56
"AGGAATAGTGATACAA",0,2,4,0,0,6,103
"AGGAATATCACTACTT",7,37,18,4,8,74,215
"AGGAATATCATCGTAG",1,8,3,0,0,12,144
"AGGAATATCCACAGGC",30,109,201,20,34,394,16111
"AGGAATATCGATTTCT",0,10,2,0,2,14,89
"AGGAATATCGCTCATC",1,2,0,0,0,3,8
"AGGACGAAGACTAGAT",6,29,6,0,7,48,1264
"AGGACGAAGCATGCGA",0,8,0,0,0,8,159
"AGGACGACAGTTAGGG",1,0,0,0,0,1,4
"AGGACGAGTCGAACAG",2,20,3,0,4,29,572
"AGGACGAGTGTTGACT",23,76,140,9,28,276,10280
"AGGACTTAGCAACAAT",1,0,2,0,0,3,70
"AGGACTTAGCGACAGT",3,32,8,0,2,45,714
"AGGACTTCACAACATC",3,21,5,0,7,36,592
"AGGACTTGTAAGGCTG",294,704,212,54,145,1409,72587
"AGGACTTGTATGTCCA",2,3,0,0,0,5,249
"AGGACTTTCAATCCGA",1,7,0,0,2,10,99
"AGGACTTTCACATTGG",3,5,8,0,0,16,96
"AGGACTTTCTTCACAT",1,24,4,4,2,35,814
"AGGAGGTAGAATCGTA",0,5,2,0,0,7,63
"AGGAGGTCAATTCGTG",0,2,0,0,0,2,21
"AGGAGGTCAGATTCGT",1,9,6,0,0,16,396
"AGGAGGTCATCCGAGC",1,28,6,0,4,39,747
"AGGAGGTCATGCCGCA",12,69,19,4,13,117,6504
"AGGAGGTGTAAGACCG",0,0,0,0,0,0,6
"AGGAGGTTCAACACGT",1,27,8,0,0,36,490
"AGGAGGTTCTGAACGT",6,21,3,0,5,35,798
"AGGATAAAGACCATAA",1,7,0,0,0,8,140
"AGGATAAAGCTGTGCC",1,11,3,0,3,18,604
"AGGATAAAGTGCACAG",0,2,0,0,0,2,34
"AGGATAACACATGACT",3,26,6,0,6,41,779
"AGGATAACACGGAAGT",1,0,2,0,0,3,45
"AGGATAACATTGAAAG",0,11,3,0,0,14,304
"AGGATAAGTACAAGCG",0,17,4,0,2,23,359
"AGGATAAGTGCATGAG",6,72,14,3,11,106,4737
"AGGATAATCCGTGGGT",1,18,7,0,4,30,579
"AGGATAATCTCCACTG",1,3,2,0,0,6,123
"AGGATCTAGCCTTTGA",0,10,6,0,0,16,118
"AGGATCTCAACGAGGT",3,23,3,0,0,29,1335
"AGGATCTCAAGCGAAC",0,0,0,0,0,0,90
"AGGATCTCACCAGCGT",2,15,4,3,3,27,660
"AGGATCTGTCACTTCC",12,37,19,4,68,140,7987
"AGGATCTTCAAACCTG",0,2,3,0,2,7,156
"AGGATCTTCAGCTAGT",1,8,4,2,0,15,861
"AGGATCTTCGGTGCAC",0,3,0,0,0,3,68
"AGGATCTTCGTAGTCA",0,6,0,0,2,8,160
"AGGATCTTCTTACCGC",0,2,0,0,0,2,27
"AGGCATTAGAAGTCCG",20,147,33,17,23,240,9621
"AGGCATTGTTAACAGA",13,31,13,3,28,88,2454
"AGGCATTGTTAAGACA",15,35,11,4,9,74,1754
"AGGCATTGTTTGTTCT",1,3,0,0,0,4,178
"AGGCCACAGAAACCAT",0,5,5,0,2,12,384
"AGGCCACAGACCAGAC",0,6,3,0,0,9,135
"AGGCCACAGGTTCCAT",0,11,0,0,0,11,134
"AGGCCACCACGCGCTA",0,0,2,0,0,2,186
"AGGCCACGTGCCGTAC",0,0,0,0,0,0,109
"AGGCCACGTGGTTTAC",1,0,3,0,0,4,73
"AGGCCACGTTGCCTAA",2,5,4,0,0,11,51
"AGGCCACTCACGGGCT",10,70,21,3,12,116,5089
"AGGCCACTCAGACAAA",1,46,18,4,7,76,104
"AGGCCACTCGCCTTGT",1,14,2,0,6,23,696
"AGGCTGCAGCTATCTG",0,0,0,0,0,0,188
"AGGCTGCAGTCACGCC",0,0,0,0,0,0,289
"AGGCTGCAGTTGGAAT",1,10,6,0,0,17,755
"AGGCTGCGTTGGTACT",1,6,0,0,0,7,77
"AGGCTGCTCGCAATGT",0,0,0,0,0,0,12
"AGGCTGCTCGGCTCTT",1,0,0,0,0,1,13
"AGGGAGTAGAATCGAT",1,29,13,0,2,45,526
"AGGGAGTAGTTACGGG",0,6,0,0,0,6,146
"AGGGAGTCAGTATTCG",2,0,3,0,0,5,149
"AGGGAGTCATCATCCC",11,41,67,4,14,137,5335
"AGGGAGTGTACTCCCT",1,0,2,0,2,5,75
"AGGGAGTTCCCAAGTA",1,4,0,0,0,5,142
"AGGGAGTTCCCTTGTG",1,11,0,0,2,14,260
"AGGGAGTTCCGAAGGA",0,13,6,0,4,23,62
"AGGGAGTTCGTTCTGC",2,17,4,0,3,26,349
"AGGGCCTAGCATGTTC",49,186,84,295,59,673,25195
"AGGGCCTAGGACACTG",6,21,6,0,0,33,657
"AGGGCCTAGGCAGGTT",3,22,5,0,4,34,736
"AGGGCCTCAGGTCAGA",2,3,0,0,0,5,142
"AGGGCCTTCGTTCTCG",19,137,32,9,30,227,11381
"AGGGCTCAGAACCCGA",0,7,0,0,0,7,168
"AGGGCTCAGGAAGTGA",0,4,4,0,2,10,144
"AGGGCTCAGGCCTGCT",1,11,5,0,5,22,557
"AGGGCTCAGTGCAGGT",0,2,0,0,0,2,49
"AGGGCTCGTAAGGCCA",1,11,4,0,0,16,407
"AGGGCTCGTGATGAAT",4,2,0,0,0,6,80
"AGGGCTCTCAAGTCGT",512,1598,897,186,3177,6370,223198
"AGGGCTCTCCACACAA",188,1261,354,97,246,2146,84297
"AGGGCTCTCTTTCTAG",15,127,32,11,23,208,10732
"AGGGTCCAGCCTCATA",4,9,7,3,3,26,599
"AGGGTCCAGTGATCGG",5,16,4,0,5,30,437
"AGGGTCCCAAATTAGG",1,4,0,0,0,5,67
"AGGGTCCCACAGAAGC",0,7,2,0,0,9,31
"AGGGTCCCACGTTGGC",28,68,59,13,130,298,14639
"AGGGTCCGTCCTGTTC",0,18,2,0,2,22,491
"AGGGTCCTCCCGTGTT",83,203,585,47,107,1025,48377
"AGGGTCCTCTGATGGT",0,9,3,0,0,12,279
"AGGGTGAAGCGCCTTG",2,16,2,3,3,26,295
"AGGGTGAAGCGTGAGT",4,19,10,0,4,37,1410
"AGGGTGACAACCCTCT",5,14,4,0,6,29,142
"AGGGTGACAAGAAATC",0,2,0,0,0,2,24
"AGGGTGACACCTGCGA",2,3,0,0,0,5,139
"AGGGTGATCAAACCTG",143,377,1016,77,202,1815,93856
"AGGGTGATCCTTCTTC",2,7,3,0,3,15,459
"AGGGTTTAGAGTGTGC",16,141,36,8,30,231,9510
"AGGGTTTAGATCGCCC",0,3,0,0,0,3,26
"AGGGTTTCATAGAAAC",1,5,0,0,2,8,144
"AGGGTTTCATGGAGAC",18,70,17,8,12,125,5992
"AGGGTTTGTCAGCGTC",2,10,5,2,2,21,372
"AGGGTTTGTCATACCA",0,0,0,0,0,0,14
"AGGGTTTTCAAAGGAT",1,8,2,0,0,11,177
"AGGGTTTTCACCATCC",3,18,3,0,5,29,451
"AGGGTTTTCGCCATAA",0,29,4,0,2,35,599
"AGGTAGGAGATGTTGA",4,34,10,2,8,58,2170
"AGGTAGGAGCCTGGAA",2,21,2,0,2,27,56
"AGGTAGGAGGTGGGTT",0,4,0,2,2,8,268
"AGGTAGGAGTCCCAGC",0,2,2,0,0,4,100
"AGGTAGGCAAACCGGA",1,27,7,4,4,43,1343
"AGGTAGGCAACGTATC",18,38,90,11,18,175,8524
"AGGTAGGCACCGAATT",5,27,0,0,3,35,561
"AGGTAGGCACTGGAAG",151,925,326,64,207,1673,79120
"AGGTAGGCATCCGGTG",1,16,4,0,0,21,626
"AGGTAGGCATCGGTTA",148,409,472,75,861,1965,99015
"AGGTAGGTCTTGCAAG",1,3,0,0,0,4,33
"AGGTCATAGCGTGTTT",7,22,26,2,6,63,2864
"AGGTCATCACTTCCTG",0,0,0,0,0,0,29
"AGGTCATGTGGACTGA",2,2,0,0,2,6,136
"AGGTCATTCAAGTTGC",0,3,0,0,0,3,105
"AGGTCATTCTCTGCTG",23,60,102,10,43,238,10258
"AGGTCTAAGAAGCTGC",0,0,0,0,0,0,99
"AGGTCTAAGAGCCGTA",1,4,2,0,0,7,146
"AGGTCTAAGGAACTAT",0,5,2,0,0,7,139
"AGGTCTAAGGCCCGTT",5,44,9,0,7,65,2766
"AGGTCTAAGGTACAAT",264,1608,483,129,350,2834,123959
"AGGTCTACAAGAGTAT",1,6,0,0,0,7,50
"AGGTCTACATACTTTC",5,54,17,3,6,85,144
"AGGTCTACATATACCG",2,38,14,0,9,63,572
"AGGTCTACATGGGAAC",5,18,4,3,8,38,473
"AGGTCTAGTTCGCGTG",1,6,0,0,0,7,11
"AGGTCTATCTACTGCC",0,7,2,0,0,9,68
"AGGTGTTAGGGACCAT",1,11,6,0,0,18,108
"AGGTGTTCACATGAAA",1,6,0,0,0,7,517
"AGGTGTTCACGTAGAG",20,115,28,7,19,189,7308
"AGGTGTTCATGGATCT",0,5,2,0,0,7,250
"AGGTGTTTCGCAGTTA",6,75,14,7,13,115,5021
"AGGTGTTTCGGACAAG",6,20,3,0,5,34,576
"AGGTTACAGAGGCGGA",0,3,2,0,0,5,97
"AGGTTACAGCGGATCA",2,19,3,0,2,26,639
"AGGTTACAGGGATCTG",0,3,0,0,0,3,39
"AGGTTACGTCACGTGC",1,5,0,0,0,6,166
"AGGTTACGTTCAGGTT",2,26,8,0,0,36,665
"AGGTTACTCGAGTGGA",0,13,3,0,2,18,331
"AGGTTGTAGATGAATC",0,5,0,0,0,5,126
"AGGTTGTAGTCGGGAT",5,25,5,3,6,44,586
"AGGTTGTAGTTCATCG",2,10,3,0,3,18,48
"AGGTTGTCAACCTATG",0,0,0,0,0,0,9
"AGGTTGTCACCAGCTG",2,6,2,0,0,10,89
"AGGTTGTCAGAGAAAG",0,4,0,0,0,4,27
"AGGTTGTGTGATTAGA",3,28,11,2,8,52,582
"AGGTTGTGTTGTAAAG",23,161,38,9,24,255,9544
"AGGTTGTTCATCTACT",1,2,0,0,0,3,45
"AGGTTGTTCTGTGCGG",0,4,0,0,0,4,97
"AGTAACCAGCAACAGC",1,4,0,0,0,5,118
"AGTAACCAGCGGATCA",1,7,0,0,0,8,58
"AGTAACCAGTCAGGGT",3,23,9,0,2,37,504
"AGTAACCCAAAGTGTA",11,55,26,6,66,164,6123
"AGTAACCCACGTACAT",0,6,4,0,0,10,142
"AGTAACCGTAGACGGT",3,45,11,0,7,66,871
"AGTAACCGTCCGTACG",0,0,0,0,0,0,6
"AGTAACCGTGGCAGAT",2,7,2,0,2,13,429
"AGTACCACACTCAGAT",0,10,2,0,0,12,86
"AGTACCACAGGCTCTG",0,6,0,0,0,6,71
"AGTACCAGTAGACAGC",1,19,0,0,2,22,477
"AGTACTGAGGACGCTA",0,3,0,0,0,3,38
"AGTACTGCAGCTGAAG",4,28,7,0,9,48,1819
"AGTACTGCAGGTCCGT",1,3,4,0,0,8,424
"AGTACTGGTTTACCAG",0,10,0,0,3,13,198
"AGTACTGTCAGCCCAG",0,9,0,0,2,11,370
"AGTACTGTCCCTCGTA",2,23,8,4,12,49,975
"AGTACTGTCGCAGTCG",0,6,2,0,0,8,173
"AGTACTGTCGGCCCAA",0,5,0,0,0,5,80
"AGTACTGTCGGTATGT",3,11,5,0,2,21,346
"AGTAGCTAGCCGGATA",108,720,192,39,148,1207,67022
"AGTAGCTAGTGCGCTC",1,19,4,0,2,26,665
"AGTAGCTCACAGCTGC",263,1940,507,132,359,3201,149202
"AGTAGCTCATACTGAC",11,51,36,5,10,113,3494
"AGTAGCTCATATCTGG",36,270,59,12,40,417,23992
"AGTAGCTCATGGGTTT",0,15,5,2,0,22,543
"AGTAGCTGTCGTGCCA",1,3,0,0,0,4,42
"AGTAGCTGTTGCGGCT",4,17,4,0,3,28,122
"AGTAGCTTCAGAGCGA",3,29,23,0,8,63,2252
"AGTAGCTTCCCTCTAG",1,5,0,0,0,6,130
"AGTAGCTTCGTAACCA",18,61,53,3,41,176,5519
"AGTAGTCAGGCACAAC",8,22,38,5,9,82,4080
"AGTAGTCAGTGCTCGC",12,58,20,5,18,113,3736
"AGTAGTCCATGCACTA",0,0,2,0,0,2,69
"AGTAGTCCATTGTGCA",0,4,0,0,0,4,107
"AGTAGTCGTAAGGTCG",8,84,21,2,17,132,5956
"AGTAGTCGTCTTCAAG",0,2,2,0,0,4,209
"AGTAGTCGTGCATGAG",0,5,0,0,0,5,137
"AGTAGTCTCGACCAAT",1,6,3,0,0,10,91
"AGTCAACAGGAACGAA",0,9,3,0,2,14,140
"AGTCAACCAATTGCCA",0,3,2,0,2,7,89
"AGTCAACCACTTCTCG",1,7,2,0,0,10,194
"AGTCAACGTCGTGGTC",6,17,22,0,3,48,1235
"AGTCAACGTGGGAGAG",1,9,0,0,3,13,133
"AGTCAACTCGCCTATC",2,12,0,0,2,16,352
"AGTCACAAGAGCCATG",0,0,0,0,0,0,15
"AGTCACAAGCCGTCGT",0,4,0,0,0,4,38
"AGTCACACAAAGGCGT",0,2,0,0,0,2,29
"AGTCACACATGACTAC",0,20,8,0,4,32,774
"AGTCACACATGGATCT",4,16,6,2,7,35,590
"AGTCACAGTTGTTTGG",0,7,2,2,0,11,124
"AGTCACATCGACGCGT",0,0,0,0,0,0,42
"AGTCATGAGCTAGATA",598,454,185,53,150,1440,68547
"AGTCATGAGGGCAGGA",1,5,4,0,0,10,266
"AGTCATGCACGAGGAT",0,8,0,0,0,8,76
"AGTCATGCAGAAGCGT",2,21,7,0,4,34,607
"AGTCATGCAGATCCTA",1,14,2,0,7,24,114
"AGTCATGCATGAGATA",2,8,0,0,0,10,131
"AGTCATGGTTGTGCAT",0,2,4,0,0,6,57
"AGTCATGTCACTACTT",0,12,4,0,3,19,498
"AGTCATGTCGAGAAAT",1,3,2,0,0,6,98
"AGTCATGTCGAGCTGC",4,10,4,0,5,23,323
"AGTCATGTCTCAAAGC",14,128,32,43,20,237,11013
"AGTCTCCAGAATCGCG",0,0,0,0,0,0,9
"AGTCTCCAGAGTGACC",3,6,7,2,0,18,268
"AGTCTCCAGCTCTGTA",3,16,3,0,2,24,753
"AGTCTCCCACCTATCC",0,5,0,0,0,5,13
"AGTCTCCGTCCTTTGC",1,0,0,0,2,3,168
"AGTCTCCGTGGATTTC",179,908,241,66,176,1570,71867
"AGTCTCCGTTCCGTTC",1,13,2,0,3,19,468
"AGTCTCCTCCACTAGA",6,21,3,2,2,34,612
"AGTGACTAGCTGTTCA",1,3,0,0,2,6,188
"AGTGACTAGGAACTCG",103,112,39,7,24,285,12780
"AGTGACTAGGATGCGT",0,0,0,0,0,0,9
"AGTGACTCAGAGCCCT",0,13,0,0,2,15,181
"AGTGACTCATGGCTGC",0,4,0,0,0,4,98
"AGTGACTTCAGTCAGT",0,13,2,0,0,15,253
"AGTGACTTCGACATAC",2,20,3,0,0,25,576
"AGTGATCCAGGCCCTA",0,0,0,0,0,0,3
"AGTGATCGTGACAGGT",1,0,3,0,0,4,43
"AGTGATCTCTCTGCCA",90,225,160,615,117,1207,56108
"AGTGCCGAGGTCGTCC",0,6,0,0,0,6,330
"AGTGCCGCACAGTATC",0,7,0,0,2,9,120
"AGTGCCGCACTCTCGT",0,7,2,0,0,9,193
"AGTGCCGCAGCCTATA",0,4,2,0,0,6,372
"AGTGCCGCAGGGCTTC",11,48,85,7,16,167,7534
"AGTGCCGCATATGCGT",4,17,3,0,3,27,593
"AGTGCCGGTCCTCATC",0,0,0,0,0,0,3
"AGTGCCGGTCGGAAAC",1,6,0,0,0,7,223
"AGTGTTGCACGACAGA",0,7,0,0,0,7,153
"AGTGTTGCACGATTCA",4,33,13,2,18,70,1544
"AGTGTTGCAGGCATTT",1,2,3,0,0,6,90
"AGTGTTGCATCCAACA",3,18,14,0,9,44,1239
"AGTGTTGGTTATGGTC",0,5,3,0,2,10,94
"AGTGTTGTCAACGAGG",1,0,2,0,0,3,138
"AGTGTTGTCACCTTAT",61,500,118,40,83,802,41312
"AGTGTTGTCCATCACC",259,172,72,22,57,582,22208
"AGTGTTGTCGCACTCT",1,10,4,0,2,17,267
"AGTTAGCAGCGGTAAC",1,5,2,0,0,8,198
"AGTTAGCAGCGTTGTT",0,0,0,0,0,0,15
"AGTTAGCAGGAAAGAC",9,28,68,6,13,124,6573
"AGTTAGCCACAAGTGG",452,239,117,34,92,934,39879
"AGTTAGCCACGACAGA",1,19,3,0,0,23,494
"AGTTAGCCACTCCGGA",2,5,6,0,0,13,691
"AGTTAGCCAGGCTACC",2,8,0,0,4,14,181
"AGTTAGCCATGTTACG",0,3,0,0,0,3,72
"AGTTAGCGTAACGATA",0,2,0,0,0,2,11
"AGTTAGCGTACAAGCG",1,17,3,0,0,21,533
"AGTTAGCGTTATAGAG",0,2,0,0,0,2,114
"AGTTAGCTCTATTTCG",17,49,21,44,17,148,4619
"AGTTCCCTCCTCGCAT",0,8,0,0,0,8,134
"AGTTCGAAGGGCAGGA",1,8,0,0,0,9,110
"AGTTCGAGTCCTCCAT",1,2,0,0,0,3,423
"AGTTCGAGTTGCCATA",0,0,0,0,0,0,3
"AGTTCGATCATGCAGT",1,3,2,3,0,9,467
"AGTTCGATCTCTGACC",0,0,0,0,0,0,11
"ATACCGAAGACCAAAT",0,4,3,0,0,7,92
"ATACCGAAGCGTATAA",2,9,2,0,6,19,164
"ATACCGACAAGTCATC",1,14,3,0,0,18,635
"ATACCGACAGGACTTT",1,5,0,0,0,6,305
"ATACCGAGTACTCCGG",1,5,0,0,0,6,157
"ATACCGAGTAGAGATT",1,13,3,0,2,19,332
"ATACCGAGTTCAAGTC",4,14,4,0,2,24,514
"ATACCGATCCCTCGTA",0,2,0,0,0,2,5
"ATACCTTAGAGGATCC",0,0,0,0,0,0,7
"ATACCTTAGATAGGGA",0,2,3,0,2,7,45
"ATACCTTAGGGAGTGG",3,13,5,0,0,21,469
"ATACCTTCAGCAGACA",3,20,10,0,7,40,626
"ATACCTTGTGAACGGT",43,353,74,15,57,542,26843
"ATACCTTTCAGTGTGT",0,11,2,0,0,13,143
"ATACCTTTCTAGCCAA",1,32,4,2,3,42,1294
"ATACCTTTCTGGGCGT",1,3,2,0,0,6,199
"ATACTTCAGGTCATTC",171,1053,339,95,232,1890,91339
"ATACTTCAGTTTCAGC",0,8,2,0,0,10,74
"ATACTTCCAACTTGCA",149,914,329,74,184,1650,85853
"ATACTTCGTAGCTGAG",0,6,0,0,0,6,240
"ATACTTCGTCACTCAA",81,192,105,316,82,776,34969
"ATACTTCGTGAATTAG",3,19,7,2,5,36,67
"ATACTTCTCACGTCCT",2,12,0,0,2,16,96
"ATAGACCAGGCCTTCG",70,566,129,39,86,890,44411
"ATAGACCCACTGAGTT",0,0,0,0,0,0,19
"ATAGACCCAGGACAGT",0,6,3,0,2,11,169
"ATAGACCCAGGCGTTC",1,13,5,0,2,21,579
"ATAGACCCATGACTAC",33,172,32,13,25,275,13477
"ATAGACCCATTCACAG",23,142,31,8,23,227,10209
"ATAGACCGTTTGGGAG",1,2,0,0,0,3,106
"ATAGACCTCGTCTCAC",1,4,0,0,0,5,72
"ATAGAGAAGCTCTTCC",0,8,2,0,0,10,220
"ATAGAGAAGTATAGGT",19,86,86,8,30,229,8706
"ATAGAGACAACCAACT",1,46,10,5,8,70,114
"ATAGAGACACCGGTCA",1,2,2,0,2,7,156
"ATAGAGAGTACAAAGT",1,5,3,0,0,9,148
"ATAGAGAGTGAGGCAT",2,7,0,0,0,9,40
"ATAGAGATCAAATGAG",3,38,15,2,6,64,1057
"ATAGAGATCGATACAC",2,7,3,0,0,12,524
"ATAGAGATCGCTGTCT",0,6,0,0,0,6,160
"ATAGAGATCTTGGCTC",1,3,0,0,2,6,64
"ATAGGCTAGAATTCAG",3,32,8,4,4,51,1116
"ATAGGCTAGGATGCGT",2,7,0,2,6,17,177
"ATAGGCTCAATGCAGG",0,8,2,0,2,12,121
"ATATCCTCAAAGCTAA",102,271,101,22,68,564,26093
"ATATCCTGTCTACACA",32,78,84,14,191,399,19943
"ATATCCTGTTCTTAGG",4,23,8,2,6,43,716
"ATATCCTTCATGCTAG",2,4,0,0,0,6,161
"ATATCCTTCATTCTTG",1,5,2,2,2,12,474
"ATCACAGAGACATCCT",1,33,3,2,5,44,823
"ATCACAGAGATGACCG",0,8,0,0,0,8,71
"ATCACAGAGCATTTCG",55,422,106,25,72,680,37043
"ATCACAGCAAACCACT",4,9,5,0,0,18,366
"ATCACAGCAGCGAGTA",0,0,0,0,0,0,14
"ATCACAGCATGGAACG",23,59,16,4,16,118,4675
"ATCACAGTCCAACTGA",2,3,0,0,2,7,688
"ATCACGAAGATTGAGT",122,291,831,65,161,1470,81042
"ATCACGAAGTGCCCGT",2,22,6,0,4,34,1075
"ATCACGACAAGAATGT",0,11,0,0,2,13,162
"ATCACGACACAGCTTA",1,6,4,0,0,11,272
"ATCACGACACGTCGTG",3,6,0,0,2,11,54
"ATCACGACAGGATTCT",46,129,137,24,209,545,25121
"ATCACGACATCGTGGC",1,0,2,0,0,3,106
"ATCACGAGTGCCTTCT",0,5,0,0,0,5,83
"ATCACGAGTTGCGGCT",1,18,7,0,4,30,371
"ATCACGATCGGACTTA",0,2,2,0,2,6,212
"ATCACGATCTGCATGA",0,0,0,0,0,0,18
"ATCACTTAGTTAGTAG",0,0,0,0,0,0,11
"ATCACTTGTGTAGTGG",150,111,54,18,36,369,16248
"ATCACTTGTGTGCCTG",2,23,10,0,0,35,639
"ATCACTTGTTGGAGAC",0,0,0,0,0,0,13
"ATCACTTTCCGTATGA",177,435,287,984,207,2090,78935
"ATCACTTTCGGCTGAC",37,140,337,26,56,596,29205
"ATCACTTTCTCGAACA",0,5,0,0,0,5,110
"ATCACTTTCTGGACCG",0,5,0,0,0,5,59
"ATCAGGTAGAGCCCAA",11,27,7,4,5,54,925
"ATCAGGTAGGTGATAT",1,18,2,0,0,21,330
"ATCAGGTCACATGGTT",3,13,3,0,0,19,647
"ATCAGGTCACCGTGCA",0,6,0,0,0,6,91
"ATCAGGTGTCAAGTTC",0,0,2,0,0,2,9
"ATCAGGTGTCACTCGG",3,11,4,0,3,21,487
"ATCAGGTTCATTTCGT",1,0,0,0,0,1,7
"ATCAGGTTCTTCGATT",0,9,0,0,0,9,189
"ATCATTCAGCCTCTTC",2,24,4,0,5,35,177
"ATCATTCAGTAACCTC",1,25,4,0,2,32,462
"ATCATTCAGTGCAGGT",2,19,4,0,4,29,579
"ATCATTCCAAGCACAG",35,305,74,21,129,564,27798
"ATCATTCTCTACCAGA",10,65,30,4,83,192,8006
"ATCATTCTCTTCTTCC",7,21,6,0,2,36,798
"ATCCACCAGCCTTCTC",1,6,0,0,0,7,176
"ATCCACCAGCTCATAC",1,6,2,0,2,11,439
"ATCCACCAGGAGCAAA",0,2,0,0,0,2,40
"ATCCACCCATAACTCG",1,16,8,0,0,25,646
"ATCCACCCATAATGCC",2,19,6,0,4,31,814
"ATCCACCGTCTGTTAG",4,22,7,0,2,35,631
"ATCCACCGTTTGCAGT",0,5,0,0,2,7,119
"ATCCACCTCCGGACGT",52,617,168,26,90,953,39155
"ATCCATTAGCAACTTC",16,62,64,5,80,227,12271
"ATCCATTCACACCGAC",1,2,0,0,0,3,216
"ATCCATTCAGCGCGTT",0,5,0,0,0,5,415
"ATCCATTGTACCTATG",166,1183,373,70,221,2013,105901
"ATCCATTGTTCCCACT",5,27,11,0,0,43,915
"ATCCATTTCCGTCACT",0,10,5,0,3,18,294
"ATCCATTTCTTGGAAC",3,12,0,0,4,19,439
"ATCCCTGAGCCTGACC",2,8,0,0,0,10,179
"ATCCCTGAGCTTAGTC",5,90,21,3,16,135,7591
"ATCCCTGCAACCACGC",0,2,0,0,2,4,93
"ATCCCTGGTCCAATCA",46,183,72,17,39,357,16437
"ATCCCTGGTCTACGAT",11,35,35,6,47,134,7102
"ATCCCTGGTGATAGAT",1,2,0,0,2,5,132
"ATCCCTGTCTCGGCTT",1,4,0,0,0,5,15
"ATCCCTGTCTCTGAGA",3,18,10,0,4,35,478
"ATCCCTGTCTTACTGT",0,7,2,0,0,9,158
"ATCCGTCCAGTCAGTT",2,16,2,0,4,24,855
"ATCCGTCGTAAGGTCG",0,0,0,0,0,0,22
"ATCCGTCGTAGTGTGG",3,3,2,0,2,10,172
"ATCCGTCGTAGTTAGA",1,5,3,0,0,9,163
"ATCCGTCGTCGCGTCA",1,4,0,0,0,5,68
"ATCCGTCTCAACGAGG",2,20,5,0,3,30,723
"ATCCGTCTCTTCGGTC",1,18,8,0,3,30,56
"ATCCGTCTCTTTGCTA",1,0,0,0,0,1,164
"ATCCTATCAACGTAAA",0,4,0,0,0,4,43
"ATCCTATCAGCAGGAT",0,13,5,0,3,21,591
"ATCCTATGTCACCACG",25,193,49,17,38,322,13850
"ATCCTATTCACAGTGT",6,40,14,3,5,68,1143
"ATCCTATTCACTTTGT",1,19,8,0,3,31,48
"ATCCTATTCGGTCTGG",1,6,0,0,0,7,151
"ATCGATGAGGAGTATT",3,26,6,0,5,40,658
"ATCGATGAGTATGATG",4,27,7,2,9,49,2090
"ATCGATGCACCCTATC",0,16,6,0,2,24,653
"ATCGATGCAGGAATCG",19,94,37,11,20,181,7761
"ATCGATGCAGGCTTGC",1,3,0,0,0,4,110
"ATCGATGTCAAGCTGT",9,27,4,0,4,44,639
"ATCGATGTCACCGCTT",0,4,0,0,0,4,165
"ATCGATGTCGTAGGGA",1,2,0,0,0,3,14
"ATCGATGTCTCCCAAC",45,312,72,18,56,503,26982
"ATCGCCTAGAGGGCGA",63,448,96,32,73,712,42746
"ATCGCCTAGGTCTTTG",1,2,0,0,0,3,20
"ATCGCCTAGTGGGAAA",0,9,0,0,0,9,114
"ATCGCCTAGTTGAATG",2,25,11,2,2,42,599
"ATCGCCTGTGTAAATG",133,284,94,24,70,605,27487
"ATCGCCTTCGGCCAAC",233,1618,417,120,296,2684,122459
"ATCGGATAGATGAACT",1,6,2,0,0,9,48
"ATCGGATAGATGGGCT",3,5,2,0,0,10,96
"ATCGGATAGGCCACTC",0,3,0,0,0,3,13
"ATCGGATAGTACTGTC",10,41,18,5,63,137,6744
"ATCGGATCAACGTATC",2,4,0,0,0,6,132
"ATCGGATCAAGGCGTA",2,5,0,0,2,9,234
"ATCGGATCACCCTCTA",6,18,3,0,4,31,594
"ATCGGATCATATCTCT",1,9,3,0,0,13,411
"ATCGGATGTAGTTAGA",101,735,226,65,126,1253,68944
"ATCGGATGTCACCGAC",5,23,7,0,5,40,856
"ATCGGATGTCCCTGAG",55,138,407,15,64,679,38850
"ATCGGATTCAATCTTC",1,14,6,2,0,23,614
"ATCGGATTCTCAGTCC",36,257,60,17,41,411,20610
"ATCGGCGAGCAAGTCG",1,6,0,2,0,9,101
"ATCGGCGCAATTTCGG",0,6,0,0,2,8,60
"ATCGGCGCACCTAAAC",0,3,2,0,0,5,275
"ATCGGCGGTGAGATTA",0,2,0,0,0,2,49
"ATCGGCGGTGTCCGTG",0,4,0,0,0,4,30
"ATCGGCGTCCAGCAAT",0,4,0,0,0,4,56
"ATCGGCGTCCCAATAG",0,3,0,0,2,5,210
"ATCGGCGTCGCACTCT",0,3,0,0,0,3,12
"ATCGTAGAGTCCGTCG",0,0,0,0,0,0,12
"ATCGTAGAGTGGTTAA",3,4,3,0,9,19,237
"ATCGTAGCATTGCTTT",0,0,0,0,0,0,1
"ATCGTAGTCAGCTGTA",3,21,4,0,5,33,640
"ATCGTAGTCTCTGACC",73,100,34,2,23,232,7360
"ATCGTCCAGTCCCAAT",0,2,0,0,0,2,60
"ATCGTCCCAAGGGTCA",2,24,9,0,6,41,861
"ATCGTCCGTTCGTAAC",97,367,186,52,637,1339,64812
"ATCGTCCTCCGTACGG",0,9,0,0,0,9,182
"ATCGTCCTCGACGCGT",1,4,2,0,0,7,271
"ATCGTGAAGCGATTCT",1,4,2,0,5,12,941
"ATCGTGAAGCGTCAAG",1,4,2,0,2,9,47
"ATCGTGACAGTCGTTA",0,0,0,0,0,0,8
"ATCGTGAGTCCTGTTC",11,61,16,4,13,105,4170
"ATCGTGAGTCGTTCAA",0,5,4,0,0,9,72
"ATCGTGATCCTCATAT",0,7,0,0,3,10,139
"ATCGTGATCGCGGTAC",2,23,10,0,5,40,1171
"ATCGTGATCTTCGGAA",147,410,788,80,463,1888,93204
"ATCTCTACACGAAGAC",1,6,3,0,0,10,243
"ATCTCTACACTCTCGT",36,83,19,6,8,152,4061
"ATCTCTACATCGTGGC",0,0,0,0,0,0,73
"ATCTCTAGTACGGCAA",1,0,0,0,0,1,243
"ATCTCTAGTTTCGTTT",0,3,0,0,0,3,13
"ATCTCTATCAGAGTGG",10,31,14,2,2,59,1431
"ATCTCTATCCTACTGC",1,3,0,0,3,7,481
"ATCTCTATCGAGTCCG",0,0,0,0,0,0,11
"ATCTCTATCGATGCTA",6,35,10,2,21,74,1116
"ATCTTCAAGTATAGGT",0,4,0,0,0,4,168
"ATCTTCAAGTCCCGAC",1,8,0,0,2,11,239
"ATCTTCACAGGACAGT",0,7,0,0,0,7,148
"ATCTTCATCGGCTCTT",0,5,0,0,0,5,234
"ATGAAAGAGCAGCGAT",2,44,7,0,5,58,557
"ATGAAAGAGCTAGAGC",8,67,19,3,15,112,4238
"ATGAAAGCAAATCCCA",1,0,0,0,0,1,16
"ATGAAAGCATACAGGG",1,5,5,0,0,11,250
"ATGAAAGGTCGGAAAC",11,52,74,5,42,184,8122
"ATGAAAGGTTAGGGAC",24,75,79,10,92,280,12886
"ATGAAAGTCAACGCTA",0,22,9,0,3,34,645
"ATGAAAGTCCTTCTAA",1,8,3,0,0,12,187
"ATGACCAAGAAGCCAC",6,36,45,3,14,104,3194
"ATGACCAAGACCGTTT",4,36,10,0,6,56,764
"ATGACCAAGATAGCAT",2,6,0,0,0,8,180
"ATGACCAAGGGATGTC",14,51,64,9,18,156,5974
"ATGACCAAGGTCTACT",0,26,10,2,2,40,851
"ATGACCAGTAGGATAT",0,2,2,0,0,4,128
"ATGACCAGTATGAGGC",0,5,0,0,0,5,95
"ATGACCAGTGAGCCAA",1,21,7,0,4,33,1054
"ATGACCAGTTCAAACC",0,2,0,0,2,4,149
"ATGACCATCTATACTC",4,36,13,2,7,62,981
"ATGAGGGAGACATGCG",13,74,28,6,21,142,4721
"ATGAGGGAGAGAGCAA",29,58,28,77,30,222,8427
"ATGAGGGCATGAGTAA",68,47,20,5,20,160,5431
"ATGAGGGCATTCCTAT",1,11,3,0,0,15,41
"ATGAGGGCATTGCTTT",0,3,0,0,0,3,150
"ATGAGGGGTCACTGAT",0,0,0,0,0,0,86
"ATGAGGGGTTTAGACC",1,3,3,0,0,7,144
"ATGAGGGTCATTTGCT",7,38,34,0,8,87,3884
"ATGAGGGTCCATCCGT",23,125,27,11,27,213,8774
"ATGAGTCAGAAATGGG",1,5,0,0,0,6,119
"ATGAGTCAGTGTTCCA",1,21,15,0,2,39,404
"ATGAGTCCAAAGCGTG",31,102,127,10,160,430,20360
"ATGAGTCCAACCACAT",0,7,0,0,0,7,85
"ATGAGTCCATAAGATG",50,122,79,24,248,523,19610
"ATGAGTCCATCCAATG",0,9,2,0,0,11,100
"ATGAGTCGTAGTATAG",4,20,15,0,4,43,767
"ATGAGTCGTTATGTCG",0,0,0,0,0,0,3
"ATGAGTCGTTGGACTT",8,37,64,3,67,179,5321
"ATGATCGCATACCACA",2,31,7,0,2,42,634
"ATGATCGCATGGAACG",4,23,3,0,2,32,880
"ATGATCGTCGCGTTTC",1,5,0,0,0,6,48
"ATGATCGTCGTCCTTG",3,4,0,0,0,7,98
"ATGATCGTCTCCATAT",0,33,16,2,6,57,369
"ATGATCGTCTCTCTTC",0,0,0,0,0,0,5
"ATGCATGAGATTCGCT",0,4,0,0,0,4,30
"ATGCATGAGCCTTTGA",1,6,0,0,0,7,150
"ATGCATGAGCGGATCA",0,0,0,0,3,3,99
"ATGCATGAGGAAAGAC",1,4,0,0,0,5,76
"ATGCATGAGTCACTGT",1,0,0,0,0,1,25
"ATGCATGAGTGTTGTC",4,16,4,2,4,30,859
"ATGCATGCAAGTGGTG",0,5,0,0,0,5,133
"ATGCATGGTACAGTCT",1,5,0,0,2,8,156
"ATGCATGTCATCGCCT",1,38,5,0,4,48,1227
"ATGCATGTCCCAACTC",64,165,358,32,216,835,35493
"ATGCATGTCCTCTAGC",15,67,149,14,31,276,9910
"ATGCATGTCGTTCGCT",0,0,0,0,2,2,24
"ATGCCTCAGGATGTTA",3,27,9,4,2,45,797
"ATGCCTCAGTGAGTGC",2,5,5,0,0,12,200
"ATGCCTCCAACCGTGC",1,2,0,0,3,6,424
"ATGCCTCCACTGGAAG",1,17,7,0,6,31,829
"ATGCCTCGTGTTTACG",0,2,2,0,0,4,29
"ATGCCTCGTTCAGGTT",2,3,3,0,3,11,204
"ATGCCTCGTTCGGCTG",1,9,2,2,2,16,309
"ATGCCTCTCGCACTCT",0,3,3,0,3,9,164
"ATGCCTCTCTTTCAGT",1,0,2,0,0,3,188
"ATGCGATAGATAGCAT",0,2,2,0,0,4,51
"ATGCGATAGCTGAAGC",1,3,2,0,0,6,192
"ATGCGATAGGATTTCC",4,32,9,6,7,58,90
"ATGCGATCAATACAGA",0,8,2,0,2,12,206
"ATGCGATCAATTGGTC",1,5,0,0,0,6,335
"ATGCGATCAGAAATTG",3,27,21,3,11,65,1983
"ATGCGATCATTCCTCG",1,33,6,0,8,48,1010
"ATGCGATTCGGTTCAA",4,10,3,0,0,17,131
"ATGCGATTCTAGGAAA",1,2,0,0,0,3,8
"ATGGAGGAGACAGTCG",23,194,41,10,27,295,10458
"ATGGAGGAGCGAATGC",1,8,0,0,0,9,209
"ATGGAGGAGGGCCAAT",2,23,10,2,11,48,1715
"ATGGAGGAGGTAAGGA",2,22,5,0,3,32,767
"ATGGAGGAGTTGAATG",2,8,2,0,0,12,213
"ATGGAGGCACCAGCCA",0,7,0,0,3,10,36
"ATGGAGGCACCAGCTG",0,4,0,0,0,4,204
"ATGGAGGGTTGGCTAT",1,0,0,0,0,1,35
"ATGGAGGTCATTATCC",1,20,2,0,4,27,838
"ATGGATCAGCAGTACG",0,0,0,0,2,2,127
"ATGGATCCAAGGGTCA",0,10,0,0,0,10,350
"ATGGATCCAATGAGCG",1,17,2,3,0,23,465
"ATGGATCTCCACCTGT",0,20,4,0,5,29,804
"ATGGGAGAGAAGCCAC",3,20,3,0,0,26,245
"ATGGGAGAGGACAGCT",13,53,96,9,22,193,10304
"ATGGGAGAGTCTTCGA",4,15,5,0,0,24,68
"ATGGGAGCACCAATTG",34,119,63,196,53,465,19185
"ATGGGAGGTTTGACAC",1,14,4,0,0,19,751
"ATGGGAGTCGACCACG",1,12,2,0,0,15,104
"ATGGGTTAGAAGTGTT",0,7,2,0,4,13,92
"ATGGGTTAGACATATG",1,0,0,0,0,1,39
"ATGGGTTAGCTTAGTC",1,2,0,0,0,3,67
"ATGGGTTAGGACAGCT",6,32,16,4,29,87,2701
"ATGGGTTAGGTCCTGC",78,501,171,39,136,925,46458
"ATGGGTTCACGAGGAT",0,7,5,0,0,12,100
"ATGGGTTCAGCGTGCT",0,7,0,0,0,7,110
"ATGGGTTGTGTTGAGG",0,24,5,2,0,31,801
"ATGGGTTTCAGCGGAA",0,4,0,0,0,4,88
"ATGGGTTTCTTGAACG",0,5,2,0,0,7,220
"ATGGTTGAGATGAACT",0,2,0,0,2,4,355
"ATGGTTGAGATGCAGC",1,6,0,0,0,7,40
"ATGGTTGAGCTGTTCA",81,356,174,36,274,921,48272
"ATGGTTGAGTAGCAAT",0,11,3,0,4,18,606
"ATGGTTGCAACAAAGT",0,2,3,0,0,5,313
"ATGGTTGGTCCATCTC",3,24,6,0,4,37,1087
"ATGGTTGGTGTTGAGG",22,180,49,19,49,319,12966
"ATGGTTGTCCAAACCA",0,6,0,0,3,9,42
"ATGTCCCAGCAGTCTT",0,3,0,0,2,5,138
"ATGTCCCAGTGCCCGT",1,9,2,2,3,17,615
"ATGTCCCCAACGTAAA",1,9,10,0,2,22,416
"ATGTCCCCACGCGCTA",2,22,2,0,3,29,1334
"ATGTCCCCACTCCGAG",0,0,0,0,0,0,11
"ATGTCCCCAGTCGTTA",0,2,0,0,0,2,127
"ATGTCCCCAGTTTGGT",166,78,51,19,44,358,14247
"ATGTCCCGTAGACAGC",0,0,0,0,0,0,26
"ATGTCCCGTGACCTGC",0,4,2,0,0,6,320
"ATGTCCCTCTTCGTAT",3,12,0,2,2,19,519
"ATGTCTTAGATTCGAA",1,6,2,0,0,9,93
"ATGTCTTAGTTCATGC",1,11,2,0,0,14,222
"ATGTCTTGTAACATGA",30,82,134,16,38,300,9962
"ATGTCTTGTGGATCAG",0,2,0,0,0,2,31
"ATGTCTTTCATACGGT",18,123,36,8,28,213,6052
"ATGTCTTTCCTCAGGG",0,2,2,0,0,4,126
"ATGTCTTTCTGTGCGG",0,3,0,0,0,3,74
"ATTACCTAGTAGTGCG",0,3,0,0,0,3,16
"ATTACCTAGTGCTCAT",1,10,4,0,0,15,167
"ATTACCTCAACCTATG",4,26,3,0,6,39,380
"ATTACCTGTAAGTTAG",2,31,6,0,2,41,763
"ATTACCTGTGAGTGAC",1,9,4,2,2,18,298
"ATTACCTTCAGCAATC",1,30,6,2,5,44,495
"ATTACCTTCCAGTGCG",1,15,8,0,7,31,695
"ATTACCTTCCTACCGT",1,7,0,0,0,8,112
"ATTACTCAGGATCACG",0,4,0,0,0,4,112
"ATTACTCAGGTCGCCT",1,3,0,0,0,4,47
"ATTACTCAGTTGTCAC",3,13,8,0,0,24,510
"ATTACTCCAATCTCGA",56,214,209,28,186,693,29856
"ATTATCCAGCATTGAA",0,0,0,0,0,0,7
"ATTATCCAGGTCCCGT",0,5,0,0,0,5,36
"ATTATCCCAAATGGTA",0,7,0,0,0,7,87
"ATTATCCGTAACTAAG",0,4,0,0,0,4,46
"ATTATCCGTCGTACTA",2,21,11,0,5,39,643
"ATTATCCGTTCAGTAC",1,5,3,0,0,9,1035
"ATTATCCGTTCGAGCC",0,8,2,0,3,13,122
"ATTCACTAGATGAATC",2,7,2,0,2,13,160
"ATTCACTAGCCGATTT",1,4,0,0,0,5,363
"ATTCACTAGTGCCAGA",1,3,0,0,0,4,152
"ATTCACTCACAGTCGC",0,3,0,0,0,3,185
"ATTCACTCAGTTCCAA",1,10,0,0,0,11,137
"ATTCACTGTAGCTTTG",7,39,48,5,11,110,3932
"ATTCACTGTGGTAACG",0,0,0,0,0,0,22
"ATTCACTGTTCGGACC",0,5,2,0,2,9,129
"ATTCACTTCCGCGAGT",203,1483,382,96,244,2408,117264
"ATTCAGGAGAGCCATG",2,5,3,0,0,10,153
"ATTCAGGCACTATCGA",0,0,0,0,0,0,42
"ATTCAGGCATAGGCGA",8,28,43,2,8,89,3733
"ATTCAGGGTACAGGTG",0,2,0,0,0,2,71
"ATTCAGGGTTCGAGCC",3,14,2,0,4,23,511
"ATTCAGGTCAAGCGTT",0,14,3,0,5,22,411
"ATTCAGGTCCATACAG",0,2,2,0,0,4,20
"ATTCAGGTCGAGCCTG",4,30,5,0,6,45,741
"ATTCAGGTCGGAGCAA",0,6,0,0,0,6,52
"ATTCATCAGGGTACGT",0,4,3,0,0,7,185
"ATTCATCCACAACATC",10,99,23,14,26,172,6363
"ATTCATCCACGCGGTT",0,2,0,0,0,2,171
"ATTCATCGTACTGCCG",0,4,3,0,0,7,97
"ATTCATCGTAGGGAGG",1,5,0,0,0,6,78
"ATTCATCGTGCAAGAC",2,2,0,0,0,4,58
"ATTCATCTCATCGACA",0,7,4,0,0,11,356
"ATTCCATCACCCTTAC",1,8,4,0,0,13,533
"ATTCCATCATACATCG",0,2,0,0,0,2,130
"ATTCCATCATCCGAAT",0,7,0,0,0,7,287
"ATTCCATTCTGTTCAT",0,6,0,0,0,6,421
"ATTCCCGAGCCTCTGG",0,4,0,0,0,4,110
"ATTCCCGCATTGGATC",0,2,2,0,0,4,72
"ATTCCCGGTGGTTCTA",0,4,0,0,0,4,179
"ATTCCCGGTTCGGCGT",1,8,0,0,0,9,108
"ATTCCCGGTTTCCCAC",75,664,147,51,128,1065,43686
"ATTCCTACAACCCGCA",0,5,2,0,0,7,143
"ATTCCTACAAGATGTA",3,11,2,0,5,21,248
"ATTCCTACAGCTTCCT",1,14,2,0,0,17,239
"ATTCCTATCCAATCTT",3,21,4,0,3,31,717
"ATTCCTATCTGGGCAC",1,8,3,0,0,12,248
"ATTCGTTAGCAAATGT",1,4,0,0,2,7,131
"ATTCGTTAGCCTCATA",0,6,0,0,0,6,152
"ATTCGTTCATACAGCT",1,9,0,0,3,13,115
"ATTCGTTCATCGCTGG",0,4,2,0,0,6,96
"ATTCGTTGTTTACCTT",15,108,30,8,19,180,8923
"ATTCGTTTCACTGGGC",14,98,35,7,52,206,10455
"ATTCGTTTCTCCTGCA",0,0,2,2,4,8,167
"ATTCTACAGCAAGCCA",0,9,3,0,0,12,134
"ATTCTACCACCAGACC",0,4,2,0,0,6,199
"ATTCTACGTAGATCGG",0,15,3,0,0,18,462
"ATTCTACGTATTCCGA",0,10,4,0,0,14,168
"ATTCTACGTATTGACC",0,0,0,0,0,0,36
"ATTCTACGTCTTGCGG",104,709,213,56,150,1232,54264
"ATTCTACGTTGGGTAG",6,32,9,2,7,56,1109
"ATTCTACGTTTAGAGA",0,3,0,0,0,3,83
"ATTCTACTCTTTCCGG",1,22,7,2,9,41,655
"ATTCTTGAGACGATAT",109,641,209,52,121,1132,58235
"ATTCTTGAGCGAATGC",1,38,8,2,7,56,697
"ATTCTTGAGCGAGTAC",0,2,0,0,0,2,13
"ATTCTTGCAGACCAAG",0,3,2,0,0,5,139
"ATTCTTGCATGGCGCT",1,21,7,0,5,34,1153
"ATTCTTGGTAGATTAG",0,2,0,0,0,2,15
"ATTCTTGGTGGCGTAA",0,7,0,0,0,7,109
"ATTCTTGTCACTCACC",44,314,100,17,67,542,24791
"ATTCTTGTCGGAGTAG",0,0,0,0,0,0,20
"ATTCTTGTCTTTGCTA",13,70,21,5,13,122,6086
"ATTGGGTAGGGCCCTT",3,20,6,0,6,35,479
"ATTGGGTGTATGAGGC",29,227,81,19,46,402,19058
"ATTGGGTGTCACCACG",2,13,3,0,3,21,779
"ATTGGGTGTCCAGGTC",65,49,24,8,22,168,7400
"ATTGGGTTCATGTCTT",1,8,0,0,0,9,133
"ATTGGGTTCCATCTAT",4,30,5,0,3,42,1108
"ATTGTTCAGAAACACT",11,78,20,5,15,129,6338
"ATTGTTCAGTCAGCCC",2,21,11,0,6,40,739
"ATTGTTCAGTGCCGAA",1,22,3,0,0,26,638
"ATTGTTCCATCATCCC",118,288,76,23,65,570,26002
"ATTGTTCTCAGGAGAC",4,34,4,2,10,54,779
"ATTGTTCTCGCTTGCT",0,0,0,0,0,0,54
"ATTGTTCTCGGTTGTA",35,91,27,3,21,177,8606
"ATTGTTCTCTGCGTCT",12,38,37,5,13,105,4080
"ATTTACCCACGCTGAC",0,5,2,0,0,7,104
"ATTTACCCATCACGGC",1,5,0,0,0,6,116
"ATTTACCGTACGATCT",12,104,25,4,17,162,6613
"ATTTACCGTGTTACTG",0,4,0,0,0,4,64
"ATTTACCTCCAATGCA",0,12,0,0,0,12,36
"ATTTACCTCCTGTTGC",9,21,15,0,63,108,5226
"ATTTACCTCTAGTACG",0,7,3,0,2,12,758
"ATTTACCTCTTGTTAC",74,581,139,36,98,928,46362
"ATTTCACAGGTTATAG",0,6,2,0,0,8,138
"ATTTCACAGTCTCTGA",55,214,57,14,44,384,16606
"ATTTCACAGTGGAAAG",2,14,3,0,3,22,317
"ATTTCACGTGTCTAAC",2,31,10,0,0,43,968
"ATTTCACGTTGACTGT",5,20,10,2,6,43,664
"ATTTCACTCCGCTGTT",1,5,3,0,0,9,303
"ATTTCACTCGATACTG",1,6,3,0,3,13,218
"ATTTCACTCGATCCAA",0,5,2,0,0,7,120
"ATTTCACTCGTCGCTT",87,96,51,6,16,256,7072
"ATTTCTGAGATTGCGG",0,3,0,0,0,3,25
"ATTTCTGAGCTCCCTT",0,10,0,0,0,10,390
"ATTTCTGAGTTTGAGA",33,210,67,6,42,358,16890
"ATTTCTGCACTGGATT",7,60,21,29,16,133,4839
"ATTTCTGCAGACGGAT",1,4,2,0,0,7,124
"ATTTCTGCAGGGAGAG",2,4,2,0,0,8,107
"ATTTCTGTCCGCAGTG",0,0,0,0,0,0,3
"ATTTCTGTCGTGGCTG",2,4,0,0,0,6,86
"CAAAGAAAGCTGGCCT",6,38,18,0,12,74,2276
"CAAAGAAAGGCGTCCT",0,4,0,0,0,4,133
"CAAAGAACAACACAAA",1,3,3,0,0,7,154
"CAAAGAACATCGCCTT",22,21,7,2,4,56,1793
"CAAAGAACATTGGATC",0,5,0,0,0,5,11
"CAAAGAAGTAGTATAG",6,36,33,2,10,87,2906
"CAAAGAAGTCAACCAT",17,91,218,14,33,373,19805
"CAAAGAAGTCGCATTA",0,4,0,0,0,4,41
"CAAAGAAGTTACACAC",1,2,0,0,0,3,38
"CAAAGAATCAGAGCAG",0,8,0,0,0,8,147
"CAAAGAATCCGAGCTG",6,55,18,14,19,112,3343
"CAAAGAATCGACCAAT",0,7,2,0,5,14,232
"CAACAACAGGTTAGTA",0,16,3,0,6,25,431
"CAACAACCAACGGCCT",0,8,0,0,2,10,176
"CAACAACCAGGTGTGA",14,55,26,68,21,184,5900
"CAACAACCAGGTTCGC",2,6,0,0,0,8,187
"CAACAACGTATTGCCA",32,347,76,21,58,534,31454
"CAACAACGTCGAAGCA",3,8,3,0,0,14,765
"CAACAACTCCAGCCTT",6,31,5,0,4,46,1180
"CAACAACTCCCTTTGG",1,6,3,0,0,10,303
"CAACAACTCGGCTGAC",2,15,9,0,3,29,637
"CAACAACTCTGACAGT",4,22,4,0,3,33,336
"CAACAACTCTGAGCAT",120,70,38,8,29,265,9463
"CAACAGTAGAAGTCCG",0,0,3,0,0,3,194
"CAACAGTAGCGTCAGA",0,7,0,0,0,7,108
"CAACAGTAGGTACCTT",137,743,183,38,153,1254,62902
"CAACAGTAGTTGAAGT",1,0,0,0,0,1,124
"CAACAGTCATAGGTAA",1,9,0,0,0,10,217
"CAACAGTCATCCAACA",2,14,2,0,3,21,381
"CAACCAAAGAATCCCT",17,131,32,10,25,215,11064
"CAACCAACAAATCGGG",6,18,7,0,2,33,792
"CAACCAACATATCTGG",3,12,3,0,8,26,770
"CAACCAAGTGCCTGCA",24,232,57,15,44,372,19520
"CAACCAAGTTGCCGAC",1,6,0,0,0,7,145
"CAACCAATCGCCAACG",0,0,2,0,0,2,40
"CAACCTCAGGAACGCT",1,23,8,0,5,37,573
"CAACCTCAGTGGCGAT",1,26,5,2,2,36,764
"CAACCTCCAGTCAGAG",0,12,4,0,3,19,285
"CAACCTCCATCGGAAG",3,14,5,0,2,24,384
"CAACCTCGTAACTTCG",1,25,4,0,0,30,1218
"CAACCTCGTCAGTCTA",3,19,12,3,2,39,825
"CAACCTCGTTCTCCAC",0,3,0,0,0,3,29
"CAACGATAGACCATTC",4,24,7,0,7,42,1143
"CAACGATAGCCGTCGT",0,2,0,0,0,2,61
"CAACGATAGGACAGTC",0,9,0,0,0,9,132
"CAACGATAGGTGGTTG",2,17,4,0,7,30,426
"CAACGATAGTAGACAT",1,6,0,0,0,7,299
"CAACGATGTCCGTACG",1,14,3,0,4,22,470
"CAACGGCAGTAAGACT",0,13,2,0,3,18,40
"CAACGGCGTGCGGATA",0,4,0,0,0,4,70
"CAACGGCTCGTGACTA",1,31,7,0,5,44,603
"CAAGACTAGGTGCCAA",0,2,0,0,2,4,49
"CAAGACTAGTCAGAGC",0,5,0,0,0,5,66
"CAAGACTCAACCGATT",166,417,367,71,1048,2069,97167
"CAAGACTCAATGGCCC",0,8,0,2,3,13,384
"CAAGACTGTACTCCGG",0,3,3,0,2,8,242
"CAAGACTGTTGCATGT",0,5,0,0,0,5,150
"CAAGACTTCCGTGCGA",5,33,16,0,29,83,4577
"CAAGACTTCGTTACCC",5,19,7,0,6,37,512
"CAAGAGGAGCCAACCC",0,4,0,0,0,4,52
"CAAGAGGCAAGCACCC",1,9,3,0,0,13,154
"CAAGAGGCACTTACAG",2,10,0,3,4,19,230
"CAAGAGGCAGTCGCTG",0,8,0,0,0,8,133
"CAAGAGGCATCCAATG",2,9,3,0,3,17,495
"CAAGAGGCATGTAACC",390,182,91,113,81,857,36468
"CAAGAGGTCATAGAGA",0,3,0,0,0,3,84
"CAAGAGGTCCGTGGTG",0,6,0,0,0,6,255
"CAAGAGGTCGTAATGC",133,194,53,10,38,428,12821
"CAAGAGGTCTCCATAT",4,21,23,0,4,52,2104
"CAAGCTACAACGGCCT",0,0,0,0,0,0,14
"CAAGCTAGTATGCGGA",18,124,50,6,26,224,11714
"CAAGCTAGTCAGTCTA",1,4,3,0,4,12,465
"CAAGCTAGTTGCATCA",4,18,11,0,12,45,1372
"CAAGGGACATGTTCAG",6,14,10,2,5,37,1313
"CAAGGGACATTCTGTT",2,28,6,0,2,38,840
"CAAGGGAGTACAGTCT",0,4,0,0,0,4,146
"CAAGGGAGTCTAGGTT",9,7,2,0,0,18,717
"CAAGGGATCAGAGTTC",1,10,0,0,0,11,91
"CAAGGGATCCGTTGGG",1,6,0,0,0,7,86
"CAAGGGATCGCCGAAC",8,56,11,5,10,90,3557
"CAATACGAGGGCAGTT",0,8,0,0,0,8,284
"CAATACGTCACTACGA",4,11,8,0,4,27,792
"CAATACGTCCTTCTAA",4,25,20,2,9,60,1498
"CAATCGAAGATGAACT",0,12,4,0,2,18,54
"CAATCGACAAGCAGGT",40,282,76,18,52,468,19233
"CAATCGACAGGTGAGT",1,5,0,0,0,6,104
"CAATCGACATACAGGG",0,4,0,0,0,4,102
"CAATCGAGTACCTGTA",0,10,6,0,0,16,166
"CAATCGAGTACTTGTG",0,0,0,0,4,4,44
"CAATCGAGTCGGCTAC",0,0,0,0,0,0,23
"CAATCGAGTGTAAACA",43,201,59,15,49,367,18124
"CAATCGAGTTGCTGAT",1,0,3,0,0,4,70
"CAATCGATCATGAGGG",1,16,3,0,0,20,339
"CAATCGATCCCGAGGT",2,10,0,0,2,14,221
"CAATCGATCGTGTGAT",0,14,4,0,2,20,379
"CAATGACAGATACGAT",0,4,0,0,3,7,166
"CAATGACAGATAGTCA",2,6,3,0,3,14,325
"CAATGACAGGTATAGT",1,6,0,0,4,11,130
"CAATGACCACCATAAC",0,4,2,0,0,6,112
"CAATGACCAGAGTCAG",2,21,3,0,4,30,798
"CAATGACCAGTAACCT",1,16,6,0,4,27,1572
"CAATGACCATGACTAC",2,9,6,0,0,17,300
"CAATGACGTATGCGGA",0,3,2,0,0,5,120
"CAATGACTCCATTCAT",3,26,20,0,8,57,1252
"CAATGACTCTACACTT",45,247,63,11,56,422,17529
"CAATTTCAGAAGAGCA",6,21,6,0,3,36,369
"CAATTTCAGGGAGGTG",24,262,56,18,52,412,18294
"CAATTTCAGTGAGTTA",0,7,4,0,2,13,203
"CAATTTCCAGTCTTCC",36,89,183,20,50,378,15454
"CAATTTCGTCTTTCAT",0,0,3,0,0,3,256
"CAATTTCTCGAGTCCG",0,4,3,0,2,9,306
"CAATTTCTCGTTATCT",30,85,148,10,30,303,14858
"CAATTTCTCTCCATAT",0,7,2,0,0,9,46
"CACAACAAGGTTGAGC",2,4,0,0,4,10,220
"CACAACACAAATCCCA",5,28,5,3,6,47,670
"CACAACACAGAAGTGC",0,6,3,0,2,11,196
"CACAACAGTAACCAGG",0,0,0,0,0,0,16
"CACAACAGTCGGTAAG",10,5,0,0,0,15,410
"CACAACAGTGTGCCTG",3,33,6,3,7,52,700
"CACAACATCCGCAGTG",0,9,5,0,2,16,303
"CACACAAAGAGCCATG",1,5,0,0,0,6,339
"CACACAAAGAGGTCAC",4,31,12,2,14,63,2192
"CACACAAAGGATGGCT",3,26,10,0,7,46,1191
"CACACAAAGGTCCCGT",0,9,0,0,2,11,426
"CACACAAAGTCACGAG",0,2,0,0,0,2,22
"CACACAACAGCCTACG",6,68,12,0,9,95,5930
"CACACAAGTAGCGAGT",4,20,5,2,5,36,702
"CACACAAGTCACTGAT",0,2,0,0,0,2,303
"CACACAATCTCAAAGC",0,4,5,0,0,9,115
"CACACAATCTGAGGTT",1,3,2,0,0,6,132
"CACAGATAGCATACTC",0,2,2,0,0,4,224
"CACAGATAGGTCCAGA",1,6,3,0,2,12,400
"CACAGATCATCCTAAG",8,27,36,4,11,86,3781
"CACAGATGTCATCACA",0,6,0,0,0,6,171
"CACAGATGTGGCCCAT",0,7,2,0,0,9,470
"CACAGATGTTGCATGT",3,7,8,0,2,20,708
"CACAGGCAGCGTCTGC",1,6,0,0,5,12,343
"CACAGGCGTCCCGGTA",1,16,3,3,3,26,893
"CACAGGCGTCGAGCTC",1,0,0,0,0,1,19
"CACAGGCGTCGATTTG",4,24,37,6,7,78,1477
"CACAGGCGTTGCCGCA",0,5,0,0,2,7,158
"CACATGACACTTGGCG",2,18,6,0,5,31,924
"CACATGACAGAGGGTT",0,3,2,0,0,5,80
"CACATGACATCGTTCC",1,27,6,0,5,39,416
"CACATGAGTAACACGG",2,0,0,0,0,2,210
"CACATGAGTGATACCT",4,33,7,3,5,52,713
"CACCAAAAGCCTTCTC",1,11,9,2,4,27,794
"CACCAAACATCATCTT",0,4,0,0,0,4,40
"CACCAAACATCTGTTT",2,4,0,0,0,6,138
"CACCAAAGTAGGGAGG",0,5,2,0,0,7,144
"CACCAAAGTTGACTGT",5,18,4,0,5,32,545
"CACCAAATCCATTGTT",98,248,176,43,670,1235,58545
"CACCGTTAGACGAGCT",1,7,4,0,0,12,350
"CACCGTTCAACCGTAT",0,7,2,0,0,9,255
"CACCGTTCAAGTGGCA",623,247,165,45,120,1200,51938
"CACCGTTCAGGTAGTG",0,2,0,0,0,2,46
"CACCGTTGTTTCCAAG",0,29,8,4,2,43,818
"CACCGTTTCGAGCCTG",2,19,8,0,16,45,1458
"CACCGTTTCTTGGCTC",32,222,53,11,43,361,19979
"CACGAATAGACCATAA",1,19,3,0,0,23,186
"CACGAATAGACGCTCC",2,6,0,0,0,8,91
"CACGAATCAAAGGCAC",2,8,3,0,2,15,455
"CACGAATCAGCGACCT",0,11,0,0,0,11,86
"CACGAATTCAACGTGT",100,295,131,25,70,621,29593
"CACGAATTCCACACAA",0,21,8,2,4,35,1103
"CACGGGTAGCGTTAGG",0,14,8,3,3,28,235
"CACGGGTAGCTAAATG",3,10,3,0,3,19,700
"CACGGGTCAACACTAC",4,17,18,2,14,55,3088
"CACGGGTGTCTACATG",1,3,2,0,2,8,162
"CACGGGTGTGACTCGC",0,0,0,0,0,0,13
"CACGGGTGTGCTATTG",1,5,0,0,0,6,96
"CACGGGTTCCATCCGT",1,25,9,2,6,43,1443
"CACGTGGAGATCGCCC",6,23,12,0,29,70,2553
"CACGTGGGTGAGATCG",0,5,0,0,0,5,124
"CACGTGGGTGCTTCAA",2,17,4,2,0,25,483
"CACGTGGTCAGCTGAT",1,7,0,0,0,8,155
"CACGTGGTCCACGTCT",0,4,4,0,0,8,237
"CACGTGGTCCCGTTGT",1,4,0,0,0,5,139
"CACGTGGTCTCCATAT",1,3,2,0,0,6,69
"CACGTTCAGCTATCTG",162,360,1022,84,214,1842,91875
"CACGTTCAGTAGCATA",6,22,11,0,6,45,1502
"CACGTTCAGTCGTTAC",2,15,4,0,3,24,485
"CACGTTCAGTGGCGAT",1,20,0,0,0,21,123
"CACGTTCCAAAGGCTG",2,20,5,2,3,32,586
"CACGTTCCACCTCGTT",1,0,0,0,0,1,20
"CACGTTCCACTACAGT",43,250,88,72,52,505,19684
"CACGTTCCAGAGAGGG",1,15,6,0,0,22,371
"CACGTTCGTAGTTACC",2,12,8,4,4,30,821
"CACGTTCGTTTCGTAG",2,4,3,0,0,9,130
"CACGTTCTCAACTGGT",1,7,2,0,0,10,409
"CACGTTCTCGACGTCG",19,115,41,5,19,199,8333
"CACGTTCTCTGGACCG",1,9,0,0,3,13,22
"CACTAAGAGGCCATAG",0,0,2,0,0,2,3
"CACTAAGCACAAGCAG",0,13,2,0,2,17,489
"CACTAAGCACACACGC",1,15,3,2,0,21,967
"CACTGAACAAATCGGG",50,255,63,17,47,432,19652
"CACTGAACAACGGCTC",6,35,18,5,18,82,2086
"CACTGAACACACCGAC",0,3,0,0,0,3,320
"CACTGAAGTACTAGCT",5,43,11,3,5,67,2743
"CACTGAAGTCTACATG",0,6,5,2,0,13,274
"CACTGAATCCTACCGT",1,5,0,0,0,6,71
"CACTGAATCGTTGTTT",3,22,7,0,0,32,810
"CACTGAATCTAGGAAA",11,45,28,7,76,167,6607
"CACTGAATCTCATGGA",1,3,7,0,0,11,379
"CACTGGGAGCCAGAGT",189,1394,484,87,265,2419,103755
"CACTGGGGTGGACTGA",0,9,0,0,0,9,97
"CACTGGGTCATCCTGC",0,3,0,0,0,3,70
"CACTGGGTCCAAACCA",2,0,0,0,0,2,138
"CACTGGGTCCGATCTC",1,8,6,0,3,18,672
"CACTGGGTCGCTTTAT",0,3,0,0,0,3,158
"CACTGGGTCGTAACCA",0,4,0,0,0,4,94
"CACTGTCAGAAGCGCT",2,5,3,0,0,10,78
"CACTGTCAGCATCAGG",1,18,0,0,6,25,587
"CACTGTCAGCTGAGCA",1,4,0,0,0,5,104
"CACTGTCAGGAGAATG",27,237,54,17,40,375,21867
"CACTGTCCACTTCCTG",1,8,3,0,2,14,313
"CACTGTCCACTTGTGA",2,30,7,0,5,44,892
"CACTTCGAGCATCCCG",0,0,0,0,0,0,89
"CACTTCGAGCCTGTCG",0,19,2,0,0,21,1008
"CACTTCGAGTTAGAAC",1,8,2,0,0,11,108
"CACTTCGCATCGGAAG",0,3,5,0,0,8,156
"CACTTCGTCAGTCCGG",0,5,3,0,0,8,299
"CACTTCGTCGTGGACC",5,43,88,4,16,156,5110
"CAGAGCCAGCATCAAA",1,4,0,0,0,5,90
"CAGAGCCAGGTCACCC",6,27,7,0,6,46,780
"CAGAGCCCACAAATAG",45,351,133,22,77,628,33978
"CAGAGCCCACTACTTT",1,17,5,4,4,31,849
"CAGAGCCCATACTGTG",4,4,2,0,2,12,238
"CAGAGCCCATTGAGGG",3,18,7,2,2,32,669
"CAGAGCCGTACAGTCT",1,2,0,2,0,5,261
"CAGAGCCGTATTAAGG",1,4,0,0,0,5,71
"CAGAGCCGTCTGCGCA",3,20,6,0,3,32,411
"CAGAGCCGTCTGTGTA",0,3,3,0,0,6,73
"CAGAGCCGTGTTGAGG",0,8,2,0,0,10,244
"CAGAGCCTCGGACTTA",0,0,0,0,0,0,18
"CAGAGCCTCGGTCGGT",1,3,0,0,0,4,45
"CAGAGCCTCTCGTTTA",11,37,52,5,14,119,4805
"CAGAGCCTCTGTCTCG",0,0,0,0,0,0,48
"CAGATACAGACTACCT",2,4,0,0,0,6,97
"CAGATACAGAGCACTG",59,44,26,8,15,152,6700
"CAGATACAGCTAGCCC",7,40,15,3,76,141,5418
"CAGATACAGTCAGCGA",3,15,0,0,2,20,84
"CAGATACAGTGACCTT",4,9,3,2,2,20,322
"CAGATACAGTGATGGC",1,4,2,0,3,10,237
"CAGATACGTCATCCGG",0,5,2,0,0,7,477
"CAGATACGTTTCCAAG",0,2,0,0,0,2,14
"CAGATACTCTGCCTCA",6,23,16,0,8,53,1628
"CAGATCAAGGGACACT",1,4,0,0,0,5,88
"CAGATCACATGAGAAT",0,7,0,0,2,9,104
"CAGATCAGTCCAGGTC",18,51,121,6,18,214,9129
"CAGATCATCACGGTCG",1,15,5,2,0,23,851
"CAGATCATCCTTATGT",0,3,2,0,0,5,146
"CAGATCATCGCCGATG",0,0,0,0,0,0,39
"CAGATCATCTAGTGAC",1,5,2,0,0,8,153
"CAGATTGCAGAATCGG",0,5,2,0,0,7,150
"CAGATTGCAGCGGTCT",2,15,6,0,2,25,650
"CAGATTGCATCGAAGG",3,5,0,0,2,10,509
"CAGATTGGTGCCGTTG",1,6,0,0,0,7,181
"CAGATTGGTTTCAGAC",4,21,5,0,2,32,1275
"CAGATTGTCACCACAA",9,39,39,3,40,130,6024
"CAGATTGTCCCGAAAT",4,23,3,0,0,30,529
"CAGCAATAGAACAAGG",1,3,2,0,0,6,127
"CAGCAATAGAGAATCT",2,6,3,0,0,11,330
"CAGCAATAGTCGCCCA",0,3,2,2,2,9,72
"CAGCAATAGTGAGGTC",2,29,7,2,2,42,654
"CAGCAATGTATTCCTT",2,22,6,0,2,32,569
"CAGCAATTCAGCTAGT",0,8,4,0,0,12,91
"CAGCAATTCCTAGCCT",1,0,0,0,0,1,19
"CAGCAATTCCTCTAGC",1,0,0,0,0,1,30
"CAGCAATTCGATACGT",0,0,0,0,0,0,113
"CAGCAATTCTCCGAAA",1,15,4,0,5,25,271
"CAGCAATTCTTTCTAG",1,7,3,0,0,11,80
"CAGCACGAGGACAACC",0,5,4,0,3,12,106
"CAGCACGCAACCGGAA",2,4,0,0,2,8,179
"CAGCACGGTAGATCGG",303,845,249,54,172,1623,64469
"CAGCACGGTGCATCTA",0,7,4,0,3,14,135
"CAGCACGGTGTAGCAG",1,0,0,0,0,1,24
"CAGCAGCAGTCGCTAT",0,0,0,0,0,0,51
"CAGCAGCAGTTCCAGT",2,8,8,0,2,20,724
"CAGCAGCCAAGCACAG",0,5,0,0,0,5,59
"CAGCAGCCACCCTATC",88,414,331,41,288,1162,55252
"CAGCAGCCATCGCTCT",2,8,0,0,0,10,201
"CAGCAGCGTGTAGGAC",0,0,0,0,0,0,29
"CAGCAGCTCATGCCCT",0,4,0,0,0,4,128
"CAGCAGCTCCAATCCC",0,5,0,0,2,7,274
"CAGCCAGAGCAACAAT",5,46,15,4,8,78,3339
"CAGCCAGCAAGCGCAA",1,2,0,0,0,3,289
"CAGCCAGCAAGCGCTC",1,0,0,0,0,1,183
"CAGCCAGGTGCCTATA",0,6,0,0,0,6,103
"CAGCCAGGTGTCTTGA",0,0,3,2,0,5,311
"CAGCCAGGTTGTACGT",3,3,2,0,0,8,144
"CAGCCAGTCTGGACCG",0,5,0,0,0,5,299
"CAGCGTGCATAGAAAC",0,2,0,0,0,2,36
"CAGCGTGCATGAGATA",0,0,0,0,0,0,24
"CAGCGTGGTAGTCTTG",1,8,2,2,2,15,665
"CAGCGTGGTCGCGGTT",1,2,0,0,0,3,19
"CAGCGTGGTTCCTTGC",1,6,0,0,0,7,66
"CAGCGTGTCAGCGCAC",62,54,19,9,23,167,6219
"CAGCGTGTCCCGTTGT",1,6,0,0,0,7,163
"CAGCGTGTCGACGCGT",1,0,0,0,0,1,9
"CAGGCCAAGAGAGCAA",0,4,2,0,0,6,115
"CAGGCCAAGAGTGACC",6,21,5,0,0,32,252
"CAGGCCAAGCTGTTCA",6,38,33,4,9,90,2098
"CAGGCCAAGTCTAACC",134,180,59,18,44,435,21790
"CAGGCCACACCAGACC",43,226,77,21,251,618,27631
"CAGGCCATCAACGAGG",0,6,6,0,0,12,456
"CAGGCCATCATTGGTG",7,65,16,5,13,106,3841
"CAGGCCATCCGAGATT",70,360,274,33,97,834,41431
"CAGGCCATCGTGCAGC",0,0,0,0,0,0,26
"CAGGCCATCTATTGTC",0,0,0,0,0,0,59
"CAGGGCTAGCCTGACC",15,46,73,6,20,160,5984
"CAGGGCTAGGCAGGTT",9,41,53,4,14,121,3664
"CAGGGCTAGTGCTACT",0,2,0,0,0,2,6
"CAGGGCTCAACGTATC",0,18,3,0,2,23,661
"CAGGGCTCACATTCGA",0,4,0,0,0,4,116
"CAGGGCTCACTATCGA",0,0,0,0,0,0,25
"CAGGGCTCAGCGCTTG",95,602,146,29,112,984,51205
"CAGGGCTGTATGAGGC",0,5,0,0,0,5,138
"CAGGGCTGTTTAGTCG",0,9,2,0,3,14,451
"CAGGGCTTCCCGTTGT",0,8,3,2,5,18,387
"CAGGGCTTCCGATTAG",1,0,0,0,0,1,10
"CAGGTATAGAGATGCC",0,8,3,0,0,11,107
"CAGGTATAGCAGTAAT",2,17,4,0,0,23,352
"CAGGTATAGGCCACTC",4,24,7,0,4,39,717
"CAGGTATAGGCGACAT",2,22,4,0,7,35,549
"CAGGTATAGTAAACAC",1,10,2,0,0,13,216
"CAGGTATAGTAGTGCG",3,13,5,0,9,30,861
"CAGGTATAGTCGAGGT",1,0,0,0,0,1,50
"CAGGTATCACAGTCCG",0,2,0,0,2,4,411
"CAGGTATCAGATAAAC",0,4,0,0,2,6,95
"CAGTGCGAGATGGCGT",3,13,2,2,4,24,589
"CAGTGCGCAACAAGTA",0,4,0,2,0,6,95
"CAGTGCGCAGTACTAC",15,55,47,8,122,247,13780
"CAGTGCGCAGTGACCC",1,17,4,0,3,25,422
"CAGTGCGCATCGAACT",2,18,2,0,0,22,206
"CAGTGCGGTAACGCGA",2,9,2,0,0,13,526
"CAGTGCGGTACATACC",0,15,4,0,0,19,464
"CAGTGCGGTATCTTCT",3,17,11,0,3,34,805
"CAGTGCGTCTTAGCTT",14,57,73,6,75,225,7954
"CAGTTAGAGATTCGCT",4,25,11,0,7,47,848
"CAGTTAGAGCAACAAT",1,20,5,0,2,28,494
"CAGTTAGAGGGCAGGA",2,21,3,0,2,28,373
"CAGTTAGAGGTCATTC",0,4,0,0,2,6,103
"CAGTTAGGTTTCCATT",369,237,120,41,105,872,33661
"CAGTTAGTCAGCTGTA",1,4,4,0,0,9,437
"CAGTTAGTCCTACACC",70,44,23,4,16,157,6488
"CAGTTCCCACAAAGTA",32,90,172,15,128,437,19250
"CAGTTCCCAGAGTAAT",0,0,0,0,0,0,2
"CAGTTCCCATCGGAGA",1,6,3,0,2,12,121
"CAGTTCCGTCCATCTC",46,109,267,15,48,485,22772
"CAGTTCCTCCCGAATA",0,6,0,0,0,6,109
"CATAAGCAGGTCCCGT",0,4,0,0,0,4,183
"CATAAGCAGTAACGAT",1,8,0,0,0,9,105
"CATAAGCCAAGTGACG",0,3,0,0,0,3,281
"CATAAGCCAATCCAGT",0,2,0,0,0,2,298
"CATAAGCCATGGAATA",19,95,174,10,60,358,15856
"CATAAGCGTACTGCGC",0,0,0,0,0,0,3
"CATAAGCGTACTGTTG",0,9,3,0,0,12,169
"CATAAGCGTATGGGAC",3,26,4,0,2,35,443
"CATAAGCGTGACTGAG",29,57,15,2,18,121,4843
"CATAAGCTCACTTATC",2,13,8,0,3,26,152
"CATAAGCTCGAACACT",0,0,0,0,0,0,14
"CATACAGAGAGGTCAC",0,2,2,0,0,4,70
"CATACAGAGCCATGCC",4,9,4,0,3,20,604
"CATACAGAGTCTAGAA",0,14,0,3,0,17,129
"CATACAGCAGCGTGCT",27,63,153,9,26,278,16788
"CATACAGGTACTGACT",2,9,4,0,0,15,232
"CATACAGGTCGCTTAA",1,25,2,3,5,36,431
"CATACAGTCCCTGGTT",0,0,0,0,0,0,53
"CATACCCAGGAGAGTA",8,47,27,3,12,97,2188
"CATACCCAGTACGTCT",110,247,69,17,66,509,23017
"CATACCCGTACTCAAC",0,5,0,2,0,7,240
"CATACCCGTGACACGA",2,19,5,0,6,32,106
"CATACCCTCGGCCAAC",0,5,0,0,0,5,199
"CATACCCTCGGCTTCT",0,0,0,0,0,0,31
"CATACCCTCTTGATTC",3,7,2,0,0,12,37
"CATACTTCAACGGCTC",1,31,10,5,6,53,1077
"CATACTTGTAGCTGTT",2,23,0,0,0,25,574
"CATACTTTCAAAGACA",0,0,0,0,0,0,39
"CATACTTTCCTTGAAG",0,3,0,0,0,3,84
"CATACTTTCGGTGTTA",8,30,27,0,9,74,3225
"CATACTTTCTATTTCG",2,6,0,0,3,11,217
"CATAGACAGATAGCTA",16,54,49,9,52,180,7226
"CATAGACCAGTATACC",0,4,3,0,3,10,142
"CATAGACCATGGGATG",0,3,2,0,2,7,265
"CATAGACGTACCAGAG",0,6,2,0,3,11,117
"CATAGACGTTGTGCCG",0,8,4,0,3,15,394
"CATCAAGAGGAGTATT",2,26,5,0,6,39,921
"CATCAAGAGGGTTGCA",3,12,9,3,2,29,569
"CATCAAGCACGACTAT",0,2,0,0,2,4,83
"CATCAAGCAGCACAGA",1,2,0,0,0,3,22
"CATCAAGCATCCGATA",1,11,2,0,0,14,73
"CATCAAGGTTCTTCAT",0,14,2,0,0,16,34
"CATCCACAGCGCCTTG",0,4,0,0,0,4,112
"CATCCACAGGAGCAAA",1,2,3,0,0,6,447
"CATCCACCAACGTAAA",24,92,84,12,126,338,14240
"CATCCACCAAGACCGA",2,37,8,0,3,50,735
"CATCCACGTCGAATGG",28,156,43,6,21,254,11902
"CATCCACGTCTTGTCC",0,16,6,0,0,22,589
"CATCCACGTTAGCTAC",1,11,0,0,0,12,161
"CATCCACTCACGATAC",8,52,11,4,7,82,3134
"CATCCCAAGATGACAT",3,27,9,0,5,44,935
"CATCCCAAGTACAGCG",2,7,2,0,3,14,180
"CATCCCAAGTGTTCCA",1,11,2,0,2,16,162
"CATCCCACATCTAGAC",24,82,172,9,43,330,15965
"CATCCCAGTACCCAGC",8,38,62,5,14,127,5392
"CATCCCATCACCTTGC",19,117,34,6,18,194,6197
"CATCCCATCCCGGTAG",101,623,247,59,128,1158,47123
"CATCCCATCTCGCTTG",121,736,175,54,147,1233,51908
"CATCCGTAGATTGTGA",1,7,0,0,0,8,25
"CATCCGTAGCACTAAA",0,8,2,0,3,13,151
"CATCCGTAGCGTGTTT",2,9,8,0,0,19,582
"CATCCGTCACAGTGTT",1,6,2,0,0,9,225
"CATCCGTCACGCACCA",1,6,0,0,0,7,244
"CATCCGTCAGCTGTAT",0,4,0,0,0,4,47
"CATCCGTGTATTGACC",1,5,0,0,0,6,126
"CATCCGTGTGGGAGAG",0,3,0,0,0,3,59
"CATCCGTTCGCAACAT",0,0,0,0,0,0,19
"CATCCGTTCTTCGGTC",0,3,2,0,0,5,227
"CATCGCTAGATCCAAA",0,6,0,0,0,6,296
"CATCGCTAGGTGGCTA",0,2,0,0,0,2,78
"CATCGCTAGTAATACG",1,28,5,0,5,39,772
"CATCGCTTCCAGTACA",1,3,0,0,0,4,138
"CATCGGGAGAAGCGGG",0,4,0,0,0,4,199
"CATCGGGAGTGCTCAT",4,17,10,0,6,37,469
"CATCGGGGTTCAGGTT",0,5,0,0,0,5,68
"CATCGGGTCTACTGAG",0,6,0,0,0,6,143
"CATCGTCAGCTGGCTC",4,24,6,0,5,39,858
"CATCGTCAGGTTGGTG",1,3,0,0,0,4,93
"CATCGTCCAAATTGGA",3,20,8,0,4,35,534
"CATCGTCCACCTTCGT",1,21,6,3,2,33,476
"CATCGTCCAGAGGTAC",57,166,104,35,427,789,38549
"CATCGTCCAGTTGTTG",0,2,0,0,0,2,77
"CATGAGTAGAGTATAC",0,3,0,0,0,3,18
"CATGAGTCAACGGTAG",4,14,4,2,5,29,338
"CATGAGTTCCAAGCCG",0,2,0,0,0,2,61
"CATGAGTTCCCGTTCA",0,0,0,0,0,0,23
"CATGCAAAGCATTTCG",1,14,6,0,0,21,592
"CATGCAACAAGTGGCA",27,102,132,8,134,403,19168
"CATGCAACACATCCCT",3,18,9,0,2,32,680
"CATGCAACAGGCGATA",1,2,0,0,0,3,97
"CATGCAAGTGGTTCTA",0,7,0,0,0,7,65
"CATGCAAGTGTAGTGG",42,89,32,5,19,187,7291
"CATGCAAGTTTGGAGG",0,0,0,0,0,0,8
"CATGCAATCCACACCT",0,10,8,0,4,22,761
"CATGCCTAGCACTCAT",4,15,3,0,0,22,639
"CATGCCTAGCTACTGT",1,8,0,0,0,9,143
"CATGCCTAGGTTCATC",0,0,0,0,0,0,29
"CATGCCTAGTTCCAGT",0,17,4,0,0,21,857
"CATGCCTCACAATGCT",3,57,9,3,4,76,3380
"CATGCCTCAGGCACTC",1,2,0,0,0,3,232
"CATGCCTCATATTCGG",2,15,0,0,3,20,519
"CATGCCTTCATTTGCT",23,78,149,10,34,294,13502
"CATGCCTTCCTTGAAG",0,2,0,0,0,2,5
"CATGCCTTCTTGGGCG",21,72,136,13,32,274,16439
"CATGCGGAGGTGGGTT",0,15,0,0,3,18,440
"CATGCGGAGTTTCAGC",0,0,0,0,0,0,19
"CATGCGGCAGAAGCTG",51,129,319,21,72,592,32706
"CATGCGGCAGCTGGTC",1,4,0,0,0,5,126
"CATGCGGGTCTGTCAA",1,15,4,2,7,29,319
"CATGCGGGTGTCCGTG",1,19,5,0,4,29,601
"CATGCGGTCTCTGAGA",0,2,0,0,0,2,23
"CATGCTCAGATGCAGC",1,3,0,0,0,4,40
"CATGCTCAGTTTGCTG",3,12,5,0,0,20,427
"CATGCTCCACTACTTT",3,18,7,0,4,32,350
"CATGCTCCACTCCGAG",1,8,3,0,0,12,109
"CATGCTCCATGGGCAA",0,17,5,0,0,22,423
"CATGCTCGTAGGAAAG",0,3,0,0,0,3,87
"CATGCTCGTATACCTG",0,2,0,0,0,2,105
"CATGCTCGTCAAGCCC",14,30,8,0,6,58,2070
"CATGCTCGTTGAGAGC",1,7,2,0,2,12,463
"CATGCTCTCATTCGTT",0,2,3,0,0,5,129
"CATGCTCTCCATAGGT",0,2,3,0,0,5,281
"CATGCTCTCCCTTGGT",0,6,0,0,0,6,58
"CATGCTCTCCTAAACG",1,0,0,0,0,1,13
"CATGCTCTCGGTAACT",0,3,0,0,2,5,96
"CATGGATAGGACAGTC",0,2,0,0,0,2,23
"CATGGATAGGTGGGTT",0,3,0,0,0,3,159
"CATGGATCAATAGTAG",3,24,8,2,3,40,613
"CATGGATCAATGAGCG",5,14,6,2,6,33,795
"CATGGATCACAGCTGC",1,33,9,2,6,51,1267
"CATGGATCACGTGTGC",1,5,0,0,3,9,375
"CATGGATGTAGACAGC",4,38,10,2,7,61,1049
"CATGGATGTCGAAGCA",8,50,78,3,21,160,6693
"CATGGATTCTCAGAAC",4,24,8,2,5,43,935
"CATGGTAAGTGGAAGA",31,197,57,21,41,347,19030
"CATGGTAAGTTCCATG",0,0,0,0,0,0,14
"CATGGTAAGTTGCTGT",1,2,3,0,0,6,417
"CATGGTACAATACCTG",89,608,150,42,98,987,40693
"CATGGTAGTACCTATG",5,24,8,0,3,40,788
"CATGGTAGTCGAACGA",3,20,2,2,4,31,605
"CATGGTATCAATCCGA",0,8,2,0,0,10,244
"CATGGTATCCAGCCTT",2,5,3,0,4,14,186
"CATGGTATCCATATGG",0,6,4,0,0,10,149
"CATTCATAGACCAAGC",0,0,0,0,0,0,97
"CATTCATAGCTCGAAG",1,2,2,0,5,10,385
"CATTCATAGCTGACCC",0,2,0,0,0,2,32
"CATTCATCAAGGAGTC",0,11,8,0,6,25,555
"CATTCATCAGTATTCG",1,11,2,0,0,14,325
"CATTCATGTAGGAGGG",4,40,8,4,10,66,2787
"CATTCATGTAGTCGTT",3,32,5,0,9,49,549
"CATTCATTCAAGTCTG",0,8,0,0,0,8,143
"CATTCATTCATTTGGG",1,25,6,0,3,35,518
"CATTCATTCCATCACC",0,3,0,0,0,3,46
"CATTCATTCCGTATAG",0,13,2,0,0,15,667
"CATTCATTCTGGCTGG",1,6,4,0,0,11,285
"CATTCCGAGAGGGTCT",0,3,0,0,0,3,103
"CATTCCGAGCATCAAA",1,7,0,3,2,13,229
"CATTCCGAGTAGAGTT",1,15,2,0,4,22,249
"CATTCCGGTTATCTGG",45,148,160,19,204,576,25160
"CATTCCGTCAGCCTCT",38,104,47,102,26,317,13940
"CATTCTAAGTAACCTC",0,2,0,0,0,2,100
"CATTCTACAAGTTGGG",190,1192,353,107,269,2111,101470
"CATTCTACAATTCGTG",0,9,2,0,0,11,262
"CATTCTACACGAGAAC",5,40,34,4,13,96,2851
"CATTCTACATCCAACA",3,31,5,2,6,47,646
"CATTCTAGTGAGAACC",3,35,10,0,10,58,618
"CATTCTAGTGTGGACA",2,34,13,0,9,58,454
"CATTCTAGTGTTTCTT",85,561,170,47,116,979,46891
"CATTCTATCCCTCAAC",4,31,5,0,5,45,1009
"CATTCTATCCTTTAGT",1,5,0,0,4,10,136
"CATTCTATCTGAATCG",0,2,0,0,0,2,87
"CATTGAGAGGAAGTAG",2,21,4,3,7,37,452
"CATTGAGCAGGTTCGC",1,7,4,0,0,12,513
"CATTGAGCATCCTGTC",1,30,18,2,7,58,1700
"CATTGAGTCCATTGGA",6,18,7,3,6,40,1814
"CATTGCCAGTGCCTCG",0,4,2,0,0,6,253
"CATTGCCCACACCGAC",1,17,0,0,5,23,502
"CATTGCCCACGACAGA",2,25,4,0,3,34,54
"CATTGCCGTGAGTAAT",24,35,11,2,10,82,3048
"CATTGCCGTTTGATCG",0,2,0,0,0,2,57
"CATTGCCTCGGCCTTT",3,13,3,2,3,24,642
"CATTGTTAGCAAGTCG",0,29,8,0,4,41,546
"CATTGTTAGGTAAGTT",1,4,0,0,2,7,212
"CATTGTTAGGTTCAGG",0,20,8,4,3,35,55
"CATTGTTAGTCAATCC",0,4,6,0,2,12,255
"CATTGTTAGTGCTACT",0,2,0,0,0,2,3
"CATTGTTCAGCACAAG",1,5,0,0,0,6,147
"CATTGTTGTAGGAGGG",0,4,0,0,0,4,59
"CATTGTTGTGAGATAT",5,22,10,2,6,45,80
"CATTGTTGTTATAGAG",2,5,2,0,0,9,133
"CATTGTTTCACATCAG",0,0,0,0,0,0,21
"CATTGTTTCTGATTCT",4,13,4,0,0,21,340
"CATTTCAAGTTCGGTT",0,0,0,0,0,0,22
"CATTTCAAGTTGCCCG",0,6,2,0,0,8,196
"CATTTCACAAGATGTA",2,30,8,2,5,47,865
"CATTTCACATCCGAGC",0,12,3,0,4,19,254
"CATTTCATCCTTATCA",102,65,42,10,29,248,9984
"CATTTCATCGGACTTA",2,16,4,0,2,24,343
"CATTTCATCGGAGTGA",2,16,6,0,2,26,464
"CCAAGCGAGGCATTTC",0,0,0,0,0,0,9
"CCAAGCGCAACTACGT",0,7,0,0,0,7,269
"CCAAGCGTCCGGTAAT",5,29,13,4,7,58,882
"CCAATGAAGACGACGT",7,28,37,4,10,86,4517
"CCAATGAAGACTTCAC",0,0,0,0,0,0,20
"CCAATGATCCTCTGCA",1,9,4,0,0,14,457
"CCAATTTAGGAGGCAG",22,116,28,8,28,202,10737
"CCAATTTCAAATGAAC",0,10,2,0,0,12,85
"CCAATTTCAATTCACG",2,18,6,2,2,30,1056
"CCAATTTCACCTTCCA",3,20,10,3,5,41,674
"CCAATTTCATGAAGCG",0,2,0,0,2,4,123
"CCAATTTTCATTACCT",1,10,0,0,0,11,518
"CCAATTTTCCATCTAT",1,14,6,2,0,23,55
"CCAATTTTCCTACTGC",1,2,2,0,3,8,302
"CCACAAAAGAAGATCT",0,10,0,0,0,10,107
"CCACAAAGTCCTACGG",1,7,4,0,3,15,327
"CCACAAATCACCCTCA",1,9,2,0,2,14,506
"CCACAAATCAGCGCGT",0,2,2,0,0,4,72
"CCACAAATCGCATTGA",3,19,7,2,0,31,804
"CCACACTAGCAATAGT",0,4,0,0,0,4,9
"CCACACTAGCACTCAT",2,15,8,0,4,29,176
"CCACACTAGCATGGGT",1,0,0,0,0,1,14
"CCACACTCATCATTTC",14,55,92,7,15,183,8502
"CCACACTCATCTTTCA",1,14,6,0,3,24,503
"CCACACTGTGGCTTGC",18,13,9,0,4,44,1578
"CCACACTTCAACTGAC",0,2,0,0,4,6,228
"CCACACTTCTAGGCCG",1,21,4,0,4,30,127
"CCACACTTCTGACGCG",0,5,0,0,2,7,114
"CCACCATAGAGTCAAT",0,10,2,0,0,12,149
"CCACCATAGTCACTAC",1,19,8,0,2,30,843
"CCACCATAGTTATGGA",13,78,156,7,25,279,15165
"CCACCATCACTGGACC",1,24,2,0,5,32,285
"CCACCATCAGCATACT",0,0,0,0,0,0,27
"CCACCATCAGTCGCTG",3,20,8,3,3,37,1047
"CCACCATCATCTGGGC",43,100,162,24,124,453,23182
"CCACCATGTTACGGAG",2,4,0,0,0,6,147
"CCACCATGTTGGGCCT",1,3,0,0,0,4,97
"CCACCATGTTGTATGC",3,42,55,2,12,114,4106
"CCACCATTCGCCATAA",0,3,0,0,0,3,125
"CCACCATTCTTTGGAG",51,174,45,11,40,321,14068
"CCACGAGAGGTTACCT",83,284,83,19,60,529,22338
"CCACGAGAGTAAATGC",9,27,46,2,12,96,4671
"CCACGAGAGTTAGTAG",4,20,5,0,6,35,686
"CCACGAGCAGAACTAA",1,4,0,0,0,5,135
"CCACGAGGTCAAGTTC",0,3,3,0,0,6,154
"CCACGAGGTTGTTTGG",2,8,0,0,0,10,93
"CCACGAGTCGTGGCTG",150,520,132,26,75,903,31013
"CCACGAGTCTAGAACC",0,0,0,0,2,2,82
"CCACGAGTCTAGGCAT",0,7,2,0,0,9,88
"CCACGTTCAAATGAGT",2,10,2,0,2,16,458
"CCACGTTCAACCGTGC",0,8,4,0,0,12,198
"CCACGTTCAGTTTGGT",5,26,3,0,3,37,1060
"CCACGTTGTGTCTTCC",1,0,0,0,0,1,27
"CCACGTTTCGCGCTGA",0,2,0,0,0,2,4
"CCACGTTTCGTGGAAG",0,0,0,0,0,0,14
"CCACGTTTCTCTCCGA",306,1921,681,162,518,3588,147818
"CCACTTGAGAGCCCAA",3,4,0,0,0,7,111
"CCACTTGCAAGTACCT",2,6,0,0,0,8,164
"CCACTTGCATGTGCCG",103,812,214,47,135,1311,73679
"CCACTTGGTAACCCTA",78,566,130,29,92,895,45402
"CCACTTGGTGAATTAG",37,168,57,22,41,325,18767
"CCACTTGTCACTGAAC",29,38,21,4,10,102,1977
"CCACTTGTCGTTGCCT",1,10,0,0,3,14,234
"CCATAAGAGTCACTGT",1,2,3,0,3,9,332
"CCATAAGCACCTCTAC",2,7,3,0,0,12,137
"CCATAAGCACCTTCCA",1,3,0,0,0,4,63
"CCATAAGCATCATGAC",2,10,0,0,3,15,302
"CCATAAGCATCGTTCC",2,2,2,0,2,8,295
"CCATAAGTCCTGCTAC",1,15,7,3,7,33,670
"CCATAAGTCCTTATCA",0,5,2,0,2,9,228
"CCATAAGTCTCATGCC",3,19,3,0,0,25,1111
"CCATCACAGCCAAGCA",26,64,86,9,107,292,13490
"CCATCACAGGCTCTAT",22,63,93,8,94,280,13177
"CCATCACAGGGATCGT",3,27,9,5,3,47,907
"CCATCACCACGATTCA",0,2,0,0,0,2,297
"CCATCACGTGCGGTAA",332,216,113,35,81,777,32575
"CCATCACGTGGAAGTC",2,13,2,0,2,19,364
"CCATCACGTGGGACAT",0,3,0,0,0,3,53
"CCATCACGTGTCCATA",0,0,0,0,0,0,41
"CCATCACGTTGGACCC",7,42,12,4,61,126,4607
"CCATCACTCCACAAGT",1,8,3,0,3,15,197
"CCATCACTCTTAGGAC",176,575,422,87,1058,2318,115043
"CCATCACTCTTCGTAT",1,5,0,0,0,6,138
"CCCAACTAGAGGCGGA",1,16,3,0,3,23,502
"CCCAACTAGGCACCAA",2,3,0,0,0,5,44
"CCCAACTCAAGAATAC",0,6,4,0,0,10,233
"CCCAACTCACACCTTC",69,530,137,36,99,871,40947
"CCCAACTCAGTATTCG",1,6,3,0,0,10,117
"CCCAACTTCAGGAAAT",2,34,5,0,5,46,405
"CCCAACTTCCATAAGC",0,2,0,0,0,2,5
"CCCAACTTCCATTTGT",1,5,0,0,0,6,245
"CCCAACTTCTCCGCAT",4,17,3,0,0,24,917
"CCCAACTTCTGTAAGC",5,104,28,10,20,167,7030
"CCCATTGCAACGCATT",12,44,82,7,18,163,6993
"CCCATTGCACAATCTG",3,22,5,0,3,33,877
"CCCATTGCACACCTTC",20,100,49,9,24,202,7925
"CCCATTGCACGTCATA",36,85,119,15,100,355,18846
"CCCATTGGTAATGTGA",1,19,5,0,3,28,157
"CCCATTGGTAGTTACC",317,144,87,30,63,641,26754
"CCCATTGGTGATAGAT",1,5,6,0,0,12,104
"CCCATTGGTTAATGAG",0,3,2,0,0,5,81
"CCCATTGGTTGATGTC",0,8,2,0,4,14,196
"CCCATTGTCATTGTGG",0,3,0,0,0,3,66
"CCCATTGTCCACACCT",1,22,4,0,4,31,882
"CCCATTGTCGGCCTTT",0,8,0,0,0,8,117
"CCCATTGTCGGTATGT",1,2,0,0,4,7,507
"CCCGAAGAGAAGTGTT",29,185,55,14,40,323,11484
"CCCGAAGAGATCGCCC",166,1146,316,97,222,1947,79165
"CCCGAAGCAAAGCTAA",0,14,6,0,3,23,512
"CCCGAAGCACAGTCCG",0,21,10,0,0,31,657
"CCCGAAGCATAGGCGA",257,1802,492,124,331,3006,163457
"CCCGAAGCATTGTGCA",0,4,0,0,0,4,204
"CCCGAAGGTACTTCCC",13,129,26,5,24,197,10285
"CCCGAAGGTACTTGTG",0,5,0,0,0,5,155
"CCCGAAGGTATGGTTC",1,5,2,0,0,8,472
"CCCGAAGGTCACGTGC",0,3,3,0,2,8,89
"CCCGAAGGTCACTCGG",0,0,0,0,3,3,91
"CCCGAAGGTCTACATG",5,19,5,2,7,38,1081
"CCCGAAGGTGGAAATT",1,2,2,0,0,5,92
"CCCGAAGGTTCTTGCC",0,8,0,0,0,8,118
"CCCGAAGGTTTCGGCG",0,7,2,0,0,9,163
"CCCGAAGTCCATTCGC",1,4,0,0,0,5,162
"CCCGGAAAGGAGATAG",0,7,5,0,0,12,298
"CCCGGAAAGGTCATAA",0,6,3,0,0,9,128
"CCCGGAAAGGTTAGTA",34,98,128,22,127,409,20682
"CCCGGAAAGGTTGTTC",0,0,0,0,0,0,39
"CCCGGAAAGTTGCGAG",0,4,5,0,0,9,212
"CCCGGAACACCTCTAC",1,20,6,0,3,30,775
"CCCGGAACAGAAACCG",6,18,12,0,8,44,1558
"CCCGGAACAGACGCTC",8,31,11,5,51,106,4926
"CCCGGAACATGGGTTT",27,93,200,19,79,418,23037
"CCCGGAACATGTAACC",0,3,0,0,0,3,185
"CCCGGAAGTAACTGCT",26,130,44,65,36,301,15854
"CCCGGAAGTGGCGTAA",0,0,0,0,0,0,29
"CCCGGAAGTGTTCCTC",16,53,84,6,24,183,6749
"CCCGGAATCATACGAC",155,1114,262,76,231,1838,93452
"CCCGGAATCCACACAA",1,9,6,0,3,19,352
"CCCGGAATCTGCATGA",11,42,22,7,52,134,3737
"CCCTAACAGCTAAACA",0,7,3,0,0,10,87
"CCCTAACAGTTTCTTC",0,12,2,0,0,14,236
"CCCTAACCACTTCTCG",0,3,0,0,0,3,108
"CCCTAACCATAGCTGT",2,9,2,0,2,15,414
"CCCTAACGTACGAGTG",0,0,0,0,0,0,70
"CCCTAACGTATCGGTT",0,4,0,0,0,4,103
"CCCTAACTCACTCCGT",0,30,11,4,6,51,99
"CCCTAACTCACTTGTT",21,61,128,10,26,246,12327
"CCCTAACTCGCGGTAC",0,0,0,0,0,0,83
"CCCTAACTCTTCGCTG",0,12,2,0,0,14,21
"CCCTCAAAGAGGCGGA",1,13,4,0,4,22,567
"CCCTCAAAGGTGGCTA",0,0,0,0,0,0,64
"CCCTCAAAGTGACCTT",0,5,10,0,3,18,624
"CCCTCAAAGTTCGCAT",1,4,0,0,0,5,79
"CCCTCAACACATTGTG",0,3,0,0,0,3,68
"CCCTCAACACTCCGGA",0,12,4,0,0,16,447
"CCCTCAAGTCACGCTG",0,4,0,0,0,4,222
"CCCTCAAGTTATAGAG",7,43,17,3,3,73,2436
"CCCTCAATCACCTTGC",1,2,0,0,0,3,88
"CCCTCAATCCGATGCG",1,0,0,0,0,1,12
"CCCTCTCAGAGTCCGA",6,29,7,0,4,46,945
"CCCTCTCCAAGCCTGC",0,0,0,0,0,0,135
"CCCTCTCCAAGCGGAT",88,689,212,38,129,1156,50852
"CCCTCTCCACTTCCTG",3,5,16,0,3,27,1440
"CCCTCTCCAGAACATA",14,45,17,5,70,151,6779
"CCCTCTCCAGCAGGAT",0,5,3,0,0,8,262
"CCCTCTCCAGGTCCGT",0,0,0,0,0,0,8
"CCCTCTCGTATGAAAC",26,38,34,6,15,119,4920
"CCCTCTCGTGGCCCAT",1,3,0,0,0,4,37
"CCCTCTCTCCATTTCA",0,2,0,0,0,2,13
"CCCTGATAGACTACGG",0,2,2,0,0,4,140
"CCCTGATAGCTTAGTC",1,10,6,0,2,19,312
"CCCTGATCATATGAAG",0,6,4,0,0,10,213
"CCCTGATGTCGCATTA",31,215,52,10,29,337,17779
"CCCTGATGTCGGAAAC",0,11,4,2,3,20,516
"CCCTGATGTGTCCCTT",4,30,3,0,3,40,249
"CCCTGATGTTCGGACC",2,22,7,0,9,40,1043
"CCCTGATTCATCACCC",1,7,0,0,0,8,512
"CCCTGATTCCTAAACG",5,14,16,0,5,40,1279
"CCCTTAGAGAGTGACC",0,0,0,0,0,0,69
"CCCTTAGCAGGCGATA",2,13,2,0,2,19,773
"CCCTTAGCATAACCCA",8,4,0,0,0,12,452
"CCCTTAGGTCTGTAGT",1,3,3,0,0,7,98
"CCCTTAGTCAAGTGTC",1,5,3,2,3,14,280
"CCGAACGAGCGGCTCT",19,95,205,7,31,357,17289
"CCGAACGAGGCAGTCA",39,268,92,21,59,479,22771
"CCGAACGAGGTCATAA",0,0,0,0,0,0,15
"CCGAACGAGTGAGGCT",3,21,2,0,0,26,672
"CCGAACGCACCGTCGA",0,3,0,0,0,3,12
"CCGAACGCACTAGGTT",29,170,49,13,43,304,10807
"CCGAACGCACTGTCCT",2,26,6,0,4,38,130
"CCGAACGGTGAATAAC",0,3,0,0,0,3,83
"CCGAACGGTTAGTCGT",2,0,2,0,0,4,190
"CCGATCTAGAAATTCG",2,4,0,0,0,6,106
"CCGATCTAGTATAGGT",5,23,5,4,0,37,712
"CCGATCTGTAGCACAG",1,9,0,0,0,10,288
"CCGATCTGTGCTGTCG",1,0,0,0,0,1,3
"CCGATCTGTTTGTTCT",0,6,0,0,2,8,261
"CCGATCTTCAAAGGTA",1,10,2,0,0,13,147
"CCGATCTTCACCGGGT",86,406,153,34,83,762,37232
"CCGATGGAGGACAACC",1,4,0,0,0,5,184
"CCGATGGAGGCCTTGC",0,2,0,0,0,2,5
"CCGATGGCACACTGGC",1,3,0,0,0,4,228
"CCGATGGCAGAATGTA",0,10,4,0,0,14,93
"CCGATGGGTCCACACG",4,10,5,0,2,21,52
"CCGATGGTCCAACCGG",0,8,4,0,0,12,413
"CCGCAAGAGAGAATCT",1,3,2,0,0,6,180
"CCGCAAGAGCTAGATA",2,13,7,2,13,37,1580
"CCGCAAGAGGGCATGT",0,12,4,0,0,16,64
"CCGCAAGCAATAGTCC",5,8,5,0,2,20,492
"CCGCAAGCATCCCGTT",3,24,6,2,3,38,1424
"CCGCAAGGTAGGCTCC",1,21,5,0,0,27,636
"CCGCAAGGTCGAATTC",1,2,0,0,0,3,57
"CCGCAAGGTGGCTGCT",0,0,0,0,0,0,2
"CCGCAAGTCGAAGAAT",4,13,3,0,2,22,478
"CCGCAAGTCGCTTAAG",1,18,5,0,2,26,470
"CCGGACAAGACTGAGC",47,156,96,25,406,730,35646
"CCGGACACAGAGTTCT",21,166,41,7,25,260,11421
"CCGGACACAGCAATTC",136,327,856,75,169,1563,85387
"CCGGACAGTCCATCTC",103,686,169,54,121,1133,53324
"CCGGACAGTGTGCTTA",0,7,0,0,0,7,139
"CCGGACAGTTGCGTAT",2,12,7,3,4,28,843
"CCGGGTAAGGAATTAC",0,7,4,0,0,11,116
"CCGGGTACAATCCAGT",93,68,36,11,21,229,7874
"CCGGGTACAGCACACC",3,28,4,0,6,41,558
"CCGGGTACATCCGATA",20,124,43,10,36,233,10829
"CCGGGTATCTTCCAGC",0,3,2,0,0,5,33
"CCGGTAGGTACAGGTG",0,0,0,0,0,0,79
"CCGGTAGGTTGAGGAC",0,4,3,0,5,12,234
"CCGGTAGTCAACCCGG",0,5,2,0,0,7,142
"CCGGTGAAGCTCTGTA",1,23,8,0,3,35,920
"CCGGTGACAGAGGGTT",179,182,81,21,58,521,25521
"CCGGTGACATACATCG",0,3,3,0,0,6,114
"CCGGTGAGTATGCGGA",13,57,29,7,94,200,8853
"CCGGTGAGTTCCTAAG",3,4,0,0,0,7,100
"CCGGTGATCATACGAC",1,3,2,0,4,10,227
"CCGTAGGAGCACTCGC",1,7,0,0,0,8,91
"CCGTAGGAGGACGGAG",0,4,0,0,0,4,429
"CCGTAGGAGGCATTTC",0,8,0,0,0,8,199
"CCGTAGGCACACTGGC",2,16,3,0,2,23,568
"CCGTAGGCACGGGTAA",0,0,0,0,0,0,26
"CCGTAGGCAGGTCAAG",1,14,6,0,2,23,172
"CCGTAGGGTGGGACAT",35,90,197,14,41,377,17544
"CCGTAGGGTGGTCCGT",2,0,0,0,0,2,356
"CCGTAGGTCATGGATC",73,49,21,9,9,161,6423
"CCGTAGGTCCTAACAG",4,26,12,0,8,50,910
"CCGTGAGAGTTGCCCG",1,2,0,0,0,3,187
"CCGTGAGCAACCCTCT",0,2,3,0,2,7,54
"CCGTGAGCACTCATAG",0,0,0,0,0,0,37
"CCGTGAGCAGCAGAAC",1,0,0,0,0,1,85
"CCGTGAGCATAGATCC",0,2,0,0,0,2,86
"CCGTGAGCATCCAACA",9,37,64,6,10,126,6380
"CCGTGAGGTTAACCTG",0,3,0,0,0,3,146
"CCGTGAGGTTACGATC",0,3,0,0,0,3,7
"CCGTGAGGTTCTTGTT",0,2,0,0,0,2,23
"CCGTGAGGTTTGATCG",29,21,8,0,4,62,1803
"CCGTTCAAGGGCTTCC",1,3,3,0,2,9,88
"CCGTTCAGTGCATGTT",0,0,3,0,0,3,65
"CCGTTCATCACGGGCT",9,59,29,4,11,112,5883
"CCTAACCAGGTAGCAC",3,21,2,0,3,29,1067
"CCTAACCAGGTTCCGC",1,8,5,0,0,14,813
"CCTAACCAGTTCGCAT",4,27,8,0,5,44,911
"CCTAACCGTCGGCTAC",1,5,0,0,0,6,122
"CCTAAGAAGTCGTCTA",0,11,0,0,2,13,133
"CCTAAGACAAAGTGTA",0,7,0,0,0,7,81
"CCTAAGACACATCATG",3,41,7,3,3,57,1076
"CCTAAGACAGACACAG",2,39,10,2,3,56,1088
"CCTAAGACAGCAATTC",0,10,2,0,0,12,268
"CCTAAGACAGCAGTCC",13,62,104,6,17,202,8454
"CCTAAGAGTAACTTCG",3,18,6,0,4,31,218
"CCTAAGAGTAGCGATG",67,160,403,28,90,748,42733
"CCTAAGAGTCAACACT",1,18,6,0,2,27,595
"CCTAAGATCCAGTGCG",1,0,4,0,0,5,128
"CCTAAGATCGCATAGT",1,9,4,0,2,16,428
"CCTACGTAGACATCCT",21,59,63,6,86,235,9347
"CCTACGTAGATCGCCC",1,19,9,0,0,29,215
"CCTACGTCACATTCTT",0,4,0,0,0,4,291
"CCTACGTCACGAGAAC",2,0,4,0,0,6,105
"CCTACGTCAGTCAGAG",3,30,8,0,6,47,1255
"CCTACGTCATAGAATG",5,30,5,0,7,47,614
"CCTACGTGTCCACTCT",130,317,209,61,882,1599,81000
"CCTACGTTCCGTGGTG",0,9,0,0,0,9,265
"CCTATCGAGAGGTCGT",8,43,19,3,68,141,3190
"CCTATCGAGCACTGGA",0,5,2,0,0,7,171
"CCTATCGAGTGGTTCT",0,0,0,0,0,0,6
"CCTATCGAGTTGGCGA",1,5,0,0,3,9,175
"CCTATCGCATATGCGT",0,10,2,3,3,18,388
"CCTATCGGTATTTCCT",0,2,2,0,0,4,62
"CCTATCGGTCGCTGCA",0,5,0,0,2,7,274
"CCTATCGGTGAGACGT",52,146,273,35,192,698,34655
"CCTATCGGTTATGTGC",15,121,29,8,23,196,8803
"CCTATCGTCCGCGAGT",0,6,0,0,0,6,174
"CCTATCGTCGCCTATC",2,8,4,0,2,16,527
"CCTATCGTCGGTTCAA",20,97,254,9,142,522,13614
"CCTCAACAGATCCCAT",0,0,0,0,0,0,30
"CCTCAACAGCATACTC",1,12,3,0,0,16,199
"CCTCAACAGGCGATAC",0,3,0,0,0,3,165
"CCTCAACCAACTGTGT",124,684,209,43,140,1200,58948
"CCTCAACCAATTTCCT",56,47,25,4,13,145,6097
"CCTCAACCACTCTGCT",5,35,18,2,34,94,3625
"CCTCACAAGCACTAAA",1,8,2,2,3,16,152
"CCTCACAAGTTCCAGT",10,46,54,3,11,124,4851
"CCTCACACAACGACTT",1,20,6,0,4,31,840
"CCTCACACAGAACTTC",1,18,6,0,4,29,115
"CCTCACAGTAGCTGTT",0,0,0,0,0,0,130
"CCTCACAGTCTTGCGG",18,51,102,6,22,199,8841
"CCTCACAGTTGTGCAT",25,76,50,12,156,319,17104
"CCTCACATCAGACAAA",0,4,0,0,0,4,42
"CCTCACATCATAGGCT",24,188,52,14,30,308,13801
"CCTCACATCCCATGGG",0,0,0,2,0,2,25
"CCTCACATCGCACGGT",73,198,580,34,99,984,51236
"CCTCACATCTTCTAAC",5,31,8,2,6,52,1313
"CCTCAGTAGGGAGGCA",113,610,245,52,203,1223,69113
"CCTCAGTCAACGTTAC",6,37,26,0,30,99,4016
"CCTCAGTTCACCTTGC",4,22,3,0,2,31,1120
"CCTCAGTTCAGAACCT",0,7,2,0,0,9,251
"CCTCAGTTCGTGCATA",4,27,7,0,5,43,1246
"CCTCATGAGACGGAAA",3,20,3,0,2,28,468
"CCTCATGAGCGACATG",0,7,4,0,3,14,182
"CCTCATGCATGCAGGA",7,21,3,0,7,38,498
"CCTCATGCATTCTCCG",0,0,0,0,0,0,160
"CCTCCAAAGAATCTAG",1,11,0,0,0,12,257
"CCTCCAAAGCGTTGTT",1,6,5,0,0,12,292
"CCTCCAACACTAGTAC",1,4,4,0,0,9,245
"CCTCCAAGTGATAGTA",1,4,0,0,0,5,141
"CCTCCAAGTGGAATGC",1,17,6,0,2,26,539
"CCTCCAAGTTGTGCCG",96,171,50,15,33,365,15648
"CCTCCAATCAGACCGC",0,0,0,0,0,0,12
"CCTCCTCAGAGCTGAC",0,8,0,0,0,8,326
"CCTCCTCGTTCTCGTC",3,19,4,2,2,30,906
"CCTCCTCTCAGTCACA",0,8,2,0,0,10,150
"CCTCCTCTCATGTCTT",6,29,2,2,2,41,952
"CCTCCTCTCCTAGCTC",2,22,8,2,5,39,1377
"CCTCCTCTCGTAGTCA",6,13,8,3,3,33,1221
"CCTCTAGAGGCCGCTT",1,2,0,0,0,3,108
"CCTCTAGAGTAATTGG",93,536,130,37,113,909,49688
"CCTCTAGAGTGCAAAT",16,98,37,6,19,176,7041
"CCTCTAGCAGCATACT",48,45,18,9,17,137,5028
"CCTCTAGCAGCCCACA",4,11,4,0,0,19,55
"CCTCTAGCAGGACTAG",1,2,0,0,0,3,94
"CCTCTAGCAGTCCCGA",1,7,2,0,0,10,158
"CCTCTAGGTCAGGTAG",0,6,0,0,0,6,114
"CCTCTAGGTTCGGCTG",3,23,7,0,8,41,1195
"CCTCTAGTCCTCTCTT",1,13,0,2,5,21,424
"CCTCTAGTCGTGGACC",0,0,0,0,0,0,8
"CCTCTCCAGCTGGCCT",4,17,3,0,0,24,970
"CCTCTCCAGTCAGCGA",4,28,6,0,2,40,2149
"CCTCTCCCAGCCTTCT",27,134,41,11,29,242,10673
"CCTCTCCCATAGAGGC",1,3,0,0,0,4,318
"CCTCTCCTCCTTCGAC",0,2,2,0,0,4,78
"CCTCTCCTCGGCTCTT",3,19,3,0,2,27,973
"CCTCTCCTCGTCTACC",2,43,8,3,2,58,1842
"CCTCTCCTCTGACAGT",3,34,8,0,5,50,928
"CCTGCATAGAGGTTTA",0,0,0,0,0,0,12
"CCTGCATAGCGTCAAG",0,2,0,0,0,2,13
"CCTGCATAGGATAATC",0,5,0,0,3,8,251
"CCTGCATAGTTGCTGT",1,11,3,0,0,15,596
"CCTGCATCAGCAATTC",0,13,3,0,0,16,277
"CCTGCATCAGTCTACA",0,3,2,0,0,5,100
"CCTGCATGTACGATCT",3,18,0,0,3,24,149
"CCTGCATGTTGCCTAA",21,79,162,5,34,301,13871
"CCTGCATTCCATTCAT",2,4,2,0,3,11,108
"CCTGCATTCCTATTTG",9,73,24,5,10,121,5980
"CCTGCATTCGTCAACA",0,0,2,0,0,2,52
"CCTGCATTCTGAGCAT",0,2,0,0,0,2,48
"CCTGTTGAGACATAGT",2,11,2,0,2,17,489
"CCTGTTGAGGCTCTCG",1,13,0,0,2,16,448
"CCTGTTGAGTCGAAGC",0,2,0,0,0,2,45
"CCTGTTGTCAGCCTTC",5,20,7,0,9,41,827
"CCTTCAGAGCGAGGAG",2,9,2,2,3,18,365
"CCTTCAGAGTGCAGGT",6,41,10,5,10,72,2994
"CCTTCAGCAAAGGCAC",0,3,0,0,0,3,101
"CCTTCAGCAAGGATGC",0,0,0,0,0,0,7
"CCTTCAGCATATCGGT",2,5,2,0,0,9,106
"CCTTCAGCATGGAATA",0,2,0,0,0,2,130
"CCTTCAGGTGGGACAT",6,23,6,0,5,40,469
"CCTTCAGTCAAGCGTT",317,162,99,23,91,692,29261
"CCTTCAGTCAGATTGC",5,16,10,2,13,46,488
"CCTTCAGTCCTACTGC",0,0,0,0,0,0,15
"CCTTCAGTCGTTATCT",2,6,3,0,0,11,261
"CCTTGTGAGTCAATCC",1,6,4,0,0,11,254
"CCTTGTGAGTTCTACG",4,18,13,0,12,47,1139
"CCTTGTGCAACTGCCG",5,30,8,0,14,57,1613
"CCTTGTGCAGCTTCGG",0,11,6,0,2,19,216
"CCTTGTGGTGAACTAA",2,23,3,0,0,28,432
"CCTTGTGTCAAAGAAC",3,15,4,0,0,22,554
"CCTTGTGTCCATAGGT",0,7,2,0,0,9,128
"CCTTGTGTCTCGCTTG",63,157,98,52,210,580,27676
"CCTTTGGCAACGAGGT",0,3,2,0,0,5,276
"CCTTTGGCAATCAGCT",232,791,623,115,837,2598,124348
"CCTTTGGGTCGTGATT",2,9,0,0,0,11,113
"CCTTTGGGTTAGGCCC",1,3,0,0,2,6,76
"CCTTTGGTCATTTCGT",1,31,6,0,4,42,704
"CCTTTGGTCCCGGTAG",8,22,8,3,5,46,1445
"CCTTTGGTCGCCTTGT",0,7,0,0,2,9,132
"CCTTTGGTCGTAGAGG",0,6,0,0,0,6,370
"CCTTTGGTCTCCGCAT",112,710,194,59,157,1232,64157
"CCTTTGGTCTGGCCTT",3,32,8,0,7,50,1384
"CGAAGGACAACAGCCC",0,4,2,0,0,6,223
"CGAAGGACAAGAGTGC",13,38,85,3,21,160,7137
"CGAAGGACACACGGTC",5,38,9,5,9,66,1050
"CGAAGGAGTGTTGACT",0,5,2,0,0,7,157
"CGAAGGAGTTAAACAG",0,6,0,0,0,6,148
"CGAAGGAGTTTAGTCG",1,3,0,0,0,4,167
"CGAAGGATCCTAGCCT",7,38,13,0,34,92,3642
"CGAAGGATCGCAATGT",1,18,7,0,6,32,496
"CGAAGGATCGTAGTGT",0,0,0,0,0,0,18
"CGAAGTTAGGAACGAA",0,4,0,0,0,4,142
"CGAAGTTAGGTACATA",0,3,0,0,0,3,85
"CGAAGTTAGTCGAATA",0,22,6,0,3,31,437
"CGAAGTTCACGGCACT",1,0,0,0,0,1,77
"CGAAGTTGTAGGACTG",2,4,0,0,0,6,32
"CGAAGTTGTGACAGCA",3,13,3,0,6,25,177
"CGAAGTTGTTGCTCCT",0,0,0,0,0,0,10
"CGAAGTTTCACTGAAC",2,20,7,0,5,34,2035
"CGAAGTTTCAGGACGA",44,119,81,20,322,586,26987
"CGAAGTTTCATGGGAG",148,1074,247,73,218,1760,97601
"CGAATTGAGCAATTAG",0,0,0,0,0,0,55
"CGAATTGAGGTACCTT",0,0,0,0,0,0,212
"CGAATTGAGGTTCACT",2,5,6,0,3,16,1093
"CGAATTGCAATGAACA",2,29,8,3,4,46,280
"CGAATTGCAATTCTTC",0,0,0,0,0,0,300
"CGAATTGCACAACGTT",0,0,0,0,0,0,25
"CGAATTGCAGGTTCAT",1,18,4,0,2,25,653
"CGAATTGGTGAAAGTT",4,32,13,2,20,71,2241
"CGACAGCAGTGCCCGT",1,25,6,2,7,41,1807
"CGACAGCGTACTAGCT",0,7,0,0,0,7,158
"CGACAGCGTATTGCCA",0,0,3,0,2,5,48
"CGACAGCTCTTTGATC",0,19,6,0,0,25,540
"CGAGAAGAGAGAATCT",9,32,16,7,61,125,4245
"CGAGAAGAGCCTGTGC",3,30,6,0,2,41,427
"CGAGAAGCATCTGCGG",0,6,2,0,3,11,56
"CGAGAAGCATTCACCC",3,20,7,0,5,35,139
"CGAGAAGGTACGTGAG",1,3,0,0,0,4,190
"CGAGAAGGTCTGTGCG",78,579,143,37,95,932,48075
"CGAGAAGGTGAAGCGT",3,20,25,0,9,57,2756
"CGAGAAGTCACATACG",0,4,0,0,0,4,31
"CGAGAAGTCTGTGCGG",0,0,0,0,0,0,6
"CGAGGAAAGGAAAGTG",0,3,0,0,0,3,28
"CGAGGAACACTGTGTA",4,20,10,0,9,43,841
"CGAGGAAGTACTGTTG",0,4,2,0,0,6,11
"CGAGGAATCTAGGCCG",95,639,154,41,123,1052,55072
"CGAGGCTAGAAAGTCT",56,78,32,7,23,196,8548
"CGAGGCTAGCGATGAC",3,5,0,0,4,12,48
"CGAGGCTAGTAGAATC",1,4,3,0,3,11,239
"CGAGGCTCAAGTTTGC",1,9,3,0,0,13,171
"CGAGGCTCAGAGCGTA",5,31,31,4,7,78,2282
"CGAGGCTCAGGTTCAT",0,6,3,0,0,9,257
"CGAGGCTCAGTAACCT",1,5,0,0,2,8,102
"CGAGGCTGTAGGACTG",0,0,0,0,0,0,16
"CGAGGCTGTGGACTAG",0,5,0,0,0,5,155
"CGAGGCTGTGTGGACA",17,93,27,4,23,164,7467
"CGAGGCTGTTGCCAAT",0,8,2,3,2,15,183
"CGAGGCTTCCAAGCAT",0,2,0,0,0,2,57
"CGAGTGCCAAACTCGT",0,3,0,0,0,3,125
"CGAGTGCCAGGTATGG",0,8,0,0,3,11,232
"CGAGTGCCATAGACTC",2,22,3,0,0,27,717
"CGAGTGCCATCTTCGC",1,6,0,0,2,9,372
"CGAGTGCGTAATCAGA",2,2,0,0,0,4,92
"CGAGTGCGTCGACTTA",0,0,0,0,0,0,5
"CGAGTGCGTGAGACGT",2,13,4,0,4,23,44
"CGAGTTAAGTGTTGAA",116,899,231,64,166,1476,73741
"CGAGTTACACACGTGC",0,4,0,2,0,6,106
"CGAGTTACAGCTGGTC",6,39,29,4,13,91,3162
"CGAGTTAGTTGGTAGG",0,4,0,0,0,4,58
"CGAGTTAGTTTCCAAG",0,5,2,0,0,7,133
"CGATCGGAGCTATCTG",1,2,3,0,0,6,75
"CGATCGGAGTTTGAGA",0,27,17,0,4,48,2154
"CGATCGGCAGGTGACA",74,123,46,8,32,283,10649
"CGATCGGTCCGTGTAA",0,0,0,0,0,0,213
"CGATCGGTCCTTCTTC",1,6,2,0,3,12,274
"CGATGCGAGATTAGCA",1,6,3,0,2,12,205
"CGATGCGAGCGTTCCG",3,27,6,0,5,41,691
"CGATGCGAGGTTCATC",8,32,19,5,7,71,1857
"CGATGCGCAGGCTACC",29,129,40,16,23,237,9075
"CGATGCGCAGTCAGAG",23,89,163,14,42,331,15358
"CGATGCGGTGCCTATA",1,7,0,0,4,12,161
"CGATGCGTCCATCAGA",1,14,3,3,0,21,725
"CGATGGCCACTGTGAT",2,5,2,0,0,9,258
"CGATGGCCAGGTGTTT",2,5,3,0,0,10,596
"CGATGGCCAGTTGTTG",2,25,5,0,3,35,882
"CGATGGCGTACCCACG",4,9,2,0,0,15,344
"CGATGGCGTACTCGAT",5,23,7,2,7,44,607
"CGATGGCTCACAATGC",97,523,126,38,88,872,38268
"CGATGGCTCGGACTTA",1,22,6,2,4,35,87
"CGATGGCTCTCTGGTC",2,4,0,0,2,8,318
"CGATGGCTCTTACTGT",1,14,4,0,3,22,738
"CGCAGGTAGGTTGCCC",51,33,20,6,20,130,4003
"CGCAGGTAGTCTGCAT",0,0,0,0,0,0,9
"CGCAGGTAGTTAGAAC",3,22,6,0,2,33,391
"CGCAGGTCAAGCGGAT",6,19,6,0,3,34,89
"CGCAGGTGTCCAACGC",3,8,5,0,3,19,929
"CGCAGGTGTGTGTGTT",0,2,2,0,0,4,107
"CGCAGGTTCAAAGGTA",0,0,0,0,0,0,11
"CGCAGGTTCCATATGG",5,40,34,6,12,97,3877
"CGCAGGTTCCGTTGGG",0,2,0,0,0,2,56
"CGCAGGTTCCTCACTG",0,0,0,0,0,0,36
"CGCATAAAGACCAGCA",32,85,211,11,44,383,17289
"CGCATAAAGTGATCGG",0,5,0,0,3,8,168
"CGCATAACAACAGATA",4,18,4,0,2,28,237
"CGCATAAGTACCAGAG",0,2,0,0,0,2,76
"CGCATAAGTCATACCA",48,593,145,28,83,897,42139
"CGCATAAGTCGTGATT",0,13,4,0,4,21,363
"CGCATAAGTGCAGATG",1,3,4,0,0,8,166
"CGCATAATCATGACAC",0,10,0,0,0,10,119
"CGCATGGAGAGTCTTC",0,22,8,0,5,35,919
"CGCATGGGTCACCACG",0,10,4,0,3,17,249
"CGCATGGTCAGAGCAG",1,0,0,0,0,1,49
"CGCATGGTCCGGGACT",0,0,0,0,0,0,2
"CGCATGGTCCTGATAG",3,15,4,0,4,26,357
"CGCATGGTCGCTGATA",5,3,2,0,2,12,174
"CGCATGGTCGTTAGAC",1,5,2,0,0,8,45
"CGCCAGAAGACGCATG",2,9,3,0,2,16,503
"CGCCAGAAGCACGATG",5,19,12,35,10,81,2497
"CGCCAGAAGCTAATCC",0,0,0,0,0,0,39
"CGCCAGAAGTGAATAC",0,0,0,0,0,0,21
"CGCCAGAAGTTCCGTA",12,89,20,5,11,137,8344
"CGCCAGACAACGACAG",0,3,0,0,0,3,27
"CGCCAGACACCTGTCT",1,2,0,0,0,3,72
"CGCCAGAGTCGTCGGT",0,0,0,0,0,0,8
"CGCCAGAGTCTGATCA",0,3,2,0,0,5,8
"CGCCAGAGTGACACGA",0,6,2,0,0,8,208
"CGCCAGATCAGACTGT",2,5,5,0,2,14,665
"CGCCAGATCAGCGCGT",1,6,0,0,0,7,409
"CGCCAGATCATTGCCC",0,6,0,0,0,6,113
"CGCCAGATCCTGTTGC",0,0,0,0,0,0,12
"CGCCAGATCGAACGGA",13,135,26,12,19,205,9954
"CGCCAGATCGTGGCGT",10,40,57,2,14,123,3954
"CGCCATTAGCGTGCCT",0,0,0,0,0,0,236
"CGCCATTCAAGTATAG",1,5,4,0,2,12,352
"CGCCATTCAGACACAG",3,8,4,0,21,36,1461
"CGCCATTGTAACCCTA",0,5,0,0,0,5,206
"CGCCATTGTCGCTTGG",1,4,0,0,3,8,127
"CGCCATTGTTGATCGT",57,303,82,29,56,527,24017
"CGCCATTTCGGTCAGC",0,2,6,0,0,8,107
"CGCCATTTCGGTCATA",154,879,271,63,183,1550,76284
"CGCCATTTCTACTCAT",1,4,0,0,4,9,189
"CGCGTGAAGCGACTTT",1,21,6,2,0,30,460
"CGCGTGACACACGGTC",0,3,0,0,0,3,54
"CGCGTGAGTTGGGAAC",0,2,0,0,0,2,13
"CGCGTGATCCTGGGAC",0,3,2,0,0,5,72
"CGCGTGATCGTTGCCT",18,55,32,7,58,170,4169
"CGGAACCAGACGGTCA",1,10,4,0,3,18,203
"CGGAACCAGGAGCTGT",1,2,0,0,0,3,109
"CGGAACCCATCACAGT",9,47,9,2,6,73,1089
"CGGAACCGTACAACGG",3,18,7,3,4,35,671
"CGGAACCGTGCGCTCA",0,0,0,0,0,0,3
"CGGAACCTCAATCTCT",0,11,0,0,0,11,149
"CGGAACCTCAGGTGTT",0,3,0,0,0,3,44
"CGGAACCTCCGTTTCG",1,9,0,0,0,10,126
"CGGAACCTCTAAGCGT",0,6,2,0,0,8,50
"CGGAATTAGAGCAGTC",3,22,3,0,0,28,449
"CGGAATTAGTAGGCCA",3,26,7,2,2,40,1425
"CGGAATTGTCGTGTTA",15,52,10,2,5,84,2039
"CGGAATTGTGAATAAC",1,26,8,0,2,37,887
"CGGAATTTCTCCCAAC",0,3,0,0,0,3,51
"CGGACACAGGCCGCTT",0,4,0,0,0,4,148
"CGGACACGTAACGATA",1,9,2,0,0,12,709
"CGGACACGTGACTGAG",9,134,25,4,20,192,7702
"CGGACACTCATGACAC",22,82,62,13,143,322,15042
"CGGACACTCGTGCGAC",1,17,8,0,3,29,470
"CGGAGAAAGGAAAGGT",8,18,5,0,0,31,429
"CGGAGAAGTACGTGTT",38,143,84,222,65,552,23890
"CGGAGAAGTGCCTATA",1,7,0,0,4,12,143
"CGGAGAATCAACTGGT",1,23,8,0,2,34,663
"CGGAGAATCATTCATC",1,0,0,0,0,1,164
"CGGAGAATCGATCCAA",0,3,4,0,0,7,117
"CGGCAGTAGAAGCTGC",3,18,6,2,3,32,617
"CGGCAGTAGTGAGTGC",0,0,0,0,0,0,8
"CGGCAGTCAACGCCCA",0,0,2,0,0,2,36
"CGGCAGTGTGGACTGA",1,4,3,0,0,8,92
"CGGCAGTTCCTTGACC",5,15,18,0,7,45,1724
"CGGCAGTTCGTTCGCT",52,230,56,15,43,396,17490
"CGGGACTAGCGACCCT",0,4,0,0,0,4,240
"CGGGACTCACATTACG",13,38,25,6,84,166,7578
"CGGGACTCAGCACGAA",1,14,8,2,2,27,685
"CGGGACTCAGGCGTTC",0,7,0,0,0,7,207
"CGGGACTCATAAGCGG",0,0,0,0,0,0,16
"CGGGACTTCAGCGCAC",1,14,2,0,4,21,398
"CGGGACTTCGCTCTCA",2,25,8,2,6,43,745
"CGGGACTTCTAGCATG",1,16,7,0,5,29,528
"CGGGACTTCTATCGCC",0,0,0,0,2,2,41
"CGGGCATAGTCGAATA",0,3,0,0,0,3,75
"CGGGCATCAGCCTACG",0,0,0,0,0,0,118
"CGGGCATGTAACGCGA",12,68,15,3,15,113,5243
"CGGGCATGTAGCGTTT",0,0,0,0,0,0,15
"CGGGCATTCAAGGCTT",8,20,9,0,14,51,1342
"CGGGCATTCAGCAATC",1,2,0,0,0,3,82
"CGGGCATTCTTGGAAC",0,4,0,0,2,6,155
"CGGGTCAAGACGGAAA",0,8,0,0,2,10,46
"CGGGTCAAGTTGGAAT",0,6,0,0,0,6,102
"CGGGTCACATCCGATA",0,0,3,0,0,3,43
"CGGGTCAGTCAAAGCG",0,0,0,0,0,0,4
"CGGGTCAGTCGTACAT",0,5,2,0,0,7,108
"CGGGTCAGTTGCTCGG",0,6,0,0,3,9,37
"CGGGTCATCCACTGAA",138,1016,263,76,201,1694,71942
"CGGGTCATCCGGACTG",86,213,567,45,122,1033,52685
"CGGGTCATCCTGATAG",0,5,0,0,0,5,227
"CGGGTCATCTTACCAT",8,31,37,3,7,86,3882
"CGGGTGTCAATGCTCA",2,13,9,0,3,27,432
"CGGGTGTCACTCGATA",0,4,0,0,0,4,46
"CGGGTGTGTAGGAGGG",0,0,4,0,0,4,110
"CGGGTGTGTATCGCGC",15,34,24,55,11,139,5335
"CGGGTGTGTGAATGAT",22,57,121,6,25,231,11213
"CGGGTGTGTGTATCCA",0,18,7,0,0,25,338
"CGGGTGTTCGGCTCTT",3,18,7,0,5,33,593
"CGGTCAGAGGTGATAT",0,2,0,0,0,2,101
"CGGTCAGAGGTTATAG",5,21,3,0,0,29,531
"CGGTCAGCAACCGTAT",149,948,319,78,202,1696,77139
"CGGTCAGCAATCGCAT",0,0,0,0,0,0,36
"CGGTCAGGTACAGCGA",1,16,9,0,6,32,454
"CGGTCAGGTTCAAACC",0,2,0,0,0,2,101
"CGGTCAGGTTGTCCCT",0,2,3,0,0,5,127
"CGGTCAGGTTTCGTGA",2,4,0,0,0,6,86
"CGGTCAGTCTGACCCT",6,9,3,2,2,22,551
"CGGTCAGTCTTGCAAG",35,266,71,17,53,442,21259
"CGTAAGTCAAGGATGC",2,2,2,0,0,6,70
"CGTAAGTCAATGAAAC",23,76,141,11,31,282,12999
"CGTAAGTCACCTGCGA",0,3,0,0,0,3,8
"CGTAAGTGTTCTTGCC",2,25,3,0,2,32,522
"CGTAAGTTCCAGTGTA",0,3,0,0,0,3,4
"CGTAAGTTCCGATCGG",5,17,4,0,2,28,368
"CGTAAGTTCGGTAAGG",3,25,5,0,8,41,558
"CGTAATGAGCGCACAA",32,35,15,2,8,92,2142
"CGTAATGCATAAGATG",0,6,0,0,2,8,169
"CGTAATGCATCGATAC",1,11,6,0,4,22,435
"CGTAATGGTACGGCAA",0,7,5,0,0,12,204
"CGTAATGGTAGCACAG",1,20,5,2,4,32,61
"CGTAATGGTATGACAA",32,185,51,12,37,317,11846
"CGTAATGTCACGATAC",0,0,2,0,0,2,117
"CGTAATGTCATATGGC",2,16,4,2,2,26,526
"CGTAATGTCCAAGCAT",1,6,5,0,0,12,171
"CGTAGTACAAGTGGTG",2,23,3,0,0,28,406
"CGTAGTACAATCCTAG",0,3,0,0,0,3,96
"CGTAGTACATAGAATG",1,6,0,0,0,7,73
"CGTAGTACATTGTCGA",3,5,0,0,3,11,852
"CGTAGTATCCATCCGT",0,2,0,0,0,2,31
"CGTAGTATCCGTGCGA",0,5,0,0,2,7,280
"CGTAGTATCTGCGTCT",0,8,0,0,0,8,13
"CGTCAAAAGCATACTC",1,5,0,0,0,6,152
"CGTCAAAAGCGGGTAT",9,28,37,4,11,89,4280
"CGTCAAACAAGACCGA",2,24,4,0,2,32,1533
"CGTCAAAGTAGCGAGT",0,0,0,0,0,0,90
"CGTCAAAGTCTAACGT",0,3,0,0,3,6,172
"CGTCCATCAAAGCTCT",12,34,47,3,22,118,5422
"CGTCCATCAATTGCCA",0,2,0,0,0,2,5
"CGTCCATCAGACGATG",2,12,3,0,0,17,524
"CGTCCATCAGTAACCT",1,4,0,0,0,5,92
"CGTCCATGTACAAACA",0,4,2,0,0,6,136
"CGTCCATGTTAATCGC",66,225,79,17,46,433,19100
"CGTCCATTCCAATCCC",0,0,0,0,0,0,8
"CGTCCATTCCATCTGC",4,31,39,3,10,87,3414
"CGTCCATTCGGCTGAC",6,44,11,3,8,72,3700
"CGTCCATTCTGCGGGT",0,8,2,0,0,10,231
"CGTGAATAGCATCAAA",2,7,4,0,0,13,203
"CGTGAATAGCGCCGTT",0,9,27,2,3,41,213
"CGTGAATAGGTAGCCA",3,18,10,0,5,36,906
"CGTGAATCATAAGCGG",1,8,0,0,2,11,226
"CGTGAATGTCAGTCTA",0,7,0,0,0,7,63
"CGTGAATGTGATACCT",1,9,2,0,0,12,128
"CGTGAATTCCGATGTA",8,45,68,3,12,136,5245
"CGTGAATTCCTCAGAA",0,13,2,0,0,15,144
"CGTGAATTCTCATTGT",0,6,0,0,0,6,59
"CGTGAATTCTTTGCTA",12,49,51,14,53,179,4775
"CGTGATAAGATGAAGG",2,5,2,0,0,9,90
"CGTGATAAGGTGGCTA",118,112,41,10,31,312,12772
"CGTGATACAGCTTTGA",1,5,2,0,0,8,239
"CGTGATAGTACGTTCA",1,15,4,0,0,20,500
"CGTGATATCGGACTGC",0,0,0,0,0,0,34
"CGTGCTTAGAAGATCT",1,10,2,0,0,13,271
"CGTGCTTAGCCTTTGA",2,3,0,0,0,5,145
"CGTGCTTCAACGATTC",0,5,2,0,2,9,124
"CGTGCTTCAGTAGATA",1,2,0,0,0,3,51
"CGTGCTTGTAGAGATT",0,3,0,0,0,3,120
"CGTGCTTTCATGGCCG",1,20,2,0,4,27,423
"CGTGCTTTCCAAAGGG",33,93,218,13,42,399,16113
"CGTGTCTAGGCTATCT",0,3,2,0,2,7,49
"CGTGTCTAGTGGTTCT",0,3,2,0,0,5,93
"CGTGTCTCAAGTGATA",5,30,14,3,39,91,2510
"CGTGTCTCACCTGTCT",1,5,2,0,0,8,116
"CGTGTCTCATAATGAG",0,0,0,0,0,0,31
"CGTGTCTGTCAATGGG",1,0,0,0,0,1,37
"CGTGTCTGTGTCCTAA",2,2,0,0,0,4,192
"CGTGTCTGTTGGACTT",12,38,68,2,11,131,4894
"CGTGTCTTCCACAAGT",0,4,8,0,0,12,410
"CGTGTCTTCCCTGGTT",0,2,0,0,0,2,46
"CGTGTCTTCTCTCGCA",4,21,7,0,14,46,959
"CGTTAGAAGATGCTAA",30,86,51,182,62,411,19176
"CGTTAGAAGATGGGCT",2,8,0,0,0,10,141
"CGTTAGAAGATGTAGT",3,36,12,2,7,60,1674
"CGTTAGAAGCTGACTT",27,74,53,6,168,328,13975
"CGTTAGACAGTTAGGG",1,2,0,0,0,3,76
"CGTTAGAGTCGGAAAC",0,3,0,0,0,3,123
"CGTTCTGCATCCGATA",0,8,5,0,0,13,500
"CGTTCTGCATGTGCCG",0,5,0,0,0,5,163
"CGTTCTGGTATCGCTA",1,14,5,2,0,22,382
"CGTTCTGGTCTCAGGC",1,12,6,0,5,24,582
"CGTTCTGGTCTCCTGT",1,6,0,0,0,7,87
"CGTTCTGGTGGACCAA",26,189,54,12,81,362,15336
"CGTTCTGTCAATCTTC",11,63,15,3,28,120,5269
"CGTTCTGTCGGTATGT",0,0,2,0,2,4,166
"CGTTGGGAGAGGATCC",0,4,0,0,0,4,357
"CGTTGGGAGCAGGCAT",5,38,45,3,14,105,4449
"CGTTGGGAGCTTTCCC",0,2,0,0,0,2,91
"CGTTGGGCATTCTCCG",3,22,11,0,21,57,2566
"CGTTGGGGTGGAGAAA",1,3,3,0,3,10,159
"CGTTGGGGTGTATCCA",19,166,54,9,32,280,10654
"CGTTGGGGTTACAGCT",2,17,5,0,0,24,685
"CGTTGGGTCCATACTT",0,14,5,0,4,23,289
"CGTTGGGTCCGTAATG",0,8,3,0,0,11,166
"CGTTGGGTCGAACGCC",0,0,0,0,0,0,9
"CTAACCCAGAGAGTTT",0,13,4,0,0,17,162
"CTAACCCAGGTCCCGT",76,69,30,3,22,200,5877
"CTAACCCCAAAGCTCT",2,2,0,0,0,4,76
"CTAACCCCAAATCAAG",2,3,0,0,0,5,62
"CTAACCCCAGTCGAGA",10,38,19,5,57,129,5140
"CTAACCCCATGTGCTA",10,76,15,5,14,120,5586
"CTAACCCGTAAGATAC",7,34,41,7,11,100,4439
"CTAACCCGTACCACGC",1,9,2,0,0,12,444
"CTAACCCGTAGTCACT",37,221,84,15,42,399,18635
"CTAACCCGTCCACAGC",3,15,5,0,0,23,91
"CTAACCCGTCTTGAGT",0,3,0,0,0,3,45
"CTAACCCGTGAAGCGT",63,46,20,3,19,151,5266
"CTAACCCTCAAGCCGC",0,8,2,0,0,10,311
"CTAACTTAGAAGCCTG",11,34,10,4,31,90,2700
"CTAACTTAGTATTCCG",1,10,4,0,3,18,97
"CTAACTTCAGTCTCTC",4,21,3,0,3,31,817
"CTAACTTGTCTGCCTT",0,0,0,0,0,0,48
"CTAAGTGAGCACCGTC",4,29,12,25,6,76,2094
"CTAAGTGAGGTATCTC",0,3,2,0,2,7,121
"CTAAGTGCATGAAGCG",7,30,23,0,9,69,2862
"CTAAGTGCATGCACTA",0,3,0,0,0,3,24
"CTAAGTGGTGTTGCCG",0,2,2,0,0,4,75
"CTAAGTGGTTAGCTAC",8,42,42,4,11,107,4668
"CTAAGTGTCACTGTCC",2,44,7,2,8,63,1722
"CTAAGTGTCGTGGAAG",0,2,0,0,0,2,52
"CTAAGTGTCTAGCCAA",0,4,0,0,0,4,93
"CTAAGTGTCTATCCAT",2,26,9,2,4,43,578
"CTAAGTGTCTCGTTTA",30,218,58,12,32,350,14880
"CTAAGTGTCTTCGGTC",0,0,2,0,0,2,71
"CTACAGAAGAAGCCTG",3,21,5,0,7,36,335
"CTACAGAAGCATGAAT",0,0,0,0,0,0,19
"CTACAGACAAAGGAGA",35,405,92,23,56,611,29190
"CTACAGACAGAGAATT",0,6,3,0,3,12,78
"CTACAGACAGTAGAAT",244,148,72,20,58,542,21564
"CTACAGAGTAGGAGTC",42,100,198,18,148,506,24984
"CTACAGAGTGTCCCTT",0,14,3,0,2,19,397
"CTACAGAGTTCTCTAT",1,10,0,0,0,11,120
"CTACAGATCACCGACG",0,6,2,0,0,8,149
"CTACAGATCAGCACCG",2,20,37,4,7,70,2870
"CTACAGATCCATCGTC",12,44,22,75,6,159,7856
"CTACAGATCGGAAGGT",6,21,17,0,7,51,1397
"CTACATTCAAAGGATT",0,3,5,0,0,8,166
"CTACATTCAGCTACCG",1,3,3,0,2,9,208
"CTACATTGTCATAGTC",1,8,0,0,5,14,586
"CTACATTGTGATACTC",1,5,3,0,0,9,169
"CTACATTGTGATTCTG",0,0,0,0,0,0,31
"CTACATTTCCTACCAC",1,13,3,0,0,17,318
"CTACATTTCCTCAGGG",45,257,137,19,55,513,25387
"CTACATTTCTCTCGCA",1,4,2,0,2,9,106
"CTACATTTCTGAGATC",1,3,0,0,0,4,24
"CTACCCAAGTTGTCAC",0,2,0,0,0,2,64
"CTACCCACAAGGCGTA",3,16,6,0,0,25,775
"CTACCCACACGTCTCT",96,269,81,19,52,517,19931
"CTACCCACAGGCTCTG",1,10,0,0,4,15,358
"CTACCCATCAAGTAAG",3,23,21,0,6,53,1918
"CTACCTGAGCGTCAGA",1,3,0,0,0,4,93
"CTACCTGAGCTAGCCC",1,0,0,0,0,1,5
"CTACCTGCAAGACAAT",4,26,3,0,9,42,745
"CTACCTGCACGACGTC",0,0,0,0,0,0,107
"CTACCTGCATAAGCAA",3,16,23,0,5,47,1624
"CTACCTGGTAAGTTAG",1,8,3,2,0,14,137
"CTACCTGGTCCTATAG",0,4,0,0,0,4,13
"CTACCTGGTCTGATAC",1,12,2,0,3,18,270
"CTACCTGTCACCACAA",0,6,0,0,5,11,229
"CTACCTGTCCATGATG",3,37,9,0,9,58,1555
"CTACGGGAGACTTCAC",2,2,0,0,0,4,149
"CTACGGGAGCACTGGA",0,16,0,0,0,16,531
"CTACGGGCATCGCTCT",0,6,0,0,0,6,260
"CTACGGGTCGCGATCG",10,46,23,7,82,168,6758
"CTACTATAGCCATTTG",12,73,28,62,15,190,6449
"CTACTATCAAACCACT",3,22,7,0,4,36,770
"CTACTATCAAGCTGTT",0,18,0,3,3,24,350
"CTACTATCAGGGATAC",0,4,2,0,0,6,48
"CTACTATCATCCCGTT",0,2,0,0,0,2,8
"CTACTATCATTGGATC",0,3,0,0,0,3,128
"CTACTATGTAACTAAG",5,36,35,2,18,96,2875
"CTACTATGTGCGAACA",0,3,0,0,0,3,218
"CTACTATTCCGTAGGC",14,43,21,5,63,146,6793
"CTACTATTCGGAAGGT",0,2,0,0,0,2,37
"CTACTATTCTTACGTT",19,122,63,11,34,249,11322
"CTAGACAAGATCCCGC",1,8,3,0,0,12,284
"CTAGACAAGGTTGGAC",11,101,16,3,14,145,5835
"CTAGACAAGTATTAGG",24,79,52,12,155,322,17469
"CTAGACACACTAACCA",2,7,0,0,0,9,468
"CTAGACACAGGCTATT",1,26,5,0,0,32,1116
"CTAGACAGTAGCGTAG",3,18,8,0,7,36,889
"CTAGACATCGTGGTAT",1,17,5,0,3,26,205
"CTAGACATCTCAAAGC",2,28,12,0,7,49,1222
"CTAGACATCTCGAACA",2,33,21,0,7,63,1984
"CTAGGTAAGACTAAGT",1,10,0,0,0,11,362
"CTAGGTAAGACTCCGC",107,282,446,54,477,1366,65886
"CTAGGTAAGCATGCGA",1,7,2,0,0,10,63
"CTAGGTAAGCTCGGCT",0,9,0,0,0,9,174
"CTAGGTAAGGTGCCAA",0,0,0,0,0,0,71
"CTAGGTACACAAGTGG",2,9,2,0,0,13,130
"CTAGGTACACGACCTG",6,26,8,0,4,44,524
"CTAGGTACACTAGGCC",4,21,4,3,2,34,786
"CTAGGTAGTAGGGTAC",0,3,0,0,2,5,165
"CTAGGTAGTGGCCTCA",4,28,7,2,7,48,763
"CTAGGTAGTGTCATGT",0,3,0,0,0,3,32
"CTAGGTATCAAGCTTG",1,3,2,0,0,6,79
"CTAGGTATCATGCAGT",3,6,3,0,0,12,146
"CTAGGTATCCGCTTAC",2,10,0,0,0,12,140
"CTATAGGAGGTTCAGG",3,30,4,0,0,37,550
"CTATAGGCAATACAGA",0,6,2,0,2,10,184
"CTATAGGCACGGCGTT",0,6,2,0,0,8,134
"CTATAGGCACTTCAAG",1,3,0,0,0,4,134
"CTATAGGCAGAAATTG",4,20,5,0,2,31,402
"CTATAGGCAGTTGAAA",31,139,35,11,30,246,13498
"CTATAGGTCTGATTCT",0,14,5,2,3,24,576
"CTATCCGAGACTTCAC",1,2,0,0,0,3,118
"CTATCCGCAGACTCTA",2,14,4,0,0,20,131
"CTATCCGCATTCTCCG",0,2,0,0,0,2,120
"CTATCCGGTCAGATTC",1,20,3,0,3,27,839
"CTATCCGGTGGTCTCG",0,2,0,0,0,2,52
"CTATCCGGTTGCTCGG",3,6,0,0,0,9,102
"CTATCCGGTTGGCTAT",4,16,4,0,4,28,543
"CTATCCGTCACACCGG",18,76,99,13,73,279,15186
"CTATCCGTCTCATGGA",0,0,0,0,0,0,38
"CTATCTAAGACTGAGC",0,0,0,0,0,0,3
"CTATCTAAGGCTATCT",6,22,6,0,13,47,1440
"CTATCTACAAATTAGG",2,20,0,0,7,29,705
"CTATCTACACGTACTA",0,5,2,0,0,7,201
"CTATCTAGTACTGTTG",15,76,109,7,44,251,14718
"CTATCTAGTGAATATG",2,11,5,0,2,20,58
"CTATCTATCTAACACG",0,9,3,0,0,12,150
"CTATCTATCTGAGAGG",0,4,0,0,0,4,110
"CTCAACCAGCGTGCCT",3,4,7,0,3,17,373
"CTCAACCAGTAACGAT",9,74,18,0,14,115,4997
"CTCAACCCAACGGGTA",0,0,0,0,0,0,10
"CTCAACCCAATTGGTC",1,5,0,0,0,6,105
"CTCAACCCACCGTGAC",0,0,0,0,0,0,25
"CTCAACCCACGGGTAA",3,20,15,2,7,47,1547
"CTCAACCCAGACGCTC",1,4,0,0,0,5,537
"CTCAACCCAGTCCCGA",0,2,0,0,0,2,25
"CTCAAGAAGATTAGAC",0,5,0,0,2,7,78
"CTCAAGAAGTGGATTA",1,16,8,0,3,28,736
"CTCAAGAAGTTGCGCC",0,6,0,0,0,6,110
"CTCAAGACATGCCATA",1,9,2,0,3,15,154
"CTCAAGAGTCCTACGG",0,5,2,0,2,9,99
"CTCAAGAGTGCCTAAT",0,0,0,0,0,0,25
"CTCAAGATCTCCGAAA",0,3,0,0,0,3,44
"CTCAAGATCTGCCTCA",3,21,4,0,2,30,751
"CTCAAGATCTTTGCTA",1,8,0,0,0,9,100
"CTCAATTAGCATGCAG",14,130,31,13,23,211,10652
"CTCAATTCATACATCG",10,40,10,3,10,73,2189
"CTCAATTTCCGCTGTT",0,4,0,0,0,4,70
"CTCAATTTCTCCTACG",0,6,2,0,0,8,50
"CTCACTGCAAAGACGC",6,23,6,2,2,39,878
"CTCACTGCAAAGCACG",1,12,7,0,0,20,226
"CTCACTGCAGTCAGTT",0,10,2,0,0,12,191
"CTCACTGGTATCCTTT",1,4,0,0,0,5,133
"CTCACTGGTGATGAAT",1,6,0,0,2,9,233
"CTCAGAAAGACTGAGC",0,10,7,0,3,20,275
"CTCAGAAAGTACAACA",3,10,4,0,0,17,608
"CTCAGAAGTAATACCC",0,2,0,0,0,2,43
"CTCAGAAGTCTGTTAG",26,68,129,13,25,261,12465
"CTCAGAAGTGTCACAT",23,147,29,5,26,230,10395
"CTCAGAATCGTAACTG",20,175,43,10,24,272,11747
"CTCAGGGAGAAAGCGA",8,32,10,7,16,73,1547
"CTCAGGGCACAACGTT",1,3,2,0,0,6,294
"CTCAGGGGTTGCAAGG",19,42,71,5,22,159,7748
"CTCAGGGTCACCTACC",0,6,0,0,0,6,34
"CTCAGTCCAACCAATC",1,6,4,0,2,13,281
"CTCAGTCGTACCAATC",0,0,0,0,0,0,51
"CTCAGTCGTCAACCAT",17,69,40,10,136,272,13449
"CTCAGTCGTGCCTACG",0,3,0,0,0,3,79
"CTCATCGAGATGAACT",2,6,5,0,0,13,130
"CTCATCGAGTCATGCT",0,11,2,0,0,13,456
"CTCATCGAGTTTCGGT",0,6,0,0,0,6,40
"CTCATCGCAATCGTCA",0,0,0,0,0,0,7
"CTCATCGCACCTGATA",0,7,2,0,0,9,89
"CTCATCGGTATCAGCT",9,26,42,2,9,88,3364
"CTCATCGGTGCTGATT",0,26,10,0,3,39,534
"CTCATCGGTTCCCACT",2,14,2,0,0,18,139
"CTCATCGTCCATCGTC",0,3,0,0,0,3,112
"CTCATCGTCTATCGTT",0,8,2,0,0,10,454
"CTCATCGTCTGCTCTG",7,41,13,2,6,69,2457
"CTCATGCAGCCATTCA",5,28,8,2,7,50,2259
"CTCATGCAGCGCCCAT",5,18,12,2,12,49,1880
"CTCATGCAGGCGCTCT",344,319,106,33,74,876,35951
"CTCATGCAGTATGAGT",1,22,5,0,0,28,532
"CTCATGCCACCTGCTT",1,27,11,0,3,42,1267
"CTCATGCCACTACGGC",1,9,0,0,0,10,149
"CTCATGCGTAATCAGA",0,0,0,0,0,0,23
"CTCATGCTCCAAGGGA",3,33,14,2,6,58,1262
"CTCATTAAGAGTACCG",2,11,4,0,3,20,198
"CTCATTAAGTTAACGA",7,71,20,4,14,116,3779
"CTCATTACAAGGACAC",2,34,7,2,4,49,955
"CTCATTACACCTGTCT",2,5,0,0,0,7,237
"CTCATTACATGTGTCA",2,4,3,2,3,14,35
"CTCATTACATTGTAGC",2,7,5,0,2,16,162
"CTCATTAGTTGCATGT",0,6,0,0,0,6,47
"CTCCAACAGGCTTAAA",0,9,6,0,0,15,356
"CTCCAACCAACCGGAA",0,0,0,0,0,0,40
"CTCCAACCATGTGCCG",1,17,10,0,3,31,660
"CTCCAACGTCACCACG",105,260,131,17,56,569,28080
"CTCCAACTCCGGACTG",1,5,2,0,0,8,193
"CTCCAACTCCTCGCAT",0,0,0,0,0,0,7
"CTCCAACTCGACGATT",2,5,0,0,0,7,248
"CTCCAACTCGGTCTGG",1,23,9,2,4,39,658
"CTCCACAAGACGCAGT",3,11,4,0,2,20,449
"CTCCACAAGCCGGAAT",2,2,0,0,0,4,68
"CTCCACACAAGACTGG",1,9,2,0,0,12,98
"CTCCACAGTCATCAGT",1,7,0,0,0,8,257
"CTCCACAGTTCAAAGA",0,10,2,0,4,16,67
"CTCCACAGTTTCGTAG",109,889,232,49,175,1454,73320
"CTCCACATCATTGCTT",0,7,0,0,0,7,230
"CTCCACATCCCGTGTT",0,6,2,0,2,10,259
"CTCCACATCGCCTAGG",18,51,89,3,21,182,8405
"CTCCACATCTATCGCC",1,28,9,0,11,49,1392
"CTCCATGAGTTGGAGC",0,3,0,0,0,3,65
"CTCCATGCACCCTGTT",0,7,2,0,0,9,255
"CTCCATGCACTTGGGC",12,39,21,4,62,138,6510
"CTCCATGCATATACCG",3,23,10,2,12,50,905
"CTCCATGGTGTGCCTG",1,6,2,0,2,11,94
"CTCCATGGTTCCGCTT",0,4,0,0,0,4,106
"CTCCATGGTTCTCCTG",0,2,2,0,0,4,132
"CTCCATGGTTGCCAAT",1,16,4,0,3,24,781
"CTCCATGTCGGACTGC",0,0,3,0,2,5,129
"CTCCCAACAGAGGAAA",10,50,64,3,18,145,7307
"CTCCCAAGTACGTACT",0,0,0,0,0,0,0
"CTCCCAAGTAGATTAG",5,48,17,3,8,81,1371
"CTCCCAAGTCCTGTTC",1,20,5,0,3,29,399
"CTCCCAAGTGTTAGCT",1,7,0,0,0,8,249
"CTCCCAATCCATCCGT",1,7,0,0,2,10,321
"CTCCCAATCGACGACC",0,3,0,0,0,3,58
"CTCCCAATCGCCGAGT",0,10,0,0,0,10,116
"CTCCCAATCTCAGTCC",0,3,2,0,0,5,51
"CTCCCTCAGGCATGCA",0,0,0,0,0,0,46
"CTCCCTCAGGGACTGT",0,0,0,0,0,0,13
"CTCCCTCCAACTAGAA",1,2,0,0,0,3,47
"CTCCCTCCACCTAAAC",2,8,0,0,0,10,246
"CTCCCTCCAGTCTGGC",16,26,10,2,2,56,2458
"CTCCCTCTCGCAGTTA",1,21,6,0,5,33,705
"CTCCGATAGGAGAGGC",1,4,0,0,0,5,120
"CTCCGATAGGTCATCT",2,7,0,0,0,9,194
"CTCCGATCATTGACAC",33,257,74,14,49,427,16102
"CTCCGATGTCAACGCC",1,3,0,0,0,4,69
"CTCCGATGTCCGATCG",16,120,34,8,17,195,9179
"CTCCGATGTCGATGCC",1,12,5,0,2,20,456
"CTCCGATGTTGTCCCT",0,0,0,0,0,0,3
"CTCCGATTCCCAATAG",1,5,2,0,0,8,139
"CTCCGATTCTGGGCAC",4,30,5,2,5,46,660
"CTCCTCCAGCCAGACA",0,0,0,0,0,0,29
"CTCCTCCCATTCCTAT",0,8,2,0,0,10,290
"CTCCTCCGTCATCACA",2,27,5,0,2,36,885
"CTCCTCCGTTCTAACG",3,4,5,0,6,18,929
"CTCCTCCTCTGGCCAG",0,4,0,0,0,4,82
"CTCCTTTAGCAACAGC",1,5,5,0,4,15,320
"CTCCTTTCAGACTCTA",11,48,66,5,15,145,7484
"CTCCTTTCATAATGAG",0,4,0,0,0,4,309
"CTCCTTTGTAATGTGA",3,25,6,2,8,44,283
"CTCCTTTGTATGGAGC",2,20,8,0,4,34,342
"CTCCTTTGTCGTATGT",0,3,2,0,0,5,187
"CTCCTTTGTGGTTCTA",1,17,7,0,4,29,709
"CTCCTTTTCCCGGTAG",4,23,8,2,3,40,1925
"CTCGAGGAGAAAGTCT",0,3,0,0,0,3,12
"CTCGAGGAGACGGAAA",1,3,5,0,0,9,397
"CTCGAGGCACAACGTT",0,2,0,0,0,2,159
"CTCGAGGCAGTCAGTT",4,8,3,0,0,15,40
"CTCGAGGGTAAGATAC",2,10,6,0,0,18,148
"CTCGAGGGTATCGTGT",4,28,10,2,4,48,706
"CTCGAGGTCGGTGTAT",4,16,3,0,4,27,406
"CTCGAGGTCTCGAGTA",0,4,0,0,0,4,170
"CTCTCAGAGGGTATAT",22,78,43,117,57,317,11932
"CTCTCAGAGTGTAGAT",117,607,168,49,125,1066,56173
"CTCTCAGCAAGGACAC",6,29,24,3,13,75,3511
"CTCTCAGCATTGACAC",0,0,0,0,0,0,19
"CTCTCAGGTCATGACT",0,3,0,0,0,3,22
"CTCTCAGGTGCACGCT",1,3,0,0,0,4,423
"CTCTCAGGTGTCTCCT",0,2,6,0,2,10,103
"CTCTCGAAGCGCCTTG",367,726,228,52,163,1536,79371
"CTCTCGAAGTAGGATT",8,29,51,2,13,103,3858
"CTCTCGAAGTGGAAGA",196,1305,328,90,263,2182,107982
"CTCTCGACACAGAAGC",0,2,0,0,0,2,97
"CTCTCGAGTATCGAGG",1,18,7,0,2,28,920
"CTCTCGAGTCAGGAGT",0,5,0,0,2,7,98
"CTCTCGAGTTCCGCGA",17,175,30,8,30,260,12177
"CTCTCGATCGCCAACG",11,32,43,5,12,103,3863
"CTCTCGATCTTTGGAG",5,10,5,0,0,20,483
"CTCTGGTAGCTCTTCC",0,3,2,0,0,5,62
"CTCTGGTCACAAGCTT",0,5,0,0,2,7,239
"CTCTGGTCAGGATGAC",3,28,5,2,2,40,363
"CTCTGGTCATGGGAAC",4,19,6,0,4,33,828
"CTCTGGTGTAGTCGGA",0,9,0,0,0,9,129
"CTCTGGTGTGGCAACA",3,34,9,3,9,58,1207
"CTGAATGAGTTACGGG",0,3,2,0,0,5,33
"CTGAATGCAGGTTACT",1,7,2,0,2,12,254
"CTGAATGCATTGCTTT",23,37,15,3,13,91,4172
"CTGAATGTCAGACTGT",10,65,32,7,75,189,9264
"CTGAATGTCCATCTCG",0,10,0,0,0,10,198
"CTGAATGTCGCTCTCA",21,84,33,8,91,237,11231
"CTGAATGTCTCTGCCA",0,9,4,0,0,13,378
"CTGAGCGAGCTGGAGT",2,21,2,0,4,29,501
"CTGAGCGAGTGTAGAT",0,0,0,0,0,0,41
"CTGAGCGCAGCTGTGC",27,97,56,16,223,419,22087
"CTGAGCGCAGGTGAGT",0,15,3,0,3,21,326
"CTGAGCGCATCGGTTA",0,0,2,0,0,2,5
"CTGAGCGGTAGGACCA",1,0,0,0,0,1,28
"CTGAGCGGTTACGGAG",3,22,0,2,0,27,473
"CTGAGCGTCATTGCTT",0,0,0,0,0,0,7
"CTGAGCGTCCACAAGT",0,6,0,0,0,6,90
"CTGAGCGTCTGCCTGT",0,2,0,0,0,2,19
"CTGAGGCAGCGAACTG",0,7,3,0,0,10,337
"CTGAGGCAGTGAATAC",5,43,10,3,8,69,3555
"CTGAGGCCAGCGACCT",0,8,2,0,2,12,230
"CTGAGGCCATGGCCAC",34,82,173,10,30,329,15213
"CTGAGGCGTTGAGTCT",0,5,0,0,0,5,77
"CTGAGGCTCGAACTCA",0,3,0,0,0,3,215
"CTGATCCAGTCCGTCG",6,32,18,3,37,96,2761
"CTGATCCCACAAAGCG",0,7,2,0,2,11,161
"CTGATCCCAGCTGAGA",1,2,0,0,0,3,48
"CTGATCCGTCATAGTC",14,32,48,4,62,160,7307
"CTGATCCGTCTACATG",0,9,4,0,2,15,224
"CTGATCCGTTATGACC",7,12,11,2,4,36,817
"CTGATCCGTTTCGTAG",3,10,4,0,2,19,689
"CTGATCCTCCCGTTGT",3,22,3,0,6,34,861
"CTGCAGGCAGTTCCAA",3,8,2,0,0,13,284
"CTGCAGGCATCTGTTT",173,110,53,16,46,398,15571
"CTGCAGGGTGCATTTG",1,2,0,0,0,3,21
"CTGCAGGGTTCCAGGC",2,17,4,2,4,29,1226
"CTGCAGGTCTGATTCT",0,7,0,0,0,7,179
"CTGCATCAGACATCCT",0,4,2,0,0,6,103
"CTGCATCAGACGCTCC",0,3,0,0,0,3,84
"CTGCATCAGCCGTAAG",0,2,3,0,0,5,160
"CTGCATCCAACGACAG",2,6,0,0,0,8,122
"CTGCATCGTCGGCCTA",1,3,0,0,0,4,167
"CTGCATCGTGCAATAA",0,4,2,0,0,6,103
"CTGCATCGTGCTCTCT",0,0,0,0,0,0,10
"CTGCATCTCGAGAAAT",6,28,5,5,0,44,732
"CTGCCATAGAATCGTA",0,2,3,0,0,5,53
"CTGCCATAGACTAGAT",6,18,5,3,3,35,646
"CTGCCATAGGTGATAT",1,2,0,0,0,3,170
"CTGCCATCACAGCTTA",2,11,3,0,0,16,338
"CTGCCATCACCGGCTA",0,0,0,0,0,0,158
"CTGCCATGTCGATTTG",2,21,6,0,4,33,860
"CTGCCATGTGCGTTTA",5,18,3,2,4,32,562
"CTGCCATGTTCAGGTT",1,4,0,0,0,5,98
"CTGCCATTCACGGGCT",0,4,2,0,0,6,130
"CTGCCATTCGGAAACG",1,21,13,2,3,40,108
"CTGCCATTCTTTCGAT",0,3,0,0,0,3,33
"CTGCCTACATCTGTTT",71,406,98,35,82,692,36192
"CTGCCTAGTCGGATTT",1,18,5,0,4,28,842
"CTGCCTAGTCTTCGAA",1,12,0,0,0,13,233
"CTGCCTATCTTAGCTT",1,41,10,0,2,54,960
"CTGCGAGAGGTCCGAA",0,7,0,0,2,9,113
"CTGCGAGAGTTTCGGT",10,43,23,7,14,97,3789
"CTGCGAGCATACCACA",0,4,2,0,2,8,138
"CTGCGAGCATCTCGTC",42,405,89,30,58,624,31531
"CTGCGAGGTGACGCCT",0,0,0,0,0,0,56
"CTGCGAGGTTGGTACT",1,2,2,0,0,5,45
"CTGCGAGGTTTACCAG",0,6,0,0,0,6,109
"CTGCGAGTCCCTCAAC",0,4,0,0,0,4,49
"CTGCGAGTCGTGGACC",1,2,2,0,0,5,54
"CTGCTCAAGCTTCGTA",0,0,0,0,0,0,32
"CTGCTCAAGGTCATTC",72,104,59,141,43,419,19189
"CTGCTCACATATCTCT",2,6,3,0,2,13,128
"CTGCTCAGTAGCACAG",30,198,51,16,34,329,15096
"CTGCTCATCCTACTGC",16,194,37,9,33,289,11584
"CTGCTCATCTCAACCC",1,12,11,0,4,28,774
"CTGGACGAGATGTTCC",1,15,4,0,0,20,541
"CTGGACGGTAGACTGG",0,10,3,0,0,13,321
"CTGGACGGTGACTCGC",6,27,15,2,6,56,780
"CTGGACGTCGGTGTAT",0,0,0,0,0,0,13
"CTGGCAGCAGATTTCG",0,12,5,0,2,19,511
"CTGGCAGCAGCAATTC",0,2,0,0,0,2,8
"CTGGCAGCAGCGTATT",0,2,0,0,0,2,53
"CTGGCAGCAGTTGTCA",5,43,14,4,10,76,2680
"CTGGCAGTCATTTCGT",1,4,0,0,0,5,71
"CTGGTCTAGAAGGATG",15,98,31,31,21,196,8628
"CTGGTCTCAAACAGGC",0,5,0,0,0,5,55
"CTGGTCTCAATACCCA",0,3,0,0,0,3,12
"CTGGTCTCAGGTATGG",0,3,0,0,0,3,30
"CTGGTCTGTTTCCCAC",1,12,4,0,2,19,411
"CTGGTCTTCAACGAGG",2,8,6,2,0,18,295
"CTGGTCTTCTCGTTTA",2,5,2,0,0,9,220
"CTGTACCAGGCCTAAG",1,8,2,0,0,11,223
"CTGTACCCAAGATGTA",0,10,2,0,2,14,81
"CTGTACCCATTGGGAG",2,4,3,0,0,9,133
"CTGTACCGTACAAGCG",45,337,124,22,71,599,29363
"CTGTACCGTAGAGACC",16,13,7,2,5,43,1159
"CTGTACCGTAGGCTCC",84,74,32,9,19,218,9206
"CTGTACCGTCGTCATA",0,12,2,0,0,14,293
"CTGTACCGTGCATGAG",3,31,3,0,0,37,851
"CTGTACCTCAACACGT",0,7,2,0,2,11,138
"CTGTACCTCCGTAGGC",0,0,0,0,0,0,1
"CTGTACCTCGCGCCAA",0,7,0,0,0,7,142
"CTGTACCTCGGCAGTC",0,7,2,0,0,9,209
"CTGTAGAAGCTCCACG",1,4,0,0,0,5,172
"CTGTAGACAGCTGTGC",0,5,2,0,3,10,257
"CTGTAGACATAACCCA",0,8,0,0,0,8,180
"CTGTAGAGTCACTTAG",3,18,5,0,2,28,69
"CTGTAGATCCCGTAAA",2,0,0,0,2,4,273
"CTGTATTAGGTGGTTG",0,6,0,0,3,9,121
"CTGTATTCAAACTAGA",0,0,0,0,0,0,1
"CTGTATTCAATGTTGC",1,6,0,0,2,9,53
"CTGTATTCACCAGTAT",5,49,6,3,4,67,483
"CTGTATTCAGGGATAC",1,34,8,0,9,52,947
"CTGTATTCAGGTTCAT",8,52,83,6,25,174,10059
"CTGTATTCAGTTCACA",2,28,8,3,4,45,185
"CTGTATTGTAGATGTA",0,2,0,0,0,2,32
"CTGTATTGTCTGTCCT",43,313,87,18,64,525,31561
"CTGTATTGTGTTCATG",1,3,4,0,0,8,138
"CTGTATTGTGTTGAGG",0,0,0,0,0,0,132
"CTGTATTGTTAACAGA",0,13,4,0,0,17,421
"CTGTATTTCATTCGGA",0,2,0,0,0,2,28
"CTGTATTTCGACCTAA",1,21,7,0,3,32,762
"CTGTCGTCACTACACA",0,6,2,0,0,8,134
"CTGTCGTCACTGGCCA",0,6,3,0,0,9,49
"CTGTCGTCATACCACA",3,30,2,0,6,41,442
"CTGTCGTCATCGTGCG",2,26,4,0,4,36,531
"CTGTCGTGTCTCACAA",0,0,0,0,0,0,19
"CTGTCGTGTGCCTATA",8,37,73,5,13,136,4761
"CTGTCGTTCGCTACAA",103,464,172,340,145,1224,43188
"CTGTGAAAGTCACTAC",18,70,150,7,28,273,13203
"CTGTGAAAGTTTGAGA",0,0,0,0,0,0,75
"CTGTGAACAAAGCACG",1,11,3,0,0,15,886
"CTGTGAACATTGTGCA",2,8,0,0,2,12,176
"CTGTGAAGTAAGCGGT",1,9,2,0,2,14,521
"CTGTGAAGTATCGCGC",35,218,55,7,44,359,16226
"CTGTGAAGTCACTAGT",0,3,0,0,0,3,18
"CTGTGAAGTCCAAAGG",2,2,2,0,0,6,154
"CTGTGAAGTGACATCT",0,3,0,0,2,5,148
"CTGTGAAGTGACCGAA",2,7,2,0,0,11,126
"CTGTGAAGTGTACGCC",1,9,2,0,0,12,166
"CTGTGAAGTTCGGTTA",0,2,0,0,0,2,128
"CTGTGAATCAGGGTAG",2,8,2,0,0,12,90
"CTGTGAATCCAGCTCT",1,10,7,0,2,20,465
"CTGTGGGCAATGACCT",0,8,2,0,2,12,277
"CTGTGGGCAATGAGCG",0,7,0,0,0,7,77
"CTGTGGGCAGCGGTTC",5,34,10,3,5,57,552
"CTGTGGGCATAACCCA",4,23,5,0,0,32,572
"CTGTGGGGTCTGGTTA",1,20,7,2,3,33,60
"CTGTGGGGTTGGGTTT",2,11,0,0,0,13,455
"CTGTGGGTCGCATAGT",9,40,55,5,23,132,8263
"CTGTGGGTCTGGTTGA",0,2,0,0,0,2,27
"CTTACCGCACTCACTC",0,0,0,0,0,0,27
"CTTACCGCAGTTGGTT",1,7,0,0,0,8,231
"CTTACCGCATGGTACT",4,8,3,2,2,19,1101
"CTTACCGGTCGTCGGT",6,29,6,2,30,73,2727
"CTTACCGGTTCTGACA",1,4,2,0,5,12,635
"CTTACCGTCAAGGTGG",106,851,197,55,157,1366,68350
"CTTACCGTCTTTGATC",37,64,23,5,20,149,5414
"CTTAGGAAGTAAGACT",0,0,0,0,0,0,43
"CTTAGGAAGTATAACG",5,30,7,0,7,49,722
"CTTAGGACATCGATCA",6,24,4,0,7,41,745
"CTTAGGAGTATAATGG",10,53,24,4,40,131,4396
"CTTAGGATCACCCTTG",0,2,0,0,0,2,7
"CTTAGGATCATCGACA",1,6,0,0,0,7,46
"CTTAGGATCCGTCCTA",0,4,0,0,0,4,96
"CTTAGGATCCTCAGGG",1,5,2,0,2,10,165
"CTTAGGATCGATTTCT",5,53,19,2,9,88,4281
"CTTCAATAGAATTGTG",5,26,6,0,6,43,1060
"CTTCAATCAACGGCTC",1,8,3,0,0,12,158
"CTTCAATCAAGTCCCG",0,5,0,0,0,5,248
"CTTCAATCAGCAGTTT",4,3,2,6,2,17,907
"CTTCAATGTGAATTAG",0,0,0,0,0,0,51
"CTTCAATGTGTTATCG",50,43,17,0,13,123,4224
"CTTCAATGTTCGGCGT",16,129,58,9,24,236,11586
"CTTCAATTCCTCTTTC",0,0,4,0,0,4,240
"CTTCCGAAGTGATTCC",2,0,0,0,0,2,182
"CTTCCGACAATTTCCT",0,3,2,0,0,5,378
"CTTCCGACATGGGTCC",0,4,3,0,0,7,139
"CTTCCGATCCACAAGT",18,53,119,10,25,225,8488
"CTTCCGATCGAGCCTG",2,16,5,0,3,26,644
"CTTCCTTAGACTGTTC",3,37,10,2,11,63,866
"CTTCCTTAGGCGACAT",1,5,3,0,0,9,144
"CTTCCTTAGTGAGTTA",8,40,19,3,5,75,1838
"CTTCCTTCAACAGTGG",1,6,0,0,0,7,213
"CTTCCTTCACGACGTC",0,4,0,0,0,4,58
"CTTCCTTCATCGGAGA",3,15,8,2,2,30,424
"CTTCCTTGTGATGTAA",0,5,0,0,0,5,287
"CTTCCTTTCTAGGAAA",1,15,4,0,6,26,472
"CTTCGGTAGCACTTTG",86,531,161,43,105,926,53334
"CTTCGGTCAAAGCTAA",0,0,0,0,0,0,6
"CTTCGGTCAGAAGCTG",41,118,252,28,89,528,27206
"CTTCGGTCATTGAGCT",0,3,0,0,0,3,103
"CTTCGGTGTCCATAGT",0,5,0,0,0,5,40
"CTTCGGTGTTAGAGTA",0,5,0,0,0,5,106
"CTTCGGTTCAGGAAAT",364,868,267,65,174,1738,84534
"CTTCGGTTCCGGCAAC",4,22,5,0,6,37,720
"CTTCGGTTCTCATGGA",2,22,9,3,6,42,549
"CTTCTAAAGATCCCAT",2,30,2,2,0,36,548
"CTTCTAACACGAAAGC",3,12,4,0,6,25,723
"CTTCTAACACTTGTGA",0,4,2,0,0,6,253
"CTTCTAACATCCCGTT",4,17,4,0,0,25,89
"CTTCTAACATCCGGCA",0,0,3,0,0,3,132
"CTTCTAAGTTAGCGGA",0,2,0,0,0,2,70
"CTTCTCTCAACCTAAC",0,3,0,0,0,3,204
"CTTCTCTCAAGGCCTC",0,0,0,0,0,0,83
"CTTCTCTCAATAGTCC",0,4,0,0,0,4,139
"CTTCTCTCAGTAGATA",2,23,8,0,5,38,795
"CTTCTCTCATATAGCC",0,12,5,0,4,21,82
"CTTCTCTCATATTCGG",14,36,11,0,5,66,1899
"CTTCTCTGTGCCCGTA",11,65,13,6,10,105,5233
"CTTCTCTGTTGGAGGT",9,24,28,6,9,76,3740
"CTTCTCTTCATAGGCT",2,6,0,0,0,8,144
"CTTGAGAAGTATGAAC",0,3,2,0,0,5,46
"CTTGAGAGTCCGACGT",3,27,7,3,5,45,1208
"CTTGAGAGTCTAACTG",3,25,7,0,5,40,973
"CTTGAGAGTGTCTCCT",0,0,0,0,0,0,3
"CTTGAGATCCTCACGT",0,0,0,0,0,0,30
"CTTGATTAGACGACTG",3,17,9,0,6,35,947
"CTTGATTAGAGAGCCT",1,4,2,0,0,7,147
"CTTGATTAGCGTTCCG",1,0,0,0,0,1,211
"CTTGATTCAAATCAAG",1,12,6,2,3,24,464
"CTTGATTCACTTCTCG",0,0,0,0,0,0,32
"CTTGATTGTCCAGTTA",2,2,4,0,0,8,53
"CTTGATTTCCGTAGTA",2,11,2,0,3,18,309
"CTTTCAAAGACGCATG",3,16,6,2,7,34,401
"CTTTCAAAGGTCGACA",6,28,32,2,7,75,3214
"CTTTCAAAGGTGGGTT",0,2,0,0,0,2,60
"CTTTCAACAACGGCCT",8,51,17,2,10,88,4277
"CTTTCAACAATCGCAT",1,0,0,0,0,1,8
"CTTTCAACAGTTAGAA",0,4,2,0,0,6,149
"CTTTCAACATATGGCT",3,34,12,0,2,51,1010
"CTTTCAACATTCAGGT",1,5,3,2,0,11,404
"CTTTCAATCCCGAATA",0,4,0,0,0,4,135
"CTTTCAATCTTTGCTA",4,37,8,3,11,63,1072
"CTTTCGGAGGACTTCT",2,20,6,0,5,33,925
"CTTTCGGCAATCGCCG",2,0,0,0,0,2,9
"CTTTCGGCATGGCGCT",110,758,177,47,147,1239,64664
"CTTTCGGGTACCATAC",1,24,9,0,5,39,885
"CTTTCGGGTCACTTAG",30,114,128,17,35,324,15065
"CTTTCGGTCAGGAAGC",1,10,0,0,2,13,330
"CTTTCGGTCGGAAGGT",0,5,3,0,2,10,149
"CTTTCGGTCGGTGCAC",1,9,2,0,0,12,110
"GAAACCTAGAAGGTAG",1,2,4,0,0,7,96
"GAAACCTAGCAGGCAT",0,11,2,0,2,15,208
"GAAACCTCAGACCGCT",3,18,7,0,3,31,706
"GAAACCTCAGGTTACT",85,483,123,30,89,810,37735
"GAAACCTGTACGTGTT",4,19,3,0,3,29,623
"GAAACCTGTGACCTGC",131,505,260,53,530,1479,58644
"GAAACCTGTTCTTAGG",2,3,0,0,2,7,123
"GAAACCTTCACGAGGA",1,3,0,0,0,4,134
"GAAACCTTCACTTGGA",3,26,7,0,3,39,742
"GAAATGAAGCAACCAG",0,2,3,0,3,8,60
"GAAATGAGTACAGAGC",0,9,0,0,0,9,101
"GAAATGATCCATTTCA",1,4,0,0,0,5,22
"GAACACTAGGTAAGGA",21,174,39,9,30,273,10886
"GAACACTAGGTAGACC",0,3,0,0,0,3,3
"GAACACTCAAGTTTGC",7,53,55,9,14,138,4834
"GAACACTCACTCATAG",4,30,10,2,4,50,472
"GAACACTCAGGAAGTC",171,1293,359,100,244,2167,96199
"GAACACTCAGTAACGG",71,480,122,38,96,807,34063
"GAACACTGTTGTATGC",33,17,10,6,10,76,2548
"GAACACTTCCGAGGCT",0,2,0,0,0,2,8
"GAACGTTAGGTGGGTT",0,2,0,0,0,2,30
"GAACGTTCACGCGCTA",18,64,45,13,124,264,13303
"GAACTGTAGACGCCCT",9,31,58,3,12,113,4325
"GAACTGTCAGTTGTTG",0,13,0,0,0,13,257
"GAACTGTCATCCTCAC",1,10,0,0,4,15,183
"GAACTGTGTACAGGTG",2,8,5,0,0,15,322
"GAACTGTGTCCGATCG",1,0,0,0,0,1,80
"GAACTGTGTCGTACAT",5,23,4,0,2,34,681
"GAACTGTTCACACCCT",4,36,10,2,5,57,1485
"GAAGAATAGGATATAC",4,33,8,0,3,48,452
"GAAGAATCAAACTCGT",5,33,6,0,6,50,1350
"GAAGAATCAGCGACAA",2,18,3,0,4,27,330
"GAAGAATTCACCGACG",4,18,15,0,5,42,1617
"GAAGAATTCGGCACTG",18,118,35,8,79,258,10966
"GAAGAATTCTCCAATT",0,4,6,0,0,10,99
"GAAGAATTCTGCAGCG",2,8,2,0,0,12,399
"GAAGCCCAGGTACCTT",13,141,49,11,26,240,12098
"GAAGCCCAGTAGAGTT",4,15,4,0,5,28,469
"GAAGCCCCACGTGTGC",1,20,9,2,0,32,722
"GAAGCCCCATGGGATG",0,4,0,0,0,4,156
"GAAGCCCGTGGTCTTA",1,6,0,2,2,11,259
"GAAGCCCTCCGATAGT",3,5,2,0,0,10,159
"GAAGCCCTCGTCTCAC",37,121,42,8,16,224,6782
"GAAGCGAAGAGTCGAC",1,4,4,0,0,9,54
"GAAGCGAAGGGACAGG",0,4,0,0,0,4,188
"GAAGCGACAATTGCCA",0,0,0,0,0,0,7
"GAAGCGACACTGTCCT",0,0,0,0,0,0,6
"GAAGCGACACTGTTCC",0,6,0,0,0,6,92
"GAAGCGACAGCACACC",0,5,0,0,0,5,243
"GAAGCGACAGCGGTCT",30,162,28,12,27,259,11154
"GAAGCGACAGTCTACA",117,838,236,50,156,1397,71975
"GAAGCGAGTGAATGAT",1,0,0,0,0,1,15
"GAAGCGATCAAGCTGT",2,17,9,0,0,28,854
"GAAGCGATCCAACTGA",8,58,12,0,8,86,3790
"GAAGCGATCCCAGCGA",3,23,8,0,4,38,1067
"GAAGCGATCTCCTGAC",2,19,5,0,5,31,591
"GAAGCGATCTCGGGAC",2,5,2,0,0,9,203
"GAAGGACAGAATTCAG",0,2,0,0,0,2,22
"GAAGGACAGACTTCAC",0,0,0,0,0,0,62
"GAAGGACAGATCACTC",2,12,6,0,0,20,1033
"GAAGGACAGCAAACAT",31,233,49,13,44,370,15302
"GAAGGACAGCCATTTG",0,3,2,3,0,8,459
"GAAGGACCAAGAGATT",225,1231,425,120,972,2973,138490
"GAAGGACCACGACAAG",15,58,18,0,13,104,3795
"GAAGGACCACTAAACC",0,3,0,0,0,3,132
"GAAGGACGTGTTACAC",9,40,103,8,9,169,6124
"GAAGGACTCAGACCCG",0,3,0,2,0,5,115
"GAAGGGTAGATGATTG",6,39,6,0,5,56,503
"GAAGGGTAGGTAACTA",0,3,2,0,0,5,77
"GAAGGGTCACTAGGCC",0,3,0,0,0,3,133
"GAAGGGTCATGAGATA",34,118,273,17,62,504,22310
"GAAGGGTGTAACACCT",1,4,2,0,3,10,110
"GAAGGGTGTTAAGCAA",0,8,0,0,2,10,117
"GAAGGGTTCACGGACC",3,20,6,0,4,33,515
"GAAGGGTTCATTACTC",0,5,0,0,0,5,126
"GAAGGGTTCTCGCTCA",0,2,0,0,0,2,148
"GAAGGGTTCTGGCCTT",5,26,6,0,6,43,1011
"GAAGTAAAGCCAAGCA",5,40,14,0,6,65,963
"GAAGTAACACAGACGA",10,32,49,2,11,104,3572
"GAAGTAACAGCGCTTG",0,13,5,0,3,21,435
"GAAGTAACAGGTATGG",2,9,2,0,4,17,213
"GAAGTAACATGGACAG",2,7,0,0,2,11,128
"GAATAGACAAGCACAG",0,6,0,0,2,8,222
"GAATAGAGTCAAAGTA",1,7,3,0,0,11,145
"GAATAGAGTGGCGTAA",20,183,36,7,22,268,11307
"GAATAGATCAAGTAAG",1,16,11,0,3,31,386
"GAATAGATCCAAGCTA",2,28,4,2,10,46,992
"GAATCACAGACTTCAC",0,6,3,0,0,9,117
"GAATCACAGGCCACCT",0,0,0,0,0,0,9
"GAATCACAGGTAAGTT",0,2,0,0,2,4,89
"GAATCACCACCCTCTA",105,625,174,41,109,1054,50732
"GAATCACCACGCACCA",6,39,26,4,21,96,3095
"GAATCACCAGAATGTA",1,0,0,0,0,1,49
"GAATCACCATGCGGTC",2,14,8,0,4,28,577
"GAATCACGTATCGCAT",1,0,0,0,0,1,49
"GAATCACTCCATTGGA",4,84,10,2,6,106,3668
"GAATCACTCGCTGACG",3,36,11,2,4,56,1306
"GAATCACTCGGACTTA",1,2,2,0,0,5,86
"GAATCGTAGACATCAA",7,44,8,3,2,64,2820
"GAATCGTAGGTCGTAG",0,3,0,0,0,3,79
"GAATCGTAGGTGATCG",1,8,2,0,0,11,180
"GAATCGTAGTAAATGC",2,5,2,0,0,9,157
"GAATCGTTCCTTATAC",0,20,5,0,4,29,677
"GACACGCAGCGCAATG",0,2,0,0,0,2,92
"GACACGCAGGACGCAT",0,9,2,0,0,11,227
"GACACGCCAACAGCCC",0,6,2,0,0,8,84
"GACACGCCATCGCTGG",3,23,8,0,6,40,863
"GACACGCGTAACATCC",0,0,0,0,4,4,35
"GACACGCGTAAGCTCT",16,58,115,9,22,220,7486
"GACACGCGTCATAGTC",0,0,0,0,0,0,8
"GACACGCGTTCCACGG",3,5,2,0,0,10,126
"GACACGCTCATCACAG",0,16,5,0,3,24,730
"GACACGCTCGCGTCGA",0,2,0,0,2,4,24
"GACAGCCAGGTGGCTA",0,10,0,0,0,10,230
"GACAGCCGTATGACAA",1,28,9,0,7,45,629
"GACAGCCTCCCGTGTT",0,10,0,0,0,10,128
"GACAGCCTCGCGTGAC",22,206,38,4,29,299,11731
"GACATCAAGAACCCGA",0,6,2,0,0,8,91
"GACATCAAGTGATAAC",0,2,0,0,0,2,15
"GACATCAAGTGTGTTC",2,14,6,2,3,27,443
"GACATCACAGAGAGGG",0,5,0,0,0,5,83
"GACATCATCAAGAAAC",0,4,2,0,0,6,101
"GACATCATCGCGAAGA",3,7,0,0,0,10,119
"GACATCATCGTGACTA",2,18,4,0,3,27,407
"GACCAATAGCAGGTCA",1,5,0,0,0,6,212
"GACCAATAGCCTCACG",4,37,9,3,10,63,1056
"GACCAATAGTATCTGC",91,659,149,41,108,1048,54419
"GACCAATAGTATGAAC",1,8,2,0,0,11,106
"GACCAATAGTGGTGAC",83,218,606,38,133,1078,51579
"GACCAATCACAGCCAC",0,21,9,2,3,35,913
"GACCAATCATTGCCTC",87,527,144,37,116,911,35424
"GACCAATGTGCGAGTA",0,2,0,0,0,2,64
"GACCAATGTGTGTTTG",50,151,181,27,201,610,24039
"GACCAATTCCATTGTT",0,6,0,0,0,6,107
"GACCAATTCGCTACAA",0,6,0,0,0,6,9
"GACCAATTCGGATTAC",0,5,2,0,0,7,305
"GACCAATTCGTGTTCC",2,3,0,0,0,5,117
"GACCCAGAGAACGCGT",0,2,2,0,0,4,102
"GACCCAGAGAATGTTG",0,6,0,0,0,6,93
"GACCCAGAGAGGTCAC",1,8,2,0,0,11,165
"GACCCAGAGCGTACAG",1,5,3,0,2,11,72
"GACCCAGCAATTAGGA",0,23,7,2,5,37,619
"GACCCAGTCGCCGTGA",1,17,4,0,2,24,461
"GACCCTTAGAGATGCC",0,2,0,0,0,2,19
"GACCCTTCACGAAAGC",0,7,5,0,2,14,211
"GACCCTTCAGTTTCAG",1,19,5,0,2,27,493
"GACCCTTCATCGTGGC",2,24,4,2,6,38,989
"GACCCTTTCATCCCGT",0,6,0,0,0,6,60
"GACCCTTTCCCTGGTT",13,47,20,6,54,140,4073
"GACCCTTTCCGCGAGT",1,20,5,0,0,26,633
"GACCCTTTCGCCGAAC",136,1020,267,62,156,1641,78728
"GACCGTGAGGATAATC",3,34,20,4,5,66,1794
"GACCGTGCACCTAAAC",0,0,0,0,0,0,33
"GACCGTGCAGGTGACA",0,2,0,0,0,2,20
"GACCGTGGTAAGACCG",1,3,0,0,0,4,333
"GACCGTGGTCGCTTAA",0,0,0,0,0,0,83
"GACCGTGGTGTCCAAT",9,94,14,2,14,133,4671
"GACCGTGTCTAGGCAT",0,3,0,0,2,5,46
"GACCGTGTCTTCCGTG",2,17,11,0,4,34,541
"GACCTTCAGTCCGCGT",1,5,0,0,4,10,376
"GACCTTCCACACCTAA",0,19,5,2,0,26,547
"GACCTTCTCCCGAGGT",44,104,281,20,52,501,22091
"GACCTTCTCCCGGTAG",0,4,3,0,2,9,137
"GACCTTCTCCGCTAGG",4,10,0,0,0,14,627
"GACCTTCTCTGGACCG",0,13,2,0,2,17,332
"GACCTTCTCTGTCCGT",1,9,0,0,0,10,432
"GACCTTCTCTTGTTAC",0,0,3,0,0,3,29
"GACGCTGAGACTCTAC",2,18,4,0,2,26,369
"GACGCTGAGCCGTCGT",0,0,0,0,0,0,1
"GACGCTGAGCCTATTG",0,3,2,0,0,5,36
"GACGCTGAGTAAATGC",0,8,0,0,2,10,119
"GACGCTGAGTAAGCAT",2,3,2,0,2,9,427
"GACGCTGCAGTCACGC",12,67,21,4,11,115,6399
"GACGCTGGTCCGACGT",49,153,205,28,303,738,36546
"GACGCTGGTGAGATTA",3,30,5,0,4,42,508
"GACGTTAAGGCCCGTT",0,9,0,0,0,9,89
"GACGTTACAATGGCAG",1,12,6,2,4,25,63
"GACTATGAGGAGTCTG",1,5,0,0,0,6,123
"GACTATGCACTTGTGA",0,2,0,0,0,2,8
"GACTATGGTCGAATGG",1,17,3,4,0,25,367
"GACTATGGTCGTTCAA",11,166,26,3,20,226,6511
"GACTATGTCATCACCC",2,14,4,2,2,24,726
"GACTATGTCCAACTAG",1,23,7,0,7,38,863
"GACTATGTCTCCGAGG",0,16,5,0,5,26,129
"GACTCAAAGCATTTGC",0,4,0,0,0,4,144
"GACTCAAAGCGCCATC",14,110,20,6,18,168,8132
"GACTCAAAGTGATAAC",31,100,24,5,12,172,5113
"GACTCAAAGTGGCGAT",0,4,0,0,0,4,134
"GACTCAACAAAGGCGT",33,81,28,5,16,163,5646
"GACTCAACACAATGTC",3,17,8,3,0,31,533
"GACTCAACAGTGCGCT",0,3,0,0,0,3,62
"GACTCAAGTCACTCAA",1,7,2,0,0,10,306
"GACTCAAGTTCCTTGC",0,13,5,0,2,20,416
"GACTCTCAGACGTCCC",4,18,8,3,9,42,1063
"GACTCTCAGCAGCCCT",1,6,2,0,2,11,245
"GACTCTCCAAAGCTAA",1,7,3,0,0,11,166
"GACTCTCCAGCTCTGG",4,16,3,0,3,26,1339
"GACTCTCGTAACGATA",0,2,0,0,0,2,74
"GACTCTCGTACCGCGT",0,0,0,0,0,0,38
"GACTCTCGTGACTGAG",2,18,3,0,3,26,814
"GACTCTCGTTCCATTT",2,10,4,0,0,16,364
"GACTCTCTCCAAGCAT",0,9,2,0,0,11,132
"GACTGATAGGCAGCTA",18,64,113,11,23,229,12776
"GACTGATAGTCGTCTA",2,37,6,2,7,54,815
"GACTGATCAATTCTCT",1,7,2,0,0,10,157
"GACTGATGTGCCGTAC",0,0,0,0,0,0,79
"GACTGATGTGCGTTTA",0,7,0,0,2,9,164
"GACTGATGTTCGGCCA",0,8,0,0,0,8,297
"GACTTCCAGCACTCGC",0,11,5,0,3,19,437
"GACTTCCAGGAACGTC",3,4,2,0,0,9,274
"GACTTCCTCCTGATAG",0,6,0,0,0,6,54
"GACTTCCTCTCATAGG",0,11,0,0,0,11,601
"GAGAAATAGAATTCAG",433,1063,319,95,253,2163,96853
"GAGAAATAGCAAGTGC",0,3,0,0,0,3,45
"GAGAAATAGTTTGTCG",1,8,2,0,2,13,64
"GAGAAATCAAGACTGG",0,3,0,0,0,3,32
"GAGAAATCACCTCTAC",0,24,11,2,5,42,1113
"GAGAAATCATAGGAGC",0,4,0,0,0,4,19
"GAGAAATCATCCTTCG",1,10,0,0,0,11,310
"GAGAAATGTACATTGC",347,2314,689,632,493,4475,209548
"GAGAAATGTATGCGGA",0,2,0,0,0,2,6
"GAGAAATGTCGCCACA",1,7,0,0,0,8,107
"GAGAAATTCCGATCGG",0,2,0,0,2,4,106
"GAGACCCAGTCGAAGC",3,21,7,0,0,31,616
"GAGACCCCACATGGTT",1,6,3,0,0,10,118
"GAGACCCCACTCGATA",1,4,12,0,3,20,734
"GAGACCCGTACATACC",1,9,6,0,4,20,255
"GAGACCCTCCTATGGA",2,2,0,0,3,7,95
"GAGACCCTCTCAGAAC",0,3,0,0,0,3,25
"GAGACCCTCTCAGTCC",29,69,70,9,117,294,10210
"GAGACCCTCTTCGGAA",0,2,0,0,0,2,44
"GAGACTTAGAGAGGGC",25,194,53,15,49,336,16900
"GAGACTTAGAGCATTA",2,4,6,0,3,15,359
"GAGACTTAGATTGCGG",1,6,4,0,4,15,109
"GAGACTTAGCTTTCTT",0,2,0,0,0,2,5
"GAGACTTCACGCGCAT",0,5,0,0,0,5,28
"GAGACTTCAGCTTTGA",19,158,34,7,18,236,10351
"GAGACTTGTGCGTTTA",26,175,55,13,41,310,12319
"GAGACTTGTTCATCTT",8,47,24,8,81,168,8316
"GAGACTTTCCACTTTA",1,16,3,0,4,24,505
"GAGACTTTCCCAATAG",2,13,4,0,2,21,404
"GAGACTTTCGATTCCC",1,3,0,0,3,7,155
"GAGAGGTAGATCACTC",0,6,2,0,0,8,139
"GAGAGGTCACCTGCTT",0,5,0,0,0,5,88
"GAGAGGTGTATGGAAT",0,4,0,0,0,4,111
"GAGAGGTTCGCAAGAG",1,9,4,0,5,19,312
"GAGAGGTTCTAGGCAT",350,2074,610,151,411,3596,168837
"GAGATGGAGAGAGTGA",9,28,12,4,47,100,4340
"GAGATGGAGTAGTCCT",3,21,7,2,8,41,560
"GAGATGGCAAGTACCT",1,12,2,0,4,19,267
"GAGATGGCAGCAGACA",0,0,0,0,0,0,3
"GAGATGGCATGAAAGT",3,19,5,0,8,35,754
"GAGATGGGTAGCGTTT",247,331,121,36,94,829,36770
"GAGCCTGAGTAAGGGA",8,74,20,9,19,130,6149
"GAGCCTGCAACACAGG",3,26,4,0,3,36,666
"GAGCCTGCACCTAAAC",1,4,3,0,2,10,323
"GAGCCTGCATTGAAGA",0,0,0,0,0,0,4
"GAGCCTGGTGGCACTC",1,13,4,0,3,21,628
"GAGCCTGTCCAAGCAT",375,3213,800,182,485,5055,191602
"GAGCTGCTCGACCACG",51,134,176,18,250,629,24275
"GAGGCAAAGAGCATCG",0,0,0,0,0,0,2
"GAGGCAAAGCGCCTTG",59,172,300,30,268,829,44207
"GAGGCAACACTCCGAG",0,26,7,2,3,38,954
"GAGGCAAGTCGATTTG",39,268,56,19,32,414,16406
"GAGGCAAGTCTGGTTA",3,11,2,0,2,18,385
"GAGGCAAGTGATGAAT",44,137,45,14,36,276,10539
"GAGGCAAGTGTATTGC",2,25,12,0,5,44,137
"GAGGCAAGTTCCTACC",3,30,4,0,5,42,439
"GAGGCCTAGCTCTATG",1,0,0,0,0,1,7
"GAGGCCTCAAACTGCT",1,24,5,0,4,34,813
"GAGGCCTCAAGCACAG",0,4,2,0,0,6,75
"GAGGCCTCAAGGGTCA",0,4,0,0,0,4,18
"GAGGCCTCACCAGCTG",13,61,32,4,18,128,5580
"GAGGCCTCACCCTTGT",0,0,0,0,0,0,21
"GAGGCCTCACTAAACC",0,5,0,0,0,5,59
"GAGGCCTCAGACGCTC",3,14,5,2,3,27,418
"GAGGCCTCAGCTCATA",69,186,126,25,475,881,46892
"GAGGCCTGTAGCACAG",0,3,0,0,0,3,25
"GAGGCCTGTCTTCAAG",0,2,0,0,0,2,124
"GAGGCCTGTCTTCCGT",1,21,5,0,3,30,88
"GAGGCCTTCCAAATGC",4,14,2,0,6,26,625
"GAGGGATAGACATAAC",1,0,0,0,0,1,3
"GAGGGATAGGTACTGG",0,5,0,0,2,7,186
"GAGGGATAGTATGAAC",1,7,0,0,0,8,193
"GAGGGATAGTTGAAGT",6,19,16,0,4,45,1440
"GAGGGATCACAGGATG",141,1119,291,83,208,1842,83079
"GAGGGATCAGCCTACG",0,4,0,0,0,4,41
"GAGGGATCAGGTGACA",14,78,23,5,13,133,6313
"GAGGGATTCACTCTTA",1,0,0,0,0,1,37
"GAGGGATTCGCCGTGA",0,5,0,2,2,9,149
"GAGGGATTCGCGTCGA",2,4,3,0,0,9,51
"GAGGGTAAGAATAGTC",0,0,0,0,0,0,19
"GAGGGTAAGACCATGG",0,3,0,0,0,3,68
"GAGGGTAAGCGCTGCT",1,12,0,2,4,19,645
"GAGGGTAAGCGTTCCG",1,0,0,0,0,1,192
"GAGGGTAAGGTACCTT",1,14,6,0,8,29,660
"GAGGGTAGTGAATTAG",3,12,7,0,2,24,464
"GAGTCATGTAGGTTTC",1,0,2,0,0,3,80
"GAGTCATTCCGTAGTA",2,8,2,0,0,12,330
"GAGTCATTCTAACGCA",7,22,10,0,5,44,888
"GAGTCATTCTGGCCTT",0,6,2,0,2,10,239
"GAGTCTAAGAAGCGAA",0,6,0,0,4,10,81
"GAGTCTAAGACGAAGA",0,6,4,0,3,13,132
"GAGTCTACAAGCGAAC",2,4,2,0,0,8,94
"GAGTCTACAGACGCTC",2,8,0,0,3,13,133
"GAGTCTAGTCAAGCGA",10,86,23,3,15,137,7057
"GAGTCTAGTGGGATTG",20,54,83,4,19,180,8949
"GAGTCTATCCATCAGA",1,19,10,0,2,32,340
"GAGTGAGAGTTCGCAT",0,2,0,0,0,2,42
"GAGTGAGCACTACGGC",1,0,4,0,0,5,289
"GAGTGAGCAGCAAGAC",24,32,12,3,8,79,2151
"GAGTGAGCATTGTACG",0,3,3,0,0,6,115
"GAGTGAGTCGACTCCT",1,3,5,0,2,11,131
"GAGTGAGTCTGGCCAG",1,16,4,0,0,21,466
"GAGTGAGTCTTAGCTT",0,6,3,0,0,9,180
"GAGTGTTCAAATACGA",7,54,12,4,7,84,3415
"GAGTGTTCATCCGTTC",1,9,3,0,0,13,38
"GAGTGTTGTTCAGCGC",2,20,15,3,3,43,695
"GAGTGTTTCCGACAGC",19,136,43,10,21,229,9212
"GAGTTACAGAGATTCA",0,7,3,0,0,10,147
"GAGTTACCACATCCCT",3,20,10,3,6,42,64
"GAGTTACCACTGAGGA",2,4,2,0,3,11,165
"GAGTTACCAGCCTACG",0,6,0,0,0,6,92
"GAGTTACCAGCGACCT",0,9,5,0,2,16,187
"GAGTTACGTTCAAACC",2,34,8,0,7,51,996
"GAGTTACGTTCCGCTT",1,2,0,0,0,3,110
"GAGTTACGTTCGTTCC",0,19,4,0,4,27,808
"GAGTTACGTTGCCGAC",1,4,0,0,0,5,188
"GAGTTACTCCTTCTGG",1,2,6,0,3,12,392
"GAGTTACTCGTAGCCG",13,175,39,16,27,270,12447
"GAGTTGTAGCGTGCTC",0,2,2,0,0,4,93
"GAGTTGTAGCTCGTGC",4,14,3,0,2,23,410
"GAGTTGTCAAATCGGG",0,4,7,0,0,11,723
"GAGTTGTCAATTTCGG",0,9,3,0,0,12,64
"GAGTTGTCACGTAGTT",2,10,2,0,3,17,110
"GAGTTGTCAGAGGGTT",0,4,0,0,0,4,158
"GAGTTGTCAGCATACT",4,18,8,0,0,30,366
"GAGTTGTGTAGTCGGA",39,105,74,16,178,412,16579
"GAGTTGTGTGGCATCC",13,56,81,11,53,214,7469
"GAGTTGTTCCGTTGGG",1,21,17,0,0,39,849
"GAGTTGTTCTGCACCT",1,8,3,0,2,14,661
"GAGTTTGAGAATTTGG",1,7,0,2,2,12,151
"GAGTTTGAGATCGCCC",0,4,0,0,0,4,136
"GAGTTTGAGGGTACGT",42,158,80,23,231,534,25893
"GAGTTTGCACTTCCTG",0,2,2,0,0,4,70
"GAGTTTGCAGATTCGT",2,16,5,0,4,27,527
"GAGTTTGGTCAGATTC",1,8,3,0,3,15,263
"GAGTTTGGTCAGGAGT",2,17,6,5,6,36,562
"GAGTTTGGTGCGTGCT",208,593,968,105,917,2791,133049
"GAGTTTGGTTATCTTC",0,2,0,0,0,2,13
"GAGTTTGTCACTCACC",4,6,2,0,0,12,425
"GAGTTTGTCACTTGTT",0,5,2,0,0,7,40
"GAGTTTGTCGCCGAGT",0,0,0,0,0,0,12
"GAGTTTGTCTTACTGT",16,50,86,11,21,184,8097
"GATAGAACAAAGGCAC",0,0,0,0,0,0,47
"GATAGAACACCAGTAT",0,5,0,0,0,5,29
"GATAGAAGTCACTCGG",0,3,3,0,0,6,109
"GATAGAAGTCGTATTG",62,161,405,22,77,727,38419
"GATAGAATCACAATGC",2,10,0,0,3,15,251
"GATAGAATCCGTTTCG",3,40,6,2,4,55,1353
"GATAGAATCGATAACC",1,17,7,0,2,27,566
"GATAGAATCGCTGTTC",0,2,0,0,0,2,12
"GATAGCTCATAATCGC",4,20,0,0,4,28,654
"GATAGCTGTATAGCTC",4,22,4,0,4,34,752
"GATAGCTGTGACTGTT",1,19,4,0,4,28,491
"GATAGCTGTGCTATTG",20,58,21,6,13,118,4715
"GATAGCTTCCGATCGG",1,10,4,2,4,21,153
"GATCACAAGCCTGACC",0,4,0,0,0,4,216
"GATCACAAGCGTTGTT",2,26,3,0,2,33,572
"GATCACAAGCTGACCC",2,9,5,3,2,21,42
"GATCACACAAAGCTAA",0,0,0,0,0,0,4
"GATCACAGTAGAGATT",1,12,2,0,2,17,368
"GATCACAGTCTTGAGT",1,0,0,0,0,1,28
"GATCACAGTGATTGGG",1,0,0,0,0,1,23
"GATCACAGTGGTTCTA",0,9,2,0,0,11,238
"GATCAGTAGAACAAGG",5,26,6,0,0,37,407
"GATCAGTAGCATATGA",37,96,26,10,25,194,6116
"GATCAGTAGCGTGAAC",0,3,0,0,0,3,170
"GATCAGTAGGACTTCT",2,31,10,0,0,43,808
"GATCAGTAGGCGATAC",207,827,227,58,185,1504,60763
"GATCAGTCACATATCG",0,2,3,0,0,5,199
"GATCAGTCACGACGAA",0,2,8,0,2,12,348
"GATCAGTGTAAGATTG",4,24,7,0,0,35,360
"GATCAGTGTCAAGCGA",19,99,48,3,19,188,6587
"GATCAGTTCCATGATG",9,29,50,3,10,101,4523
"GATCAGTTCCATTCAT",2,23,6,0,6,37,728
"GATCAGTTCGTCAGAT",4,41,18,3,6,72,2788
"GATCATGCAGGTTTAC",0,5,0,0,0,5,70
"GATCATGGTGGTCCCA",1,5,4,0,0,10,171
"GATCATGGTTGGGAAC",0,5,4,0,0,9,143
"GATCATGGTTGTACGT",17,79,33,4,96,229,11239
"GATCATGTCACTCGAA",0,11,2,0,3,16,233
"GATCATGTCCAATCTT",0,6,0,0,0,6,243
"GATCCCTAGTTTGAGA",3,14,3,0,0,20,1359
"GATCCCTCACACAGCC",9,94,31,6,21,161,6900
"GATCCCTCAGACGATG",2,25,11,2,3,43,1158
"GATCCCTCATTCACAG",0,20,7,0,0,27,492
"GATCCCTGTCCTCATC",0,0,0,0,0,0,5
"GATCGTAAGCAGGCAT",12,96,23,6,29,166,5798
"GATCGTAAGGACACTG",7,19,8,3,0,37,526
"GATCGTACAATAACGA",22,77,177,15,29,320,17076
"GATCGTACATACACCA",11,41,57,2,14,125,6205
"GATCGTACATGACGTT",1007,398,246,77,189,1917,90324
"GATCGTAGTGATAGAT",1,8,3,0,0,12,105
"GATCGTAGTGGTCCGT",8,43,32,6,69,158,6620
"GATCGTAGTGTCCAAT",19,57,56,9,64,205,6424
"GATCGTATCAGACCCG",10,87,35,8,17,157,5096
"GATCGTATCCAACTGA",0,4,0,0,0,4,57
"GATCGTATCGGCTGAC",4,23,5,0,3,35,1101
"GATCGTATCGTTGTAG",1,15,4,3,0,23,380
"GATGACTAGATTGATG",3,16,4,0,2,25,152
"GATGACTTCCCGAGGT",4,54,13,0,8,79,2900
"GATGAGGAGAGGATCC",0,2,0,0,0,2,31
"GATGAGGAGAGGGCGA",0,7,4,0,0,11,115
"GATGAGGCAACGGGTA",90,395,109,28,82,704,29829
"GATGAGGCACATGAAA",1,2,0,0,0,3,86
"GATGAGGCACCAACAT",1,16,4,0,5,26,416
"GATGAGGGTCTGGTTA",8,17,15,0,4,44,1777
"GATGAGGTCACCATAG",0,6,3,0,0,9,109
"GATGATCCAATTCACG",0,0,0,0,0,0,8
"GATGATCCAGATTCGT",2,33,7,0,0,42,1036
"GATGATCGTGTCCGTG",0,4,0,0,0,4,56
"GATGATCTCTATGTGG",25,93,190,13,61,382,21378
"GATGCTAAGCCAACCC",14,29,62,6,13,124,4833
"GATGCTACATACAGCT",3,7,3,2,2,17,138
"GATGCTATCAGTAGGG",2,26,7,2,2,39,640
"GATGGAGAGACGTCCC",6,36,9,4,10,65,2039
"GATGGAGCAACACGTT",0,2,0,0,0,2,31
"GATGGAGCAGAAGTGC",2,18,4,0,2,26,523
"GATGGAGGTAGACACG",0,5,0,0,0,5,60
"GATGGAGGTATCCTTT",0,7,3,0,0,10,128
"GATGGAGTCATCACTT",1,2,0,0,0,3,5
"GATGTTGGTAAGGTCG",3,29,12,2,3,49,3003
"GATGTTGGTAGGTAGC",0,10,4,0,0,14,430
"GATGTTGTCGAACCAT",3,10,0,0,4,17,333
"GATTCGAAGCCATTCA",3,9,2,0,0,14,509
"GATTCGACAACGAGGT",38,291,72,19,49,469,20431
"GATTCGACATCTTAGG",1,5,0,0,0,6,105
"GATTCGAGTATCGTAC",14,46,39,3,51,153,5553
"GATTCGAGTGATTCTG",0,7,0,0,2,9,234
"GATTCTTAGCGTGCCT",1,5,5,0,0,11,152
"GATTCTTAGCTGACTT",2,0,0,0,0,2,311
"GATTCTTAGGGATGTC",0,0,0,0,0,0,3
"GATTCTTCAAGTCCCG",1,6,3,0,0,10,267
"GATTCTTCAGAGAAAG",0,2,3,0,0,5,68
"GATTCTTGTCGTTGCG",2,33,10,2,25,72,2536
"GATTCTTTCACATCAG",2,4,0,0,0,6,96
"GATTCTTTCGGCTTGG",26,228,53,13,38,358,18241
"GATTGGTAGATCCCAT",0,13,0,0,2,15,176
"GATTGGTAGGCTTAAA",1,9,0,2,3,15,237
"GATTGGTAGGTGTGAC",1,14,5,2,4,26,561
"GATTGGTAGGTTGAGC",0,5,0,0,2,7,91
"GATTGGTCATGTACGT",164,111,64,12,41,392,14224
"GATTGGTGTACAGGTG",7,28,10,2,4,51,1130
"GATTGGTGTTCGTGCG",0,2,0,0,0,2,9
"GATTGGTTCATTTGTC",0,4,0,0,2,6,187
"GATTGGTTCTCATTAC",3,10,7,0,0,20,190
"GATTTCTAGGCACAAC",3,26,6,0,0,35,844
"GATTTCTCAGGCAATG",0,9,0,0,0,9,173
"GATTTCTCATGTCAGT",0,6,2,0,0,8,75
"GATTTCTGTCGGAACA",0,6,0,0,0,6,268
"GATTTCTTCTGGCCGA",0,7,0,0,0,7,225
"GCAACATAGTCCCTAA",2,18,8,0,10,38,294
"GCAACATCAACAGATA",0,2,0,0,0,2,25
"GCAACATCATCAGCGC",0,0,0,0,2,2,12
"GCAACATCATTAAGCC",0,4,0,0,0,4,136
"GCAACATGTATGCTTG",0,0,0,0,0,0,5
"GCAACATGTCAGCGTC",0,0,0,0,0,0,0
"GCAACATTCACTGATG",1,5,3,0,4,13,359
"GCAACATTCCACATAG",0,9,0,0,0,9,116
"GCAACCGAGACAGCTG",1,3,2,0,0,6,123
"GCAACCGAGGTAGCCA",27,35,16,4,9,91,3237
"GCAACCGAGTTCCTGA",0,5,0,0,0,5,189
"GCAACCGCAAACTGCT",1,12,0,2,2,17,358
"GCAACCGGTACAGTAA",245,89,52,12,47,445,15851
"GCAACCGTCGTACCTC",4,7,10,2,3,26,653
"GCACATAAGATGGGCT",85,545,166,31,103,930,48443
"GCACATAAGTCACACT",0,2,2,0,0,4,9
"GCACATAAGTTGTAAG",9,25,34,4,9,81,3349
"GCACATACAGCGCGTT",0,2,0,0,0,2,52
"GCACATACATGTTACG",58,374,85,22,66,605,26971
"GCACATAGTTCGTTCC",4,23,2,0,2,31,51
"GCACATATCTAAGCGT",0,5,0,0,0,5,88
"GCACGGTCACCAAATC",1,8,0,0,2,11,360
"GCACGGTCACCAGGTC",6,18,18,2,5,49,1379
"GCACGGTGTTGAAGTA",1,6,2,0,0,9,211
"GCACGTGAGACGCCCT",2,15,7,0,3,27,487
"GCACGTGAGGATACCG",0,8,2,0,0,10,212
"GCACGTGAGGCGTTAG",1,2,0,0,0,3,42
"GCACGTGGTAATACCC",1,0,0,0,0,1,83
"GCACGTGTCCAAGCTA",0,8,0,0,3,11,53
"GCACTAACATACAGCT",26,131,40,11,31,239,8811
"GCACTAAGTATTTCGG",3,23,6,0,6,38,546
"GCACTAATCACCGCTT",0,4,0,0,0,4,92
"GCAGCCACACCCATAA",0,0,0,0,0,0,3
"GCAGCCACACGTCGGT",0,5,0,0,0,5,19
"GCAGCCAGTGAACGGT",0,4,0,0,2,6,136
"GCAGCCAGTGCATTTG",1,6,0,0,2,9,220
"GCAGCTGAGGCCACTC",2,7,0,0,0,9,135
"GCAGCTGCACCGTGAC",191,1542,374,86,258,2451,111849
"GCAGCTGCATGGTACT",2,8,2,2,2,16,196
"GCAGCTGGTACTGCGC",2,23,7,0,0,32,1124
"GCAGCTGTCGCAGTGC",1,14,2,0,2,19,609
"GCAGCTGTCTGACAGT",27,189,45,12,38,311,16223
"GCAGGCTAGCCTCGTG",1,2,0,0,0,3,18
"GCAGGCTCAAATGGTA",0,5,0,2,0,7,362
"GCAGGCTCACAGCCAC",4,44,8,3,11,70,1896
"GCAGGCTCACTACCGG",7,29,2,0,9,47,979
"GCAGGCTGTACAGAAT",0,5,0,0,2,7,182
"GCAGGCTGTAGGAAAG",1,6,0,0,0,7,130
"GCAGTTAAGATCCGAG",3,14,6,0,5,28,589
"GCAGTTAAGCGTGTCC",0,6,0,0,2,8,56
"GCAGTTAGTGAGAACC",21,103,24,0,24,172,8921
"GCAGTTATCCTGGGAC",2,16,6,0,3,27,477
"GCAGTTATCGAAGAAT",2,6,0,0,0,8,159
"GCAGTTATCTTGCAAG",0,3,0,0,0,3,132
"GCATCGGAGATAGCTA",0,2,0,0,0,2,7
"GCATCGGAGCCACAAG",0,11,0,0,0,11,244
"GCATCGGAGCTGGCTC",0,5,0,0,0,5,99
"GCATCGGGTAGATCGG",0,2,0,0,0,2,70
"GCATCGGGTCAGGCAA",0,7,0,0,2,9,151
"GCATCGGTCAAAGCCT",0,0,0,0,0,0,8
"GCATCGGTCCGAGTGC",0,0,0,0,0,0,4
"GCATCGGTCCTCTTTC",0,0,0,0,0,0,18
"GCATCGGTCGAGTCCG",17,20,7,2,2,48,2432
"GCATCGGTCGTCAGAT",2,4,5,0,0,11,123
"GCATCTCAGCGACTTT",6,20,14,0,12,52,1718
"GCATCTCAGTGGTGGT",36,170,46,9,36,297,12151
"GCATCTCCACCTGCTT",136,195,61,26,50,468,21227
"GCATCTCCAGATACTC",1,0,0,0,0,1,9
"GCATCTCCAGTGACCC",1,2,0,0,0,3,192
"GCATCTCGTGAGAACC",1,0,0,0,2,3,15
"GCATCTCGTTCGGTAT",0,2,2,0,0,4,94
"GCATCTCTCACCTACC",0,3,0,0,0,3,60
"GCATCTCTCCGTACGG",1,19,11,0,7,38,1261
"GCATCTCTCGGTCATA",69,557,146,36,102,910,44200
"GCATCTCTCTTACACT",3,11,7,0,0,21,538
"GCATGATAGAGGTTTA",0,7,2,0,4,13,78
"GCATGATCACACACGC",31,229,59,12,40,371,14911
"GCATGATTCGATACAC",0,10,4,0,4,18,410
"GCATTAGAGAGTTGTA",0,5,0,0,3,8,70
"GCATTAGAGCGCCTTG",2,14,5,0,6,27,997
"GCATTAGCAGAGTCTT",1,4,0,0,3,8,133
"GCATTAGGTACGTGTT",1,6,0,0,0,7,324
"GCATTAGGTCGTCTCT",3,14,2,0,0,19,286
"GCATTAGGTGGCTGAA",84,343,88,43,68,626,23214
"GCATTAGTCCTCCACA",2,6,5,0,3,16,122
"GCATTAGTCTGGTGGC",4,30,10,2,23,69,1939
"GCCAACGAGAATTTGG",2,5,0,0,0,7,202
"GCCAACGAGAGAGAAC",0,5,2,0,0,7,133
"GCCAACGAGTGTCATC",0,2,0,0,0,2,107
"GCCAACGCAGTGTGCC",1,7,3,0,0,11,312
"GCCAACGCATGTTACG",4,18,5,0,2,29,359
"GCCAACGGTTTCTATC",1,2,0,0,2,5,175
"GCCAACGTCGAGAAAT",0,8,2,0,0,10,196
"GCCAACGTCTCGCTTG",0,11,5,0,3,19,442
"GCCAGCAAGGTAGCCA",0,3,0,0,0,3,48
"GCCAGCAAGGTCCAGA",0,6,0,0,0,6,43
"GCCAGCAAGTACCGGA",29,24,12,3,3,71,1710
"GCCAGCACACCACATA",0,0,0,0,2,2,138
"GCCAGCACAGGGCTTC",0,2,0,0,0,2,8
"GCCAGCAGTACATTGC",0,4,2,0,0,6,241
"GCCAGCAGTGGATCAG",0,16,5,0,0,21,336
"GCCAGCATCAGCGCAC",0,0,0,0,0,0,25
"GCCAGCATCGTCAAAC",0,0,0,0,0,0,29
"GCCAGGTGTTGGCTAT",1,24,8,0,6,39,686
"GCCAGGTTCTGCGGAC",4,19,4,0,6,33,370
"GCCAGTGAGCTAAATG",0,0,0,0,0,0,13
"GCCAGTGCACGTGTGC",4,37,9,2,5,57,1702
"GCCAGTGCACTAGGCC",0,4,0,2,0,6,131
"GCCAGTGTCAGCTTCC",0,6,0,0,2,8,53
"GCCAGTGTCATACGAC",3,28,8,0,3,42,792
"GCCATGGAGATTGAGT",0,11,2,0,0,13,272
"GCCATGGAGTGCTCGC",0,0,0,0,0,0,10
"GCCATGGCAAGTCCAT",1,16,5,0,4,26,508
"GCCATGGCAATTGTGC",2,7,2,0,0,11,268
"GCCATGGGTGAGCTCC",0,5,0,0,0,5,42
"GCCATGGTCATGCCCT",0,0,2,0,0,2,33
"GCCATGGTCTAGTTCT",16,55,28,131,11,241,7884
"GCCATTCAGCGATGAC",2,4,3,0,0,9,227
"GCCATTCCAGCACACC",0,6,0,0,0,6,205
"GCCATTCCATAGACTC",0,4,0,0,0,4,130
"GCCATTCGTCACTGAT",6,11,7,0,0,24,285
"GCCATTCGTGTTTCTT",1,2,0,0,0,3,33
"GCCATTCGTTCATCGA",2,22,7,0,5,36,633
"GCCATTCGTTGTCTAG",0,8,3,0,0,11,257
"GCCATTCTCCATCGTC",5,24,10,2,4,45,918
"GCCATTCTCCTTATAC",12,52,50,9,30,153,4803
"GCCATTCTCGCGTGCA",2,4,0,0,0,6,121
"GCCCAGAAGCACCTGC",3,5,0,0,0,8,245
"GCCCAGAAGGTACTGG",164,1199,382,105,228,2078,87540
"GCCCAGAAGTGTTGAA",0,8,0,0,0,8,216
"GCCCAGAGTATGCTTG",7,48,13,7,9,84,3594
"GCCCAGAGTCAAAGTA",1,4,2,0,0,7,67
"GCCCAGATCCATCCGT",0,0,0,0,0,0,98
"GCCCGAAAGCAGGTCA",0,4,0,0,0,4,182
"GCCCGAACACACCGCA",0,5,2,0,0,7,233
"GCCCGAATCAGATGCT",1,5,3,0,2,11,252
"GCCCGAATCCTACTGC",1,5,2,0,0,8,181
"GCCCGAATCGGCCCAA",2,30,4,0,0,36,567
"GCCCGAATCTCCGCAT",0,5,0,0,0,5,233
"GCCGATGCAAGAGTGC",2,25,9,0,5,41,854
"GCCGATGCACCGGCTA",0,0,0,0,0,0,1
"GCCGATGTCACGATAC",0,4,2,0,0,6,140
"GCCGATGTCGAGTCTA",0,18,4,0,2,24,509
"GCCGTGAAGAACAAGG",0,3,0,0,0,3,44
"GCCGTGACAATTGGTC",5,23,8,0,8,44,1056
"GCCGTGACACCCTAAA",3,30,8,0,3,44,725
"GCCGTGACAGAACATA",2,6,2,0,0,10,173
"GCCGTGACAGCAGGAT",0,2,0,0,0,2,162
"GCCGTGACATGACGGA",1,6,0,0,0,7,67
"GCCGTGAGTAGGAGTC",1,5,3,0,0,9,191
"GCCGTGAGTGCGCTCA",10,35,78,0,17,140,6011
"GCCGTGATCAGCACCG",1,28,6,0,3,38,365
"GCCGTGATCAGGGATG",35,96,47,76,21,275,9156
"GCCGTGATCCGAACGC",1,11,4,0,3,19,725
"GCCTGTTAGACATCCT",40,125,107,16,169,457,19890
"GCCTGTTAGCTGGCTC",0,10,3,0,2,15,430
"GCCTGTTCAAAGTATG",3,8,2,0,2,15,202
"GCCTGTTCAAGCACCC",0,8,0,0,0,8,359
"GCCTGTTCAATACAGA",7,49,14,2,7,79,2437
"GCCTGTTCACGAGAAC",2,3,0,0,0,5,77
"GCCTGTTTCCATGAGT",2,6,4,0,0,12,116
"GCGAGAAAGCTAGTTC",0,3,0,0,2,5,172
"GCGAGAAAGGATTACA",2,3,2,0,0,7,255
"GCGAGAAAGGCACTAG",1,9,2,0,0,12,71
"GCGAGAAGTCAACGCC",1,5,0,0,0,6,171
"GCGAGAAGTCTCTCAC",0,0,0,0,0,0,17
"GCGAGAATCATGGAGG",2,7,0,0,0,9,90
"GCGAGAATCCGGACTG",0,2,0,0,0,2,10
"GCGATCGAGGAACTAT",1,16,4,0,0,21,85
"GCGATCGAGTTGCTCA",0,5,2,0,0,7,114
"GCGATCGAGTTTGAGA",0,34,8,3,6,51,127
"GCGATCGGTAGCTGTT",0,11,6,0,4,21,386
"GCGATCGGTCCACGCA",3,17,6,2,2,30,890
"GCGATCGGTGCGGATA",31,237,60,18,43,389,20289
"GCGATCGGTTAATCGC",0,21,4,0,4,29,414
"GCGATCGTCGAACCAT",0,2,0,0,0,2,69
"GCGATCGTCTCGCTCA",0,2,0,0,0,2,234
"GCGGAAAAGGTACATA",1,7,0,0,0,8,54
"GCGGAAAGTTTACGAC",1,2,0,0,0,3,18
"GCGGAAATCACTGTTT",0,3,0,0,0,3,98
"GCGGATCAGCGCCTTG",9,31,28,3,21,92,3227
"GCGGATCCAATCGCAT",0,8,2,0,2,12,155
"GCGGATCCACAAGTGG",0,0,0,0,0,0,16
"GCGGATCCAGCAGTGA",10,54,20,8,49,141,5210
"GCGGATCGTCGCTTGG",7,4,3,0,0,14,252
"GCGGATCGTCTATGAC",11,76,16,9,11,123,6268
"GCGGATCGTCTTACTT",0,2,6,0,0,8,353
"GCGGATCGTGATAGAT",0,4,2,0,0,6,238
"GCGGATCGTGGGTATG",0,3,0,0,0,3,52
"GCGGATCTCATAGGCT",2,20,6,0,2,30,410
"GCGGATCTCGAACGGA",1,0,0,0,0,1,11
"GCGTGCAAGAAATCCA",1,3,2,0,2,8,127
"GCGTGCACAAACTCTG",123,1063,213,83,156,1638,69417
"GCGTGCACACATGTTG",7,85,25,5,15,137,6193
"GCGTGCACAGCTACTA",57,386,122,25,83,673,24529
"GCGTGCAGTCAGATTC",1,22,7,0,2,32,399
"GCGTGCAGTGCCTTTC",21,18,6,3,6,54,2030
"GCGTGCATCGGACTTA",32,303,71,18,63,487,16980
"GCGTGCATCTCGACCT",0,7,0,3,0,10,101
"GCGTTTCAGCTTTCTT",7,44,42,2,15,110,3135
"GCGTTTCCAAAGGCGT",181,1315,342,95,230,2163,110650
"GCGTTTCCAATGCAAA",0,0,0,0,0,0,43
"GCGTTTCCACAAGGTG",1,21,5,2,3,32,437
"GCGTTTCCATTACTCT",151,977,261,136,185,1710,71144
"GCGTTTCGTGTTATCG",0,3,0,0,0,3,31
"GCGTTTCTCTATCGCC",0,2,0,0,0,2,29
"GCTACAAAGAGAGGGC",1,26,10,4,8,49,968
"GCTACAACAGGTAGTG",2,15,7,0,3,27,611
"GCTACAATCTTCACGC",4,33,10,0,4,51,1596
"GCTACCTCACCATTCC",0,0,0,0,0,0,23
"GCTACCTCACGCTTAA",11,38,65,6,17,137,5385
"GCTACCTCATTCACCC",5,23,19,0,4,51,1621
"GCTACCTGTCAATGGG",0,9,0,0,0,9,29
"GCTACCTTCCTAACAG",21,39,13,5,11,89,3528
"GCTACCTTCTCCGATC",1,3,0,0,0,4,71
"GCTCAAAAGACCGTTT",26,191,45,11,31,304,14596
"GCTCAAAAGGACCCAA",2,6,2,0,0,10,288
"GCTCAAAAGTCGCCAC",0,21,4,0,5,30,688
"GCTCAAACACAAACGG",102,552,191,387,133,1365,54021
"GCTCAAACACTAGAGG",1,10,0,0,0,11,247
"GCTCAAAGTAGGACCA",7,26,12,2,40,87,2950
"GCTCAAATCAAGGACG",1,15,3,0,0,19,164
"GCTGAATAGACATAAC",0,3,0,0,0,3,231
"GCTGAATAGAGTCAAT",0,4,0,0,2,6,84
"GCTGAATAGGCACTCC",1,10,3,0,0,14,37
"GCTGAATCATCAGTGT",1,2,0,0,0,3,17
"GCTGAATGTAACTGCT",6,13,3,0,0,22,335
"GCTGAATGTCAACGCC",4,17,0,0,2,23,485
"GCTGAATGTTCTATCT",6,23,10,0,4,43,805
"GCTGAATTCGAACCTA",2,23,5,0,3,33,944
"GCTGAATTCGATCCCT",0,4,0,0,0,4,75
"GCTGCAGAGAGAGGGC",1,6,0,0,2,9,204
"GCTGCAGCAACGGGTA",72,543,125,37,95,872,38513
"GCTGCAGCAAGGTCGA",0,11,0,0,0,11,255
"GCTGCAGCAATAACCC",0,5,2,0,0,7,120
"GCTGCAGCACTGATTG",11,41,36,3,6,97,3618
"GCTGCAGCATCTGCGG",42,357,73,28,61,561,20369
"GCTGCAGGTCGGCACT",36,106,254,15,114,525,23147
"GCTGCAGGTGGGTCAA",3,20,16,0,0,39,1376
"GCTGGGTAGAATCGCG",1,24,5,0,0,30,339
"GCTGGGTAGGCTATCT",6,9,5,0,3,23,165
"GCTGGGTAGGGCAAGG",2,20,2,0,3,27,315
"GCTGGGTCAAACTAGA",0,0,2,0,2,4,226
"GCTGGGTCACATGGTT",1,4,0,0,0,5,209
"GCTGGGTCATGACAAA",1,2,2,0,0,5,91
"GCTGGGTGTCGTTATG",0,5,0,0,0,5,119
"GCTGGGTGTTAAGACA",6,14,7,0,5,32,497
"GCTGGGTTCCACGTGG",105,768,204,59,148,1284,62080
"GCTGGGTTCCCGTGAG",0,4,3,0,0,7,84
"GCTGGGTTCCTTATCA",1,4,3,0,2,10,150
"GCTTCACAGATCGCTT",0,15,6,0,5,26,610
"GCTTCACAGGAGACCT",0,3,2,0,0,5,68
"GCTTCACCAGACGGAT",3,21,4,4,3,35,464
"GCTTCACCAGTCAGCC",0,6,0,0,0,6,200
"GCTTCACCATAGATGA",2,31,5,3,5,46,1740
"GCTTCACGTACTGCCG",0,4,0,0,2,6,17
"GCTTCACGTCAGGAGT",0,2,0,0,3,5,88
"GCTTCACGTGACACAG",5,23,6,0,6,40,377
"GCTTCACGTTCGTTCC",1,0,0,0,0,1,181
"GCTTCACTCTTCCACG",1,8,0,0,2,11,80
"GCTTGGGAGGATGTTA",8,41,43,4,14,110,4809
"GCTTGGGGTAACCCTA",1,4,2,0,0,7,135
"GCTTGGGGTGGTAATA",1,5,2,0,0,8,171
"GCTTGGGTCCACCTGT",0,0,0,0,3,3,135
"GCTTGGGTCGGCTATA",134,504,451,72,821,1982,90110
"GCTTTCGAGGTTACCT",0,19,3,0,2,24,544
"GCTTTCGGTCCAATCA",1,3,0,0,0,4,264
"GCTTTCGGTGCATGTT",21,65,108,4,19,217,8845
"GCTTTCGTCGCATTAG",1,15,3,0,0,19,452
"GCTTTCGTCTGATGGT",44,126,238,23,102,533,26309
"GCTTTCGTCTTCACAT",0,5,0,0,0,5,102
"GGAACCCAGAGATGCC",0,0,0,0,0,0,2
"GGAACCCAGATCGACG",1,2,2,0,0,5,160
"GGAACCCAGGCATTTC",0,6,0,2,0,8,200
"GGAACCCCAACACTAC",160,420,518,68,1066,2232,103000
"GGAACCCCAAGCCATT",1,7,3,0,0,11,397
"GGAACCCCAATAGGAT",1,0,2,0,0,3,19
"GGAACCCGTACTAGCT",2,12,2,0,2,18,35
"GGAACCCGTCAGCTTA",1,0,0,0,0,1,5
"GGAACCCGTGACAGGT",0,6,2,0,0,8,175
"GGAACCCGTGAGTTTC",3,22,3,0,6,34,514
"GGAACCCGTTCTAACG",0,7,4,0,3,14,194
"GGAACCCGTTCTCCCA",1,11,5,0,2,19,485
"GGAAGTGAGCACCAGA",26,216,40,16,30,328,12163
"GGAAGTGAGTTTCGAC",5,26,6,0,11,48,597
"GGAAGTGCAAAGGATT",0,8,0,0,0,8,202
"GGAAGTGCAGAAACCG",0,0,0,0,0,0,33
"GGAAGTGCAGGTTTAC",8,40,56,3,13,120,5149
"GGAAGTGCATCGTTCC",1,43,17,0,5,66,481
"GGAAGTGGTCTAGTGT",3,6,2,0,0,11,92
"GGAAGTGTCAACGCTA",0,6,5,0,3,14,66
"GGAAGTGTCAGCTTCC",0,5,2,0,2,9,147
"GGAAGTGTCAGTGATC",0,5,3,0,0,8,211
"GGAAGTGTCGTTAGTG",2,5,0,0,0,7,45
"GGAATCTCATTACTCT",1,10,3,0,2,16,149
"GGAATCTGTCACAGTT",1,26,10,0,3,40,660
"GGAATCTGTCTTGAGT",1,4,0,0,0,5,174
"GGAATCTGTGGCACTC",0,5,4,0,0,9,211
"GGAATCTTCCGGCTTT",3,18,4,0,3,28,439
"GGAATGGAGAGGCGGA",1,2,0,0,4,7,280
"GGAATGGAGCGACATG",1,2,0,0,0,3,60
"GGAATGGAGGTCCGAA",0,4,0,0,2,6,98
"GGAATGGAGTTGCATC",0,11,5,3,2,21,244
"GGAATGGCATAGAGGC",2,5,3,0,2,12,91
"GGAATGGGTACGTGTT",0,13,4,0,0,17,391
"GGAATGGGTCAGGTAG",0,5,2,0,2,9,166
"GGAATGGGTGACATCT",8,39,53,6,12,118,3965
"GGAATGGGTGTACAGG",3,3,0,0,2,8,145
"GGAATGGTCCGATGCG",28,26,8,3,11,76,1666
"GGAATGGTCCGCGGAT",1,4,2,0,0,7,127
"GGACGTCAGGCACTAG",0,3,0,0,2,5,56
"GGACGTCAGTCTCCTC",0,0,0,0,0,0,3
"GGACGTCAGTGTTGTC",17,44,17,7,116,201,8334
"GGACGTCCACTAACCA",1,2,2,0,0,5,176
"GGACGTCCACTGTGTA",1,7,0,0,0,8,153
"GGACGTCCATGGGTTT",2,8,2,0,0,12,298
"GGACGTCGTAGCCCTG",0,12,0,0,4,16,236
"GGACGTCGTATAATGG",6,26,37,6,7,82,2638
"GGACGTCGTCGCAACC",0,11,5,0,2,18,226
"GGACGTCTCGTGTGAT",1,17,3,0,2,23,241
"GGAGAACAGGAGACCT",523,202,124,27,90,966,32133
"GGAGAACGTCCGGCAT",0,13,2,0,0,15,387
"GGAGAACGTGTGCTTA",3,23,15,0,2,43,444
"GGAGATGCATCTCGTC",0,2,0,0,0,2,128
"GGAGATGCATGGCCCA",0,4,3,0,0,7,121
"GGAGATGGTCCTTTGC",0,0,0,0,0,0,10
"GGAGATGGTTGGCCTG",1,13,3,0,4,21,699
"GGAGATGTCACTACTT",0,9,3,0,2,14,389
"GGAGCAAAGAAACTCA",1,11,3,0,0,15,213
"GGAGCAAAGAAGGGAT",0,0,0,0,0,0,10
"GGAGCAAAGTAACGTA",0,3,0,0,0,3,68
"GGAGCAACACCGTCGA",0,0,0,0,0,0,13
"GGAGCAAGTCCATACA",0,3,0,0,0,3,50
"GGAGCAAGTTATGTCG",1,11,5,0,4,21,301
"GGAGCAATCGACGAGA",1,24,8,0,4,37,590
"GGAGCAATCGTGACTA",3,19,3,2,3,30,308
"GGAGCAATCTTACCGC",0,0,0,0,0,0,3
"GGAGGATAGCACACAG",0,4,0,0,0,4,63
"GGAGGATAGTTGAAGT",2,7,0,0,0,9,163
"GGAGGATGTATGCTTG",2,15,4,2,5,28,478
"GGAGGATTCATGGCCG",3,14,3,0,3,23,335
"GGAGGATTCTTCGGTC",6,25,2,0,7,40,509
"GGAGGTAAGGGACCAT",0,5,2,0,0,7,41
"GGAGGTAAGTGAGGTC",1,15,4,0,2,22,400
"GGAGGTAGTAACACGG",0,15,2,0,0,17,69
"GGAGGTAGTCCAACGC",0,5,0,0,0,5,104
"GGAGGTATCACTGAAC",0,3,3,2,0,8,175
"GGAGGTATCTCCGAAA",1,4,0,0,0,5,122
"GGATCTAAGAGTCAAT",1,6,0,0,0,7,127
"GGATCTACACCGTGGT",0,12,0,0,0,12,461
"GGATCTACATGCTGCG",0,3,0,0,0,3,100
"GGATCTAGTGGGTCAA",0,4,0,0,0,4,96
"GGATGTTAGATAGCTA",1,4,2,0,0,7,30
"GGATGTTAGCTAGATA",1,7,0,0,2,10,87
"GGATGTTCAATAACCC",0,3,7,0,0,10,122
"GGATGTTCACGTAGAG",8,26,15,4,59,112,3606
"GGATGTTCAGTTGTCA",0,7,0,0,0,7,128
"GGATGTTGTAATTGGA",1,4,0,0,2,7,83
"GGATGTTGTACAGAAT",361,1127,395,98,217,2198,97981
"GGATGTTGTTGGGAAC",0,0,0,0,0,0,1
"GGATGTTTCACAAGAA",7,39,45,4,12,107,3661
"GGATGTTTCATAGCAC",1,13,3,0,0,17,392
"GGATGTTTCGTTACCC",24,55,80,14,18,191,5372
"GGCACGTAGAGCTTTC",1,4,0,0,0,5,121
"GGCACGTAGGCTGTAG",0,6,0,0,0,6,54
"GGCACGTAGGTTTACC",0,4,0,0,0,4,37
"GGCACGTCAAATGGAT",1,9,2,0,0,12,156
"GGCACGTCACACTGGC",216,2485,545,78,286,3610,92643
"GGCACGTCAGAGAAAG",0,0,0,0,0,0,0
"GGCACGTCATGATGCT",0,3,0,0,0,3,47
"GGCACGTGTCTCAAGT",1,21,7,2,36,67,1988
"GGCAGTCAGAGTTGAT",0,0,0,0,0,0,20
"GGCAGTCAGCCATCCG",2,11,18,2,4,37,712
"GGCAGTCAGCGGTAAC",11,45,27,7,100,190,5037
"GGCAGTCCATCGCTCT",2,36,3,0,0,41,1198
"GGCAGTCGTTATTCCT",0,4,0,0,0,4,6
"GGCAGTCTCAAGCCAT",0,4,0,0,0,4,46
"GGCAGTCTCATTCCTA",0,0,0,0,0,0,8
"GGCGTCAAGGAAGTCC",1,4,4,0,0,9,130
"GGCGTCACAACTTGCA",2,17,5,0,2,26,706
"GGCGTCAGTTTCGATG",0,2,0,0,0,2,14
"GGCGTCATCTCGTCGT",0,3,0,0,0,3,22
"GGCGTCATCTTCGTAT",1,10,0,0,0,11,32
"GGCTGTGAGCCGCACT",0,9,0,0,0,9,139
"GGCTGTGCAAGCCATT",34,141,268,15,180,638,21350
"GGCTGTGCACAATGCT",25,208,37,15,30,315,10131
"GGCTGTGCACCCAAGC",0,0,0,0,0,0,14
"GGCTGTGGTGTTGAGG",1,0,0,0,0,1,44
"GGCTGTGTCATTTACC",0,2,3,0,0,5,54
"GGCTGTGTCTTGGTCC",1,6,2,0,0,9,78
"GGCTTGGAGAGGCTGT",0,0,0,0,0,0,4
"GGCTTGGAGTCACTAC",0,0,0,0,0,0,71
"GGCTTGGAGTCTGTAC",0,3,0,0,0,3,63
"GGCTTGGGTCCCTGAG",0,4,0,0,0,4,49
"GGCTTGGGTCGCATCG",1,3,0,0,0,4,16
"GGCTTGGTCATGCGGC",0,2,0,0,0,2,15
"GGCTTGGTCATTGGTG",0,0,0,0,0,0,5
"GGCTTGGTCGGCGATC",1,14,4,0,2,21,250
"GGCTTTCAGACCACGA",0,6,0,0,0,6,61
"GGCTTTCAGAGAGCGG",0,11,4,3,5,23,330
"GGCTTTCAGTGCAACG",0,0,0,0,0,0,2
"GGCTTTCCACCTCAGG",34,327,80,9,51,501,16030
"GGCTTTCCATTACTCT",3,25,5,0,5,38,274
"GGCTTTCGTGCACGCT",26,43,16,4,8,97,1849
"GGCTTTCTCAAAGACA",0,6,0,0,3,9,43
"GGCTTTCTCAACTACG",0,0,0,0,0,0,126
"GGCTTTCTCGGAGTAG",0,5,2,0,3,10,36
"GGCTTTCTCTCAACGA",3,15,3,0,5,26,33
"GGCTTTCTCTCCACTG",2,13,7,2,3,27,534
"GGCTTTCTCTCCGTGT",45,126,245,16,173,605,17138
"GGGAAGTAGAGTTCGG",4,18,3,0,5,30,297
"GGGAAGTAGTATTGCC",0,2,4,0,0,6,28
"GGGAAGTCACAGTCAT",226,1324,368,76,231,2225,94901
"GGGAAGTCAGCTTTGA",3,9,5,0,3,20,426
"GGGAAGTGTGGTCTAT",0,6,0,0,0,6,43
"GGGAAGTGTTGGGATG",1,20,7,2,0,30,344
"GGGAAGTTCAACCGAT",1,10,0,0,0,11,496
"GGGAAGTTCACCCTGT",0,4,0,0,0,4,99
"GGGAAGTTCACCGGTG",0,0,0,0,0,0,11
"GGGAAGTTCGGACGTC",1,16,6,0,3,26,551
"GGGACAAAGCTGTTAC",76,761,164,38,123,1162,52689
"GGGACAAAGCTTTGTG",1,2,0,0,0,3,47
"GGGACAAGTACTCGCG",1,3,0,0,0,4,49
"GGGACAAGTATACAGA",4,10,2,0,0,16,349
"GGGACAAGTCTTCCGT",2,15,2,2,2,23,737
"GGGACAAGTGCTTATG",1,8,0,0,2,11,81
"GGGACAAGTTAATGAG",0,0,0,0,0,0,29
"GGGACCTAGCTATCTG",3,18,4,3,11,39,850
"GGGACCTAGGCTCACC",3,14,2,0,0,19,562
"GGGACCTAGGTGCTTT",4,7,0,0,0,11,283
"GGGACCTAGTACAACA",1,6,0,0,0,7,158
"GGGACCTAGTGAGGTC",1,3,0,0,4,8,324
"GGGACCTCACACTGGC",0,3,0,0,0,3,146
"GGGACCTCAGGGAGAG",1,3,0,0,0,4,86
"GGGACCTGTGAGGAAA",7,39,9,2,9,66,1469
"GGGACCTGTTCGTGCG",1,0,0,0,0,1,28
"GGGACCTTCATTGTTC",1,8,0,0,0,9,48
"GGGACCTTCTCATGCC",0,3,0,0,0,3,184
"GGGACTCAGGCTTAAA",0,5,0,0,0,5,79
"GGGACTCCACTACCCT",4,16,18,3,6,47,906
"GGGACTCCAGGCGATA",0,3,2,0,0,5,78
"GGGACTCCATCGGTTA",29,120,28,7,18,202,8328
"GGGACTCGTGACAACG",0,0,0,0,0,0,34
"GGGACTCGTTGCATGT",1,2,0,0,0,3,134
"GGGACTCTCACACCGG",0,5,0,0,0,5,142
"GGGACTCTCACGAGGA",0,0,0,0,0,0,14
"GGGACTCTCGTGGACC",0,4,2,0,0,6,186
"GGGAGATGTCGGCCTA",0,4,0,0,0,4,78
"GGGAGATGTTAGCTAC",5,39,7,3,5,59,863
"GGGAGATTCAACCCGG",0,0,0,0,0,0,4
"GGGAGATTCAAGCTGT",1,0,0,0,0,1,12
"GGGAGTAAGTGAGCCA",461,418,181,42,116,1218,40806
"GGGAGTACACTATGTG",1,3,2,0,0,6,169
"GGGAGTAGTATTTCTC",2,10,3,0,3,18,104
"GGGAGTAGTCAGCGTC",0,3,0,0,0,3,55
"GGGAGTAGTCGAAGCA",1,3,0,0,0,4,172
"GGGAGTAGTGGATACG",0,3,0,0,0,3,30
"GGGAGTATCATAGACC",0,3,3,0,0,6,161
"GGGAGTATCGTGGTAT",12,109,34,2,22,179,7844
"GGGAGTATCTGACAGT",27,201,46,12,36,322,11213
"GGGATCCAGAACTTCC",82,66,25,10,22,205,6653
"GGGATCCAGGCCCGTT",0,6,2,0,0,8,209
"GGGATCCAGTGGAATT",0,5,2,0,0,7,129
"GGGATCCAGTGTTCCA",1,5,0,0,0,6,57
"GGGATCCCATGGAGAC",6,39,10,0,9,64,2025
"GGGATCCGTTACACAC",0,6,0,0,2,8,153
"GGGATCCGTTAGAGTA",6,19,3,2,7,37,432
"GGGATCCTCACGGGCT",0,4,0,0,0,4,63
"GGGATCCTCATCGTAG",7,18,5,0,17,47,1557
"GGGATCCTCGTAGGGA",0,4,0,0,0,4,99
"GGGATGAAGCCGGAAT",0,4,0,0,0,4,45
"GGGATGAAGCTCGAAG",21,54,32,8,122,237,8662
"GGGATGACACAAAGCG",3,21,7,0,0,31,345
"GGGATGACATAATCCG",3,21,6,0,2,32,599
"GGGATGACATGACTTG",0,2,0,0,0,2,14
"GGGATGAGTAGGGAGG",271,2273,521,132,382,3579,177457
"GGGATGAGTCGTTTCC",0,0,0,0,0,0,4
"GGGCCATAGCACTAAA",22,135,30,16,23,226,7138
"GGGCCATAGGATAATC",0,0,0,0,0,0,19
"GGGCCATGTTTACGAC",1,0,0,0,0,1,92
"GGGCCATTCACCTCAC",1,15,4,0,4,24,1094
"GGGCGTTAGGCTCAAG",45,122,167,18,197,549,22618
"GGGCGTTCAAAGGAGA",0,0,0,0,0,0,6
"GGGCGTTCACGAGGTA",99,725,178,42,133,1177,47517
"GGGCGTTGTCTCAAGT",1,12,5,0,5,23,317
"GGGCGTTGTTTCGATG",0,4,2,0,0,6,29
"GGGCGTTTCTGGTTGA",0,3,0,0,3,6,48
"GGGCGTTTCTTAGTTC",1,24,6,0,2,33,471
"GGGCTACAGAGAGGGC",1,10,4,0,0,15,296
"GGGCTACCAGACCAAG",0,7,0,0,0,7,67
"GGGCTACGTCCTCAGG",1,4,0,0,0,5,179
"GGGCTACGTCTTCCGT",0,2,2,0,0,4,130
"GGGCTACGTTGAGAGC",0,4,0,0,2,6,110
"GGGCTCAAGACCTCAT",1,3,2,0,0,6,168
"GGGCTCAAGCGACTGA",0,0,0,0,0,0,8
"GGGCTCAAGCGGCTCT",0,3,0,0,0,3,39
"GGGCTCAAGTTGGGAC",0,4,0,0,0,4,115
"GGGCTCACACCTGATA",0,0,0,0,0,0,13
"GGGCTCACACTCACTC",0,3,0,0,0,3,52
"GGGCTCAGTTAACAGA",133,921,345,61,163,1623,66332
"GGGCTCAGTTGCGTAT",11,45,29,5,69,159,5978
"GGGCTCATCAGACCTA",21,41,11,2,6,81,3058
"GGGCTCATCCGATAAC",1,4,2,0,0,7,108
"GGGCTCATCGCTCCTA",0,5,3,0,0,8,43
"GGGCTCATCTCGGTCT",0,4,0,0,0,4,129
"GGGTAGAAGCAACTTC",5,21,10,0,5,41,468
"GGGTAGAAGCACACCC",0,4,0,0,0,4,266
"GGGTAGAAGCACTCTA",0,3,0,0,0,3,7
"GGGTAGACACGCGCTA",99,245,610,38,174,1166,53994
"GGGTAGACAGCACCCA",18,51,33,8,108,218,7090
"GGGTAGACATACCGTA",0,0,0,0,0,0,13
"GGGTAGACATGCACTA",0,3,2,0,0,5,103
"GGGTAGAGTATCGCAT",14,61,23,3,36,137,5118
"GGGTAGATCCACGGAC",1,20,6,0,4,31,606
"GGGTAGATCTGTGTGA",16,24,7,2,6,55,1327
"GGGTATTAGCGATTCT",0,3,0,0,0,3,61
"GGGTATTAGTAGATCA",2,19,9,2,3,35,427
"GGGTATTCACATTACG",1,5,0,0,0,6,178
"GGGTATTGTAGAGACC",1,13,3,2,2,21,142
"GGGTATTGTCGACGCT",0,14,0,0,2,16,351
"GGGTATTTCTCCTGCA",0,6,2,0,0,8,125
"GGGTATTTCTTGAGCA",0,0,0,0,0,0,6
"GGGTCACAGCAACAAT",0,0,0,0,0,0,142
"GGGTCACCACAAGTTC",3,11,3,0,0,17,292
"GGGTCACCAGTCCGTG",0,8,2,2,4,16,361
"GGGTCACGTAATGCTC",38,117,283,13,48,499,22810
"GGGTCACTCAGCACCG",45,80,34,5,16,180,5919
"GGGTCTGAGAGTCAGC",2,4,0,0,0,6,46
"GGGTCTGAGGTAGCAC",3,25,10,2,4,44,514
"GGGTCTGAGTCTACCA",9,107,25,5,18,164,7531
"GGGTCTGCAGCACAAG",0,0,0,0,0,0,13
"GGGTCTGCAGTTTGGT",1,9,3,0,0,13,228
"GGGTCTGCATGCGGTC",0,0,0,0,0,0,7
"GGGTCTGGTCTATGAC",0,7,4,0,2,13,406
"GGGTGAAAGCCGTTGC",450,182,106,28,87,853,31221
"GGGTGAACATTAAGCC",0,0,0,0,0,0,7
"GGGTGAAGTGGACTGA",8,59,15,2,6,90,3106
"GGGTGAATCAATCTCT",0,2,0,0,0,2,24
"GGGTGAATCGACCAAT",46,127,215,27,140,555,20981
"GGGTGTCAGCTTAGTC",2,4,2,0,4,12,223
"GGGTGTCCAGCATTGT",0,6,2,0,2,10,94
"GGGTGTCCAGTGGTGA",1,6,2,0,0,9,77
"GGGTGTCCATCGTTCC",1,7,2,0,2,12,112
"GGGTGTCGTACGACAG",1,24,5,0,4,34,495
"GGGTGTCTCGATACAC",0,25,4,0,2,31,691
"GGGTGTCTCTTCGGAA",2,4,2,0,0,8,91
"GGGTTATAGATGCTGG",1,8,2,0,4,15,373
"GGGTTATAGCTGAAGC",7,45,27,0,41,120,4561
"GGGTTATCAGTTCCAA",1,0,0,0,0,1,165
"GGGTTATGTAGGTCAG",1,4,0,0,2,7,93
"GGGTTATGTGCGACAA",0,7,2,0,0,9,192
"GGGTTTAAGAGAGGTA",6,41,17,4,8,76,2464
"GGGTTTAAGAGCAGCT",0,0,0,0,0,0,2
"GGGTTTAAGCAATTAG",1,2,0,0,0,3,57
"GGGTTTACAAAGTGTA",0,0,0,0,0,0,7
"GGGTTTACACCAGTAT",0,2,0,0,0,2,51
"GGGTTTAGTCGGATTT",0,12,8,2,0,22,264
"GGGTTTATCAACGCTA",0,8,0,0,0,8,77
"GGGTTTATCTCCGTGT",1,9,0,0,2,12,180
"GGTAACTCACGCTTAA",0,2,4,0,0,6,123
"GGTAACTCAGACCCGT",1,4,0,0,0,5,163
"GGTAACTGTCCTACGG",1,6,3,0,2,12,152
"GGTAACTGTGATAGTA",0,0,0,0,0,0,5
"GGTAACTGTGGACCTC",0,3,0,0,0,3,31
"GGTAACTGTTCTGACA",2,18,4,0,3,27,346
"GGTAACTGTTGGTGTT",0,10,3,0,2,15,382
"GGTAATCCACTCAGAT",4,29,29,5,5,72,1850
"GGTAATCGTCGCTGCA",4,14,7,0,10,35,681
"GGTAATCGTTCACCGG",0,0,0,0,0,0,55
"GGTAATCGTTTGGAGG",1,5,0,0,0,6,112
"GGTAATCTCACTTATC",1,0,2,0,0,3,19
"GGTAATCTCCCGTTCA",0,6,0,0,0,6,154
"GGTAATCTCGATCCCT",1,3,0,0,0,4,62
"GGTAGAGAGGCGCTTC",0,4,0,0,0,4,57
"GGTAGAGCACTACGGC",0,4,3,0,0,7,96
"GGTAGAGGTAGCGAGT",7,25,48,3,6,89,2881
"GGTAGAGGTGATAGAT",1,20,6,2,3,32,699
"GGTAGAGTCAGAGTTC",1,22,7,0,2,32,504
"GGTAGAGTCTATGTGG",1,3,0,0,0,4,21
"GGTCACGAGAGAGCGG",4,19,8,0,0,31,572
"GGTCACGAGCCAAGTG",1,0,0,0,0,1,19
"GGTCACGCAACAACAA",0,3,0,0,0,3,5
"GGTCACGCAATTTCGG",0,3,0,0,0,3,49
"GGTCACGTCCTACCGT",0,3,2,0,0,5,146
"GGTCACGTCGTGACTA",1,2,0,0,0,3,10
"GGTCTGGCAAATGAAC",2,6,0,0,0,8,153
"GGTCTGGCATATCTGG",0,4,0,0,2,6,37
"GGTCTGGTCTCTCGCA",3,4,0,0,0,7,277
"GGTGAAGAGAAGTATC",0,3,0,0,0,3,34
"GGTGAAGAGCGCAATG",0,3,2,0,0,5,198
"GGTGAAGAGTTGAAAC",3,25,10,0,7,45,793
"GGTGAAGCATGCGGTC",1,5,0,0,2,8,102
"GGTGAAGGTACGGCAA",0,2,0,0,0,2,27
"GGTGAAGGTAGAATAC",0,4,0,0,0,4,26
"GGTGAAGGTGACACGA",5,30,45,4,13,97,3185
"GGTGAAGGTGTTTCTT",2,16,4,0,2,24,450
"GGTGAAGTCACACGAT",4,14,4,4,6,32,343
"GGTGAAGTCTAAGAAG",0,12,4,0,0,16,176
"GGTGATTAGCTCGACC",1,2,0,0,0,3,21
"GGTGATTAGCTGCCAC",2,14,4,0,3,23,380
"GGTGATTCAGATGCGA",3,4,3,0,8,18,915
"GGTGATTCATAATGAG",16,71,69,7,89,252,10748
"GGTGATTCATTGAGCT",0,5,3,0,0,8,94
"GGTGATTGTTCAGTAC",118,59,40,11,22,250,8843
"GGTGATTTCGCTGCGA",0,2,3,0,0,5,252
"GGTGATTTCTCCAATT",41,118,252,19,71,501,23497
"GGTGGCTAGAAGGGAT",1,5,3,0,3,12,25
"GGTGGCTCACTCAGAT",0,6,3,0,0,9,131
"GGTGGCTCAGGTGTTT",2,6,2,0,2,12,208
"GGTGGCTCAGGTTCAT",0,10,0,0,0,10,153
"GGTGGCTCATTACTCT",0,2,0,0,0,2,44
"GGTGGCTGTGACCGTC",5,45,12,5,19,86,2213
"GGTGGCTGTTCCGGTG",1,13,4,4,4,26,346
"GGTGGCTGTTGTGTTG",3,21,6,0,4,34,1486
"GGTGTCGAGGCACTCC",0,17,0,0,3,20,460
"GGTGTCGCAACTACGT",0,12,0,0,0,12,197
"GGTGTCGCAGTCAACT",11,37,13,5,36,102,2883
"GGTGTCGGTCTGTCAA",8,22,26,0,6,62,2819
"GGTGTCGGTTTGGGAG",0,3,0,0,0,3,64
"GGTGTCGTCAGGGTAG",0,2,0,0,0,2,73
"GGTGTCGTCATCCTAT",51,131,37,18,21,258,7668
"GGTGTCGTCCGGTTCT",0,0,0,0,0,0,0
"GGTGTCGTCGGAGCAA",1,3,0,0,0,4,143
"GGTGTTAAGATAACGT",1,3,6,0,0,10,106
"GGTGTTACACAAATAG",1,11,9,0,4,25,685
"GGTGTTACAGAACTCT",2,27,5,0,4,38,474
"GGTGTTAGTGTAACGG",14,39,57,2,9,121,5114
"GGTGTTATCGGTCAGC",0,5,0,0,0,5,93
"GGTTAACGTAGTCCTA",8,46,36,3,51,144,6406
"GGTTCTCAGACCCTTA",0,6,5,0,2,13,177
"GGTTCTCAGAGCAGAA",1,5,2,0,3,11,90
"GGTTCTCAGATCACTC",4,16,3,0,7,30,657
"GGTTCTCAGCACGGAT",1,17,5,0,3,26,314
"GGTTCTCAGGAGTACC",10,39,39,5,8,101,3049
"GGTTCTCAGTATGGAT",0,0,0,0,0,0,49
"GGTTCTCCAATGCAGG",99,859,181,46,130,1315,57397
"GGTTCTCTCACTGCTC",0,3,0,0,0,3,65
"GGTTCTCTCCTGGGAC",0,6,0,0,3,9,282
"GGTTCTCTCGCTAGCG",1,0,2,0,0,3,118
"GGTTGTAAGCGTGTCC",1,17,3,0,2,23,636
"GGTTGTACAAACTCTG",1,5,8,0,0,14,394
"GGTTGTACAGGGATAC",92,384,116,26,77,695,25345
"GGTTGTAGTGGGACAT",7,13,19,0,10,49,2776
"GGTTGTATCGGCCAAC",1,2,2,0,0,5,39
"GGTTGTATCGTACACA",1,5,0,0,0,6,109
"GTAACACAGAAGCGCT",23,154,63,11,167,418,20036
"GTAACACCAAGGACAC",19,86,103,6,20,234,11307
"GTAACACCAGCGTTGC",0,0,0,0,0,0,6
"GTAACACGTTGCTCAA",0,4,0,0,0,4,10
"GTAACACTCACCGACG",0,8,0,0,0,8,121
"GTAACACTCTGCACCT",1,10,3,0,0,14,497
"GTAACCACAAGTCCCG",1,0,0,0,0,1,75
"GTAACCACAATAACGA",0,0,0,0,0,0,28
"GTAACCACACTGCGAC",0,0,0,0,0,0,45
"GTAACCACATGGGTTT",0,4,0,0,2,6,126
"GTAACCAGTCACTCTC",4,33,6,2,7,52,997
"GTAACCAGTGCCTACG",1,0,0,0,2,3,108
"GTAACCATCCATTCGC",19,56,107,4,25,211,9723
"GTAACCATCGCGATCG",1,27,6,0,3,37,488
"GTAACCATCGTAACTG",99,735,191,44,129,1198,55817
"GTAAGTCAGCCGCTTG",1,5,0,0,0,6,215
"GTAAGTCAGCGCATCC",3,18,2,0,0,23,35
"GTAAGTCAGCTCGAAG",1,14,5,0,3,23,363
"GTAAGTCAGGGACTGT",0,6,2,0,2,10,168
"GTAAGTCCACTCAAGT",1,7,3,0,3,14,107
"GTAAGTCCATCGGAAG",0,5,0,0,0,5,97
"GTAAGTCCATCGTGCG",1,4,0,0,0,5,127
"GTAAGTCGTACAGAAT",1,9,0,0,3,13,119
"GTAAGTCGTCGCACGT",1,15,3,0,2,21,730
"GTAAGTCGTCGGTAAG",2,3,0,0,0,5,34
"GTAAGTCGTGAGATCG",0,7,8,0,0,15,515
"GTAAGTCTCAACTCTT",3,14,5,0,0,22,149
"GTAAGTCTCAAGCCTA",0,2,0,2,0,4,243
"GTAATCGAGCGTTGTT",0,3,2,0,0,5,82
"GTAATCGCAAAGGCTG",0,2,0,0,0,2,12
"GTAATCGCAAGAATGT",0,4,2,0,0,6,81
"GTAATCGCACCAGCTG",0,4,0,0,0,4,110
"GTAATCGCACGGATCC",1,4,0,0,0,5,213
"GTAATCGCATGCTGCG",148,986,283,87,198,1702,87626
"GTAATCGGTAGGCTCC",4,30,5,0,5,44,469
"GTAATCGGTTAGGAGC",1,19,6,0,7,33,671
"GTAATCGTCATTGTTC",0,3,0,0,0,3,66
"GTAATGCAGCCTGAAG",0,5,3,0,0,8,117
"GTAATGCAGCTGAGTG",0,0,0,0,2,2,8
"GTAATGCCACACGTGC",0,3,0,0,0,3,64
"GTAATGCGTACGTGAG",15,51,79,4,16,165,8074
"GTAATGCGTGACGTCC",0,0,0,0,0,0,8
"GTAATGCGTGGGAGAG",0,5,3,0,2,10,156
"GTAATGCGTTGACTGT",2,9,0,0,0,11,46
"GTAATGCTCAAGAATG",2,7,0,0,2,11,133
"GTACAACAGACATACA",5,34,17,0,29,85,2332
"GTACAACGTAGGAGGG",0,2,0,0,0,2,17
"GTACAACTCAACTACG",1,17,5,3,6,32,44
"GTACAACTCGAGTCTA",2,4,0,0,2,8,153
"GTACAACTCTCTCGCA",0,9,2,0,2,13,171
"GTACAGTCACAACGTT",1,2,0,0,5,8,533
"GTACAGTCACTCTAGA",6,35,2,2,3,48,736
"GTACAGTCAGCGTATT",4,22,8,2,2,38,1203
"GTACAGTCAGTTAAAG",1,12,3,0,2,18,236
"GTACAGTGTACTCGAT",0,2,0,0,0,2,104
"GTACAGTGTCCTCAGG",0,0,0,0,0,0,1
"GTACAGTGTCGGTACC",0,0,0,0,0,0,7
"GTACAGTGTGCTATTG",6,18,14,0,6,44,1026
"GTACAGTTCAGCCTCT",1,22,13,2,5,43,778
"GTACAGTTCTTACACT",2,23,9,0,5,39,542
"GTAGAAAAGCGGGTAT",3,11,2,0,0,16,166
"GTAGAAAAGTCACTCA",1,2,3,0,0,6,123
"GTAGAAACAGATCATC",0,8,0,0,0,8,151
"GTAGAAAGTCACTCAA",14,66,127,7,28,242,9439
"GTAGAAAGTCCACTTC",0,5,3,0,3,11,172
"GTAGAAAGTGTCCGTG",1,4,0,0,0,5,56
"GTAGAAATCTGGAGAG",6,51,61,5,17,140,7398
"GTAGAGGAGGCTTCCG",25,93,163,16,88,385,16351
"GTAGAGGCACTTGGCG",0,6,3,0,2,11,124
"GTAGAGGCATTAGGCT",67,470,131,34,83,785,39023
"GTAGAGGTCCTGATAG",78,257,165,29,464,993,44115
"GTAGAGGTCGCGAAGA",2,17,3,0,7,29,467
"GTAGAGGTCTCTGACC",0,16,2,0,3,21,569
"GTAGATCAGGCCTGAA",0,0,0,0,0,0,66
"GTAGATCCAAGCTGTT",0,5,0,0,0,5,109
"GTAGATCCAGGGTCTC",19,69,156,9,25,278,13926
"GTAGATCGTCTTCCGT",15,71,19,5,13,123,3654
"GTAGATCGTGGCTAGA",6,41,14,2,8,71,2478
"GTAGATCGTGGCTGCT",4,23,3,0,5,35,262
"GTAGATCTCGCGTTTC",0,4,0,0,0,4,57
"GTAGCTACAAAGCACG",22,72,36,14,141,285,11067
"GTAGCTACAAGACCGA",2,20,7,3,3,35,526
"GTAGCTACAAGCCATT",0,0,0,0,0,0,2
"GTAGCTACAAGGAGTC",10,34,42,2,6,94,4160
"GTAGCTACAATGAAAC",1,16,7,0,0,24,292
"GTAGCTAGTCCTTTGC",2,12,4,0,5,23,205
"GTAGCTAGTCTGTGCG",1,0,0,0,0,1,43
"GTAGCTAGTGTTCAGT",1,4,0,0,0,5,199
"GTAGCTATCGCTACAA",1,28,6,0,12,47,969
"GTAGCTATCTTCTCAA",55,328,106,25,79,593,25929
"GTAGGAGCAACACAAA",13,86,24,3,20,146,5330
"GTAGGAGCAAGTACCT",1,9,3,0,0,13,183
"GTAGGAGGTACAATAG",0,6,0,0,0,6,131
"GTAGGAGTCATTTGCT",1,15,3,0,0,19,168
"GTAGGTTAGATTGACA",2,19,4,2,10,37,84
"GTAGGTTCAGTAACCT",6,35,8,5,5,59,945
"GTAGGTTCATCTAGAC",6,15,6,0,4,31,591
"GTAGGTTCATGCAGGA",165,586,340,82,756,1929,84523
"GTAGGTTCATGGGCAA",1,14,2,3,5,25,456
"GTAGGTTGTATGTGTC",3,13,2,0,2,20,430
"GTAGGTTGTCGGCACT",3,12,9,0,0,24,370
"GTAGGTTGTGCAATAA",3,17,4,2,4,30,445
"GTAGTACAGCGGCTCT",8,57,26,4,84,179,6281
"GTAGTACAGCTTACGT",0,4,0,0,0,4,239
"GTAGTACAGTGTTCCA",2,5,3,0,0,10,94
"GTAGTACCAGAGTGAC",1,5,0,0,6,12,676
"GTAGTACCAGTCAGAG",1,4,0,0,0,5,118
"GTAGTACTCTTGCAAG",0,16,3,2,0,21,87
"GTATTGGCAGACAAAT",1,9,0,0,0,10,113
"GTATTGGTCCACGGAC",1,5,0,0,2,8,100
"GTATTGGTCTGGACCG",4,32,10,2,8,56,1563
"GTATTGGTCTTAAGGC",1,3,2,0,0,6,257
"GTATTGGTCTTCCAGC",0,2,0,0,0,2,83
"GTATTTCAGACTGGGT",5,9,2,0,4,20,436
"GTATTTCAGGGATGTC",2,23,5,2,0,32,738
"GTATTTCAGTGGTGGT",2,14,2,0,0,18,319
"GTATTTCCACATTACG",3,16,4,3,3,29,122
"GTATTTCCAGGGATAC",1,10,2,0,2,15,108
"GTATTTCGTCGTCATA",0,5,2,2,0,9,217
"GTATTTCGTGTTGCCG",0,10,3,0,0,13,254
"GTATTTCGTTGCCATA",2,9,4,0,0,15,303
"GTATTTCTCATCTACT",0,2,0,0,0,2,13
"GTATTTCTCGGATACT",1,12,6,0,0,19,301
"GTCAAACAGGGAACAA",2,8,4,0,3,17,325
"GTCAAACAGGTGCGAT",0,3,0,0,2,5,218
"GTCAAACAGTTTGAGA",2,12,3,0,4,21,396
"GTCAAACCACATATCG",1,20,5,0,0,26,445
"GTCAAACCATACAGCT",3,31,8,2,4,48,687
"GTCAAACGTATTGCCA",2,19,4,0,4,29,536
"GTCAAACGTCGAAGCA",12,45,19,4,13,93,2585
"GTCAAACGTGATGTAA",0,5,0,0,0,5,77
"GTCAAACTCAGTCCGG",0,4,2,0,2,8,255
"GTCAAACTCGGATAAA",1,21,5,0,2,29,257
"GTCAAACTCGGTCGAC",0,2,3,0,0,5,122
"GTCAAACTCTGCCTGT",1,22,8,2,7,40,628
"GTCAAACTCTGTTCAT",1,6,0,0,3,10,117
"GTCAAACTCTTCGGTC",0,2,0,0,0,2,56
"GTCAAACTCTTGGTCC",3,9,3,0,2,17,64
"GTCAAGTAGCCGTCGT",2,9,4,0,2,17,207
"GTCAAGTAGCTTTCCC",0,2,0,0,0,2,104
"GTCAAGTAGTTCTACG",10,31,38,3,12,94,2912
"GTCAAGTCACAAAGCG",6,20,12,0,30,68,2677
"GTCAAGTCAGAATCGG",1,5,0,0,0,6,92
"GTCAAGTCAGAGTTCT",4,29,17,2,7,59,1185
"GTCAAGTCAGTGGTGA",50,416,94,29,74,663,23324
"GTCAAGTGTCGGAACA",0,0,0,0,0,0,4
"GTCAAGTGTGAGTAGC",2,25,4,0,3,34,424
"GTCAAGTGTGGTAACG",2,2,2,0,0,6,87
"GTCAAGTTCAACGCTA",0,16,3,0,5,24,396
"GTCAAGTTCATCACAG",0,4,2,0,0,6,89
"GTCAAGTTCGGTCTAA",0,7,0,0,0,7,92
"GTCAAGTTCTTGAACG",5,27,5,0,0,37,456
"GTCACGGAGGCGCTCT",27,228,39,8,27,329,11901
"GTCACGGCAACTAGAA",108,523,413,73,369,1486,53959
"GTCACGGCATGAAGGC",1,0,2,0,0,3,40
"GTCACGGCATGGGTTT",0,3,0,0,0,3,65
"GTCACGGGTTCTATCT",2,12,5,0,3,22,73
"GTCACGGGTTGGGTAG",1,2,0,0,0,3,77
"GTCACGGTCCTCATAT",4,16,7,0,6,33,460
"GTCACTCAGTCATACC",0,4,0,0,0,4,65
"GTCACTCAGTTGGAAT",0,27,6,3,4,40,408
"GTCACTCCAACTCATG",5,3,3,0,0,11,509
"GTCACTCGTTGTGCAT",0,3,2,0,0,5,99
"GTCAGCGAGAAGTATC",0,0,3,0,0,3,141
"GTCAGCGCAAGGTACG",0,6,0,0,0,6,80
"GTCATCCCAATCCAGT",0,4,4,0,0,8,361
"GTCATCCCAATGTTGC",2,2,0,0,2,6,147
"GTCATCCCAGCAGTGA",0,2,2,0,0,4,30
"GTCATCCTCCGTGGCA",1,8,0,0,3,12,184
"GTCATCCTCGTCGATA",2,7,2,0,0,11,145
"GTCATGAAGAGGGTCT",0,2,0,0,0,2,6
"GTCATGAAGAGTTGAT",0,2,0,0,0,2,12
"GTCATGACAGAGGGTT",0,0,0,0,0,0,20
"GTCATGAGTACCCAGC",0,0,0,0,0,0,77
"GTCATGAGTCTTCCGT",1,7,3,0,0,11,277
"GTCATGAGTTGCAAGG",0,0,0,0,0,0,47
"GTCATGAGTTTGGAAA",10,71,105,5,19,210,5826
"GTCATTTAGAGGTGCT",1,9,0,0,0,10,78
"GTCATTTAGTACAGAT",0,4,0,0,0,4,138
"GTCATTTCAACCCGCA",0,0,0,0,0,0,6
"GTCATTTCAAGCCCAC",2,33,15,2,8,60,747
"GTCATTTCAGTCGTTA",29,92,136,16,128,401,15825
"GTCATTTCATGGTGGA",0,5,4,0,0,9,208
"GTCATTTTCTTGATTC",44,307,75,15,49,490,18831
"GTCCACTAGAATCCCT",20,77,45,16,151,309,13842
"GTCCACTAGTGCAAAT",0,2,0,0,0,2,5
"GTCCACTCAACCAATC",65,529,122,26,86,828,36097
"GTCCACTCACTTCCTG",14,43,27,5,66,155,6900
"GTCCACTCATATGAAG",10,92,26,3,14,145,6169
"GTCCACTCATCGCTGG",24,182,81,14,39,340,14137
"GTCCACTGTAAGATAC",0,0,0,0,0,0,79
"GTCCACTGTATCCCTC",0,3,3,0,0,6,58
"GTCCACTGTATCCTCC",1,23,8,0,4,36,828
"GTCCACTGTATCGTTG",1,26,4,0,2,33,403
"GTCCACTGTGTATTGC",1,15,3,0,3,22,330
"GTCCACTTCACCCTGT",1,18,9,4,2,34,707
"GTCCACTTCCAAGCCG",2,12,7,0,2,23,41
"GTCCCATAGCAAATGT",0,0,0,0,0,0,134
"GTCCCATAGTAGCCAG",1,9,3,0,0,13,215
"GTCCCATCATGTGGTT",8,32,9,3,4,56,2843
"GTCCCATGTCGTTCAA",1,9,6,0,6,22,719
"GTCCCATGTGATTCTG",0,0,0,0,0,0,4
"GTCCCATGTTATAGCC",2,21,6,2,0,31,253
"GTCCCATTCCCGAACG",0,0,0,0,0,0,34
"GTCCCATTCGTCGGGT",1,6,3,0,2,12,360
"GTCCCATTCTTAGCTT",0,2,3,0,2,7,55
"GTCCTCAAGCATTGAA",0,0,0,0,0,0,20
"GTCCTCAAGCGAACTG",0,20,4,0,4,28,1305
"GTCCTCACAATCACGT",0,4,0,0,0,4,82
"GTCCTCACAGGATCTT",0,5,0,0,0,5,122
"GTCCTCAGTTGTCAGT",4,16,9,0,2,31,550
"GTCGAATAGCAATAAC",1,4,0,0,0,5,32
"GTCGAATCAAATCAGA",0,0,0,0,0,0,14
"GTCGAATGTGGTTTGT",0,5,3,0,0,8,179
"GTCGAATTCCATCCGT",0,2,0,0,0,2,31
"GTCGAATTCGGCTATA",4,17,2,2,4,29,541
"GTCGAATTCTGAATGC",14,52,80,4,25,175,7171
"GTCGCGAAGGCCTAAG",0,0,0,0,0,0,25
"GTCGCGAAGTTCGGTT",14,52,29,9,78,182,5320
"GTCGCGACAGTCTCTC",0,0,2,0,0,2,205
"GTCGCGAGTCCGCAGT",0,4,0,0,0,4,95
"GTCGCGAGTTCTGAGT",0,3,0,2,0,5,40
"GTCGCGATCACATTGG",1,3,2,0,0,6,48
"GTCGCGATCATGGTAC",112,89,34,9,64,308,10662
"GTCGCGATCCTCGATC",0,4,0,0,0,4,68
"GTCGCGATCCTGTACC",14,37,31,5,52,139,4100
"GTCGCGATCTAACGGT",0,2,2,0,0,4,138
"GTCGTAAAGTAGACAT",1,3,0,0,2,6,76
"GTCGTAAAGTTGCATC",1,35,14,0,11,61,653
"GTCGTAACACTCCGAG",0,2,0,0,0,2,10
"GTCGTAACATGTCTAG",11,37,18,0,60,126,4936
"GTCGTAAGTCGCTCGA",64,631,139,28,88,950,35507
"GTCGTAAGTGACACAG",136,973,321,49,181,1660,53517
"GTCGTAATCCCGTGTT",3,23,5,0,3,34,442
"GTCGTAATCGCTTAAG",6,59,13,0,8,86,2573
"GTCGTAATCTCGAACA",1,0,0,0,2,3,72
"GTCGTTCAGCACTCAT",0,17,8,0,3,28,265
"GTCGTTCAGGACAGTC",16,65,107,8,76,272,10023
"GTCGTTCCACGTACTA",0,0,0,0,0,0,30
"GTCGTTCCAGAGAAAG",2,22,25,0,5,54,1911
"GTCGTTCCAGCACGAA",0,19,2,0,0,21,276
"GTCGTTCGTCCACTTC",60,79,16,7,10,172,4947
"GTCGTTCGTGAACTAA",2,18,3,0,15,38,935
"GTCGTTCTCAGTCAGT",1,0,0,0,0,1,34
"GTCGTTCTCTATCGCC",2,5,0,0,0,7,57
"GTCTACCCACACGCCA",0,6,2,0,0,8,236
"GTCTACCCAGTTCACA",0,6,2,0,0,8,172
"GTCTACCCATAGGTAA",48,428,93,19,72,660,32434
"GTCTACCGTACGTAGG",5,13,10,3,17,48,1777
"GTCTACCGTATTGCCA",2,7,3,0,3,15,167
"GTCTACCGTTAAACAG",24,195,61,66,33,379,16310
"GTCTACCTCAAGATAG",4,25,6,2,5,42,385
"GTCTACCTCCCGGTAG",0,3,2,0,2,7,118
"GTCTACCTCGCGTGCA",1,6,2,2,3,14,266
"GTCTACCTCGTCCATC",0,0,0,0,0,0,10
"GTCTACCTCTAAGCCA",1,5,4,0,0,10,125
"GTCTAGACAAATCAAG",3,8,0,0,0,11,130
"GTCTAGACACAAGTGG",1,4,0,0,0,5,52
"GTCTAGAGTACGGTTT",0,0,0,0,0,0,6
"GTCTAGAGTCTGTAAC",2,11,4,0,0,17,134
"GTCTAGAGTGTCTCCT",1,14,4,2,3,24,462
"GTCTAGATCCGCGATG",2,0,3,0,0,5,78
"GTCTCACAGACATATG",2,10,3,0,0,15,103
"GTCTCACCAATCACGT",0,4,0,0,2,6,128
"GTCTCACCACCCTATC",168,196,57,17,55,493,17000
"GTCTCACCACGTCTCT",1,2,0,2,0,5,196
"GTCTCACTCGTGGCGT",1,2,0,0,2,5,90
"GTCTGTCAGCATCCTA",0,9,2,0,0,11,481
"GTCTGTCAGCTCCACG",0,0,0,0,0,0,7
"GTCTGTCCAGGGTCTC",1,10,0,0,2,13,339
"GTCTGTCGTCTGTCCT",1,16,3,3,3,26,485
"GTCTGTCGTGGGTCAA",1,0,0,0,0,1,72
"GTCTGTCTCATTTCGT",0,6,0,0,2,8,386
"GTCTGTCTCCAATCCC",14,43,95,6,17,175,6719
"GTCTGTCTCCGTAGGC",3,16,4,2,0,25,778
"GTCTGTCTCGGCATAT",1,6,4,0,0,11,223
"GTCTGTCTCTAGACAC",1,14,6,3,4,28,553
"GTCTGTCTCTATCGTT",1,11,4,0,0,16,205
"GTCTTTAAGAGAGGTA",0,2,0,0,0,2,26
"GTCTTTAAGCTCGCAC",3,22,2,0,2,29,762
"GTCTTTAAGGAACGAA",2,36,10,2,2,52,517
"GTCTTTACAACTCATG",0,3,2,4,0,9,121
"GTCTTTACACCCTGAG",0,4,0,0,0,4,138
"GTCTTTACACCGCTAG",0,7,0,0,0,7,89
"GTCTTTAGTCGGAACA",3,28,12,7,21,71,2145
"GTGACGCAGCACTCTA",9,39,63,5,15,131,5853
"GTGACGCCAAGCTCTA",1,7,2,0,0,10,25
"GTGACGCCAAGTTCCA",1,5,3,0,0,9,94
"GTGACGCCAGGTTTAC",0,3,0,0,2,5,32
"GTGACGCCAGTGTATC",3,26,3,0,7,39,869
"GTGACGCCATCGAGCC",1,19,7,2,0,29,666
"GTGACGCCATGACCCG",1,5,0,2,0,8,157
"GTGACGCGTAGCCCTG",1,2,2,0,0,5,69
"GTGACGCGTCAAGCCC",1,21,9,2,0,33,1750
"GTGACGCGTCTAGGTT",0,5,0,0,0,5,80
"GTGACGCTCTATACGG",0,3,2,0,0,5,77
"GTGAGCCAGGCAGGTT",12,88,23,3,17,143,5904
"GTGAGCCCACCAGTAT",6,47,21,3,8,85,4020
"GTGAGCCCAGAGATTA",61,432,104,30,86,713,30401
"GTGAGCCCATACAGGG",0,5,0,0,0,5,617
"GTGAGCCGTACTCAAC",0,8,4,0,0,12,312
"GTGAGGACAAGTGGGT",61,88,25,2,20,196,8276
"GTGAGGAGTAGGAAAG",0,0,0,0,0,0,10
"GTGAGGAGTGATATAG",0,0,0,0,0,0,5
"GTGAGGATCCCTTCCC",3,16,10,0,2,31,474
"GTGAGGATCGGTAGAG",1,11,2,2,4,20,523
"GTGAGTTAGGCGTTGA",19,128,34,6,25,212,11273
"GTGAGTTCAGAGCCCT",5,39,13,2,5,64,1005
"GTGAGTTCAGAGCTAG",0,2,0,0,0,2,12
"GTGAGTTGTACGCTTA",1,9,0,0,0,10,142
"GTGAGTTGTTACTCAG",0,0,3,0,0,3,314
"GTGAGTTTCATCGTAG",1,3,4,0,0,8,430
"GTGAGTTTCGAACTCA",0,3,0,0,0,3,146
"GTGAGTTTCGTGGGAA",1,2,2,0,0,5,195
"GTGATGTAGTCAGGGT",0,4,0,0,0,4,143
"GTGATGTCAAACTAAG",0,0,0,0,0,0,9
"GTGATGTCACAGTACT",15,87,22,5,17,146,7156
"GTGATGTCAGCGACCT",0,21,3,0,4,28,505
"GTGATGTGTTGATGTC",0,7,0,0,2,9,141
"GTGATGTTCGTCCTTG",0,2,0,0,0,2,55
"GTGATGTTCTTAATCC",1,13,3,0,3,20,168
"GTGCACGAGTCGCGAA",159,1186,294,69,199,1907,77493
"GTGCACGCACAAGCTT",0,9,0,2,0,11,182
"GTGCACGCACAGAGAC",0,9,3,0,0,12,93
"GTGCACGCATTGGCAT",1,19,2,0,3,25,563
"GTGCACGGTATCCCTC",17,59,29,8,119,232,9266
"GTGCACGTCAGCTTGA",21,72,42,183,33,351,13616
"GTGCACGTCCGTGGCA",20,242,55,12,35,364,13386
"GTGCACGTCGTAACAC",2,0,0,0,0,2,23
"GTGCAGCAGTCATCGT",0,8,2,2,0,12,373
"GTGCAGCCATATGGCT",2,17,2,0,0,21,439
"GTGCAGCCATGACGAG",0,2,0,0,0,2,5
"GTGCAGCCATTCGGGC",1,0,0,0,0,1,13
"GTGCAGCTCCAGCCTT",0,7,3,0,6,16,370
"GTGCAGCTCGGCATTA",0,0,0,0,0,0,2
"GTGCAGCTCTTTCCGG",0,0,0,0,0,0,2
"GTGCGTGAGAAACTCA",0,0,0,0,0,0,4
"GTGCGTGAGAGGATCC",1,3,0,0,0,4,443
"GTGCGTGCACTACCCT",0,0,0,0,0,0,65
"GTGCGTGCATAAGCAA",1,15,5,0,2,23,475
"GTGCGTGCATGGAAGC",0,5,2,0,2,9,228
"GTGCGTGGTAGTTACC",0,0,2,0,0,2,59
"GTGCGTGGTTGCATTG",0,3,0,0,0,3,33
"GTGCGTGTCTACTATC",2,11,0,0,0,13,69
"GTGCTGGCAACTTGGT",0,2,0,0,0,2,47
"GTGCTGGGTACCTAAC",0,0,0,0,0,0,29
"GTGCTGGGTGGACCAA",3,3,5,0,0,11,68
"GTGCTGGTCCATTGTT",114,432,269,59,504,1378,58434
"GTGCTTCCACCCAAGC",1,7,3,0,6,17,194
"GTGCTTCCAGCTTCCT",0,8,7,0,3,18,467
"GTGCTTCGTCACAGTT",2,19,9,0,4,34,661
"GTGCTTCGTCATCCGG",0,2,2,0,0,4,69
"GTGCTTCGTGTTGACT",0,0,0,0,0,0,4
"GTGCTTCTCAGCCCAG",0,0,0,0,0,0,31
"GTGCTTCTCGGAGTGA",2,0,0,0,0,2,97
"GTGGAAGAGAATTTGG",5,15,5,0,3,28,364
"GTGGAAGAGGATACCG",0,3,0,0,0,3,119
"GTGGAAGCAAATGCGG",11,137,20,7,21,196,7454
"GTGGAAGCAGCTATAC",5,31,6,0,10,52,946
"GTGGAAGCAGTTCCAA",5,28,9,0,5,47,673
"GTGGAAGGTCCTACAA",1,8,0,0,2,11,401
"GTGGAAGGTGCTTCAA",192,1341,320,80,227,2160,100636
"GTGGAAGTCCTTCGAC",0,4,2,2,0,8,144
"GTGGAAGTCGATCCAA",0,7,3,0,0,10,170
"GTGGAAGTCGATTCCC",1,5,0,0,0,6,116
"GTGGAGAAGCATTTCG",2,3,0,0,0,5,90
"GTGGAGAAGCCATATC",1,7,5,0,2,15,185
"GTGGAGAAGGCATCAG",0,3,0,0,0,3,112
"GTGGAGACAACTGTGT",0,0,0,0,0,0,39
"GTGGAGACACTGTTCC",0,0,0,0,0,0,46
"GTGGAGACAGGTACGA",21,67,126,7,25,246,11929
"GTGGAGAGTAAGCAAT",1,0,0,0,0,1,34
"GTGGAGAGTACAGGTG",0,5,2,0,0,7,126
"GTGGAGAGTTGGGCCT",0,3,0,0,0,3,121
"GTGGAGATCACAGAGG",1,0,0,0,0,1,70
"GTGGAGATCCGTGTCT",3,23,3,0,5,34,451
"GTGGCGTAGGTTATAG",0,5,4,0,0,9,123
"GTGGCGTCAACCACAT",0,4,3,3,0,10,665
"GTGGCGTCAAGAAATC",3,40,13,2,9,67,807
"GTGGCGTCAGAGAGGG",0,3,2,0,0,5,62
"GTGGCGTCAGGCATGA",2,17,6,2,3,30,480
"GTGGCGTCATCATCTT",0,0,0,0,2,2,43
"GTGGCGTGTAACGATA",0,0,0,0,0,0,18
"GTGGCGTGTAGCACAG",47,517,109,18,64,755,21591
"GTGGCGTGTATCATGC",0,0,0,0,0,0,5
"GTGGCGTGTGACTGAG",3,22,2,0,5,32,420
"GTGGCGTGTTAGCGGA",3,11,2,0,2,18,270
"GTGGGAAAGCCATGCC",1,14,3,0,2,20,261
"GTGGGAAAGGATTTAG",2,3,0,0,7,12,618
"GTGGGAAAGGGAGTGG",1,4,3,0,0,8,79
"GTGGGAAAGTAAGGGA",0,0,0,0,0,0,79
"GTGGGAACAGAGTAAT",0,4,0,0,0,4,78
"GTGGGAACAGCATTGT",2,18,6,0,3,29,232
"GTGGGAAGTGACCGAA",1,4,0,0,0,5,137
"GTGGGAATCCCAGCGA",0,3,0,0,0,3,168
"GTGGGAATCGTCTAAG",1,29,10,0,3,43,433
"GTGGGAATCGTTATCT",2,15,6,0,4,27,649
"GTGGGAATCTTAGTTC",1,8,3,0,0,12,229
"GTGGTTACAGGGTCTC",1,9,2,2,0,14,411
"GTGGTTAGTCGTACTA",349,2284,780,184,495,4092,187510
"GTGGTTATCCTAGCGG",0,0,0,0,0,0,16
"GTGGTTATCTTCGATT",3,16,2,2,2,25,126
"GTGTAACCAAATTGCC",3,32,7,0,6,48,656
"GTGTAACCACCCAATA",232,478,129,91,99,1029,43989
"GTGTAACCAGTCTGGC",2,7,0,0,2,11,377
"GTGTAACGTCCGAAGA",2,18,13,0,6,39,709
"GTGTAACTCAAACCTG",1,4,0,0,0,5,53
"GTGTCCTAGAGGGCGA",17,66,108,6,25,222,11480
"GTGTCCTAGGAAGTGA",0,12,4,0,0,16,28
"GTGTCCTAGTTGGACG",1,5,2,0,3,11,110
"GTGTCCTCAACGGGTA",0,12,0,2,3,17,298
"GTGTCCTCAGCTGTTA",0,4,0,0,0,4,28
"GTGTCCTCATGACAGG",15,45,67,7,9,143,4310
"GTGTCCTTCAACGCTA",48,269,71,21,66,475,20872
"GTGTGATCAAGTAGTA",0,0,0,0,0,0,182
"GTGTGATCAGAGGCAT",2,5,2,2,2,13,140
"GTGTGATTCCTCACGT",5,19,5,0,2,31,404
"GTGTGGCAGCTGGAGT",88,396,110,28,76,698,28381
"GTGTGGCCAAGCGAGT",4,26,6,0,6,42,806
"GTGTGGCTCGAAGAAT",12,73,19,4,13,121,4679
"GTGTGGCTCGCTGATA",0,4,0,0,0,4,133
"GTGTTAGAGACCCGCT",32,245,65,21,44,407,18661
"GTGTTAGAGGTAGTCG",3,21,6,2,6,38,1026
"GTGTTAGAGTATCCTG",1,19,0,0,6,26,494
"GTGTTAGAGTCATCCA",0,11,4,0,0,15,121
"GTGTTAGCAAAGACTA",0,16,6,2,0,24,173
"GTGTTAGGTAGTGCGA",2,16,4,2,4,28,447
"GTGTTAGGTATGTCAC",0,0,0,0,0,0,6
"GTGTTAGGTTCTTAGG",1,7,3,0,3,14,378
"GTGTTCCAGCGTACAG",2,5,0,0,0,7,156
"GTGTTCCAGTCATTGC",0,3,4,0,0,7,76
"GTGTTCCCAACGAGGT",1,2,0,0,0,3,34
"GTGTTCCGTTGCGTAT",0,3,0,0,0,3,170
"GTGTTCCTCCTCTTTC",0,2,3,0,2,7,216
"GTGTTCCTCGAAGTGG",0,0,0,0,0,0,25
"GTTACAGCAATAGTGA",0,2,0,0,2,4,76
"GTTACAGGTATCTTCT",0,3,3,0,0,6,111
"GTTACAGTCCCGATCT",1,7,3,0,2,13,112
"GTTACAGTCGCTGATA",1,20,8,0,4,33,843
"GTTACCCAGTCCTACA",2,7,3,0,0,12,269
"GTTACCCCAAGGCCTC",2,3,0,0,2,7,503
"GTTACCCCATTCCTAT",1,4,2,0,0,7,120
"GTTACCCGTACAAACA",0,0,0,0,0,0,11
"GTTACCCGTACATTGC",0,4,2,0,0,6,135
"GTTACCCGTACCGTGC",0,10,6,0,4,20,438
"GTTACCCGTCACATTG",1,2,0,0,2,5,113
"GTTACCCTCATTTACC",1,10,5,0,0,16,260
"GTTACCCTCGCAGTCG",3,30,14,0,7,54,778
"GTTACCCTCTACACAG",0,22,7,0,4,33,466
"GTTACCCTCTTTGCAT",1,5,2,0,0,8,167
"GTTACGACACTACCCT",27,59,32,71,20,209,6677
"GTTACGACAGCAGTTT",0,9,0,0,2,11,128
"GTTACGACATGCCGGT",0,4,2,0,0,6,227
"GTTACGAGTACCCAGC",46,295,74,20,41,476,18418
"GTTACGAGTCGGTACC",5,28,11,0,4,48,1275
"GTTACGAGTGTAGGAC",4,15,4,0,2,25,402
"GTTACGAGTTCTGACA",52,281,152,24,65,574,25757
"GTTACGAGTTGCTGAT",117,875,228,60,144,1424,70238
"GTTACGATCACCACAA",54,177,221,26,259,737,32387
"GTTAGACCAAGTCCAT",0,0,0,0,0,0,18
"GTTAGACCAATAGTAG",1,17,0,3,3,24,304
"GTTAGACCATGTGACT",2,21,2,0,3,28,423
"GTTAGACGTAGAGCTG",0,3,0,0,0,3,43
"GTTAGACGTCGTGATT",21,11,8,0,5,45,572
"GTTAGACGTTGCTAGT",0,0,2,0,0,2,38
"GTTAGACGTTGCTCGG",4,15,3,2,4,28,364
"GTTAGACGTTTGAAAG",0,5,2,0,0,7,43
"GTTAGTGAGACAGTCG",1,0,0,0,0,1,53
"GTTAGTGAGCTACTGT",1,17,10,0,2,30,347
"GTTAGTGCATGGATCT",5,8,4,0,0,17,272
"GTTAGTGCATTCAGCA",0,0,0,0,0,0,24
"GTTAGTGCATTGGCAT",2,6,3,0,0,11,185
"GTTAGTGGTGAGAACC",1,5,0,0,0,6,143
"GTTAGTGTCTAGGCAT",2,22,9,0,4,37,539
"GTTATGGAGACGCCAA",1,2,0,0,2,5,109
"GTTATGGAGCCTCATA",36,129,261,18,134,578,27500
"GTTATGGAGCGAAACC",3,20,7,0,7,37,592
"GTTATGGAGCGGCTCT",4,39,8,2,3,56,1668
"GTTATGGAGTCTACCA",55,241,59,13,43,411,17483
"GTTATGGCACTTTATC",15,50,88,11,29,193,8886
"GTTATGGGTAACCCTA",7,45,60,6,12,130,6259
"GTTATGGGTGCTATTG",0,4,0,0,0,4,95
"GTTATGGTCACTTCTA",0,0,0,0,3,3,145
"GTTATGGTCAGAGCAG",3,16,3,0,4,26,488
"GTTATGGTCATTTGTC",20,161,39,6,23,249,12136
"GTTCATTAGAGGACTC",3,26,9,0,15,53,1189
"GTTCATTAGATAGGGA",7,44,22,2,7,82,3397
"GTTCATTAGGAGTCTG",2,27,6,0,4,39,695
"GTTCATTCAACACGTT",2,3,3,0,3,11,276
"GTTCATTCACAAGCCC",0,7,2,0,3,12,173
"GTTCATTCATGAAGCG",0,4,2,0,0,6,95
"GTTCATTGTCCAAAGG",0,0,0,0,0,0,117
"GTTCATTTCAGGGTAG",1,0,0,0,0,1,8
"GTTCATTTCATCGCAA",173,890,255,60,166,1544,71608
"GTTCATTTCCCAGGAC",0,9,0,0,0,9,222
"GTTCCGTAGCTATCTG",1,2,3,0,0,6,167
"GTTCCGTAGGTTGTTC",7,28,7,3,10,55,3365
"GTTCCGTAGTCCGTCG",0,20,3,0,5,28,492
"GTTCCGTGTAGTTACC",0,3,0,0,0,3,24
"GTTCCGTTCATCAGTG",0,2,2,0,0,4,47
"GTTCGCTAGCTGCGAA",0,4,2,0,3,9,123
"GTTCGCTCAAGATGGC",0,0,0,0,0,0,15
"GTTCGCTCATATCTGG",0,0,0,0,0,0,206
"GTTCGCTGTACTCCCT",0,3,2,0,0,5,147
"GTTCGCTTCTGGGCAC",1,4,2,0,0,7,122
"GTTCGCTTCTTACTGT",5,22,6,0,2,35,752
"GTTCTATAGTCAATCC",1,13,4,0,2,20,297
"GTTCTATAGTGCTAGG",2,11,7,0,5,25,719
"GTTCTATCAGCGGTTC",4,10,4,0,3,21,114
"GTTCTATGTCGAACGA",0,0,0,0,0,0,22
"GTTCTATGTTGCTCCT",1,4,4,0,0,9,192
"GTTCTATTCAGCTTCC",5,36,37,0,10,88,3872
"GTTCTATTCTGCACCT",1,2,0,2,0,5,121
"GTTGAACAGCGCCTAC",19,144,31,14,26,234,10833
"GTTGAACAGGAGCTGT",0,0,2,0,0,2,49
"GTTGAACAGTAGGATT",2,27,4,2,4,39,524
"GTTGAACAGTCGCTAT",11,32,53,4,7,107,2613
"GTTGAACAGTCGTTAC",65,571,280,67,89,1072,38307
"GTTGAACAGTGAGGCT",2,8,3,0,0,13,137
"GTTGAACCAATCTAGC",0,34,8,0,3,45,839
"GTTGAACGTAGGGTAC",1,24,9,0,5,39,723
"GTTGAACGTCAAACGG",3,16,8,0,3,30,476
"GTTGAACGTTGAATCC",1,4,0,0,0,5,56
"GTTGAACTCAGTCACA",8,37,9,0,8,62,1205
"GTTGCGGAGTGATCGG",8,34,11,2,4,59,1006
"GTTGCGGAGTGTACCT",4,18,4,0,4,30,485
"GTTGCGGCAGACGATG",0,9,0,0,0,9,145
"GTTGCGGGTACGTGTT",0,4,0,0,0,4,105
"GTTGCGGGTAGATTAG",0,5,0,0,0,5,180
"GTTGCGGGTCACAGTT",0,15,3,0,3,21,412
"GTTGCGGGTGCATGAG",3,19,9,0,0,31,891
"GTTGCGGGTTGTGTTG",5,24,9,0,27,65,2275
"GTTGCGGTCAGACTGT",36,271,82,107,63,559,23969
"GTTGCGGTCTGGACCG",1,2,3,0,0,6,106
"GTTGCGGTCTTCCCAG",1,9,0,0,0,10,114
"GTTGCTCAGATGACAT",1010,446,235,63,186,1940,85473
"GTTGCTCAGGGCTGAT",1,14,0,0,2,17,1170
"GTTGCTCCAACCTAAC",3,19,7,0,2,31,254
"GTTGCTCCACAAATGA",4,12,7,0,3,26,690
"GTTGCTCCAGCGGTCT",12,48,23,5,86,174,6702
"GTTGCTCGTATACGGG",0,2,2,0,0,4,174
"GTTGCTCGTATGGGAC",0,3,0,0,0,3,37
"GTTGCTCGTCCACTTC",0,3,0,0,0,3,128
"GTTGCTCGTCGCATCG",0,0,0,0,0,0,9
"GTTGCTCTCGGAGATG",0,3,0,0,2,5,115
"GTTGCTCTCTAGCCTC",0,9,2,0,2,13,343
"GTTGCTCTCTCTCGAC",0,0,0,0,0,0,8
"GTTGTAGAGGTAACTA",1,3,0,0,0,4,43
"GTTGTAGGTAGCTTGT",3,7,0,0,0,10,651
"GTTGTAGGTATCGATC",0,3,2,0,0,5,68
"GTTGTAGGTCGACTGC",0,0,0,0,4,4,248
"GTTGTCCCATGTTTGG",5,11,6,0,4,26,326
"GTTGTCCGTCCAGCGT",1,5,2,0,0,8,176
"GTTGTCCGTGCTGATT",0,2,0,0,0,2,225
"GTTGTCCGTGGTCCGT",2,14,4,0,4,24,458
"GTTGTCCGTTCTCTCG",0,3,0,0,0,3,106
"GTTGTCCGTTTGATCG",2,9,4,0,0,15,207
"GTTGTGAAGGCACTCC",0,0,0,0,0,0,1
"GTTGTGAAGTCTGGAG",1,11,3,0,0,15,229
"GTTGTGACATGGCGCT",1,5,0,0,0,6,96
"GTTGTGACATTAGGAA",0,0,0,0,0,0,112
"GTTGTGAGTCACTACA",87,209,525,50,96,967,45583
"GTTGTGAGTTTACCAG",2,7,2,0,0,11,181
"GTTGTGATCCGTAATG",0,5,0,0,0,5,125
"GTTGTGATCGCTAATG",3,9,2,0,0,14,82
"GTTTACTAGACAGCGT",0,6,2,0,2,10,92
"GTTTACTAGATGCCGA",103,132,54,15,38,342,13485
"GTTTACTAGTACCGGA",4,29,4,0,4,41,780
"GTTTACTCACAAATAG",122,918,226,68,169,1503,74297
"GTTTACTCATCGCTCT",22,224,69,14,54,383,17667
"GTTTACTGTAAGATCA",0,3,0,0,0,3,24
"GTTTACTGTCCCTCAT",0,3,0,0,0,3,126
"GTTTACTTCAACACGT",1,12,2,0,0,15,393
"GTTTACTTCAGCAGAG",0,5,0,0,3,8,107
"GTTTACTTCGGACTGC",3,7,0,0,4,14,379
"GTTTGGAAGACGTCGA",0,0,0,0,0,0,26
"GTTTGGAAGATACCAA",0,6,3,0,0,9,134
"GTTTGGACACAATGCT",1,6,0,0,0,7,64
"GTTTGGACACTAACCA",1,5,0,0,2,8,17
"GTTTGGACAGAGTAAT",0,7,0,0,0,7,61
"GTTTGGAGTAGTGATA",3,23,4,2,4,36,290
"GTTTGGATCAGCGCGT",2,2,0,0,0,4,53
"GTTTGGATCTAACGCA",1,6,0,0,0,7,102
"TAACACGAGAAGAGCA",132,879,248,71,512,1842,77789
"TAACACGAGATGGGCT",3,29,16,2,15,65,1930
"TAACACGCACCCTAAA",0,2,0,0,3,5,129
"TAACACGGTTCTCCCA",2,19,5,0,2,28,353
"TAACACGGTTGGCTAT",2,18,4,0,6,30,692
"TAACACGGTTGTGTTG",1,26,7,4,4,42,470
"TAACCAGAGAAACACT",2,32,7,0,6,47,502
"TAACCAGAGCACTGGA",192,1532,333,109,243,2409,115139
"TAACCAGAGCGCCATC",0,12,6,0,2,20,51
"TAACCAGAGCTTAGTC",0,5,5,0,0,10,131
"TAACCAGCACAAGCCC",3,15,9,2,7,36,791
"TAACCAGGTACTCCCT",0,0,0,0,0,0,10
"TAACCAGGTATGTGTC",27,88,53,10,187,365,19974
"TAACCAGTCGAGATGG",116,113,35,12,33,309,11590
"TAACGACTCGTTCTCG",32,275,86,20,46,459,22126
"TAACTTCAGGCCGCTT",0,11,0,0,0,11,67
"TAACTTCAGTTCGCAT",2,22,7,0,3,34,576
"TAACTTCCAATAGGGC",1,7,3,0,0,11,100
"TAACTTCCAATGAGCG",2,17,0,0,0,19,410
"TAACTTCCACTACCCT",5,52,15,4,64,140,6576
"TAACTTCCATCAACCA",0,4,2,0,2,8,126
"TAACTTCGTTAGAGAT",4,7,2,2,0,15,594
"TAACTTCTCCACAGGC",0,8,0,0,2,10,244
"TAACTTCTCTGCTTTA",15,78,144,12,32,281,15300
"TAAGCACAGAGAGTGA",0,4,0,0,0,4,137
"TAAGCACAGCAATTCC",1,7,0,0,2,10,116
"TAAGCACAGTGATCGG",3,28,12,0,4,47,704
"TAAGCACCAATATCCG",2,15,7,13,5,42,1084
"TAAGCACGTTGTTTGG",3,29,0,2,5,39,1222
"TAAGCCAAGAGGACTC",0,5,0,0,0,5,161
"TAAGCCAAGCTCATAC",0,2,0,0,0,2,79
"TAAGCCATCTTACCGC",20,193,49,44,37,343,18202
"TAAGCGTAGGCTTAAA",0,4,0,0,0,4,56
"TAAGCGTAGGTTCTAC",1,29,5,2,5,42,523
"TAAGCGTCAATAAGGT",0,2,0,0,0,2,10
"TAAGCGTCAGTGAGCA",1,9,2,0,0,12,171
"TAAGCGTGTGACTGAG",0,2,0,0,0,2,80
"TAAGCGTGTGGTTTAC",6,36,41,5,9,97,2769
"TAAGCGTGTTCAAACC",0,0,0,0,0,0,10
"TAAGCGTTCGTTGTAG",1,2,0,0,0,3,56
"TAAGCGTTCTCGGTAA",0,5,2,0,0,7,204
"TAAGTCGAGAATCCCT",1,8,2,2,2,15,332
"TAAGTCGCAATTCACG",1,3,2,0,0,6,374
"TAAGTCGCAGCATTGT",1,7,0,0,0,8,361
"TAAGTCGGTTGCAAGG",0,10,5,0,4,19,96
"TAATCTCAGGATATAC",2,30,7,0,6,45,626
"TAATCTCCAACAGTGG",0,3,0,0,0,3,162
"TAATCTCCACCATATG",2,28,0,0,0,30,583
"TAATCTCCACGCGCTA",0,2,2,0,0,4,88
"TAATCTCCAGGTTTAC",0,9,4,0,0,13,207
"TAATCTCGTCTTCATT",185,1288,433,100,254,2260,108422
"TAATCTCGTGGCTAGA",0,4,0,0,0,4,35
"TAATCTCTCCAGCTCT",3,39,22,0,7,71,2255
"TAATCTCTCCGTACGG",0,3,0,0,0,3,186
"TAATCTCTCTCCGAAA",2,8,3,0,0,13,159
"TAATCTCTCTGAGAGG",1,23,8,2,5,39,645
"TAATTCCAGACTGTTC",2,20,6,0,5,33,80
"TAATTCCAGTTGGGAC",1,4,0,0,0,5,84
"TAATTCCCACTCCTGT",2,16,6,2,3,29,686
"TAATTCCGTCGTATTG",0,2,0,0,0,2,57
"TACAACGAGTCACGAG",3,22,8,0,2,35,486
"TACAACGCAACACGTT",0,0,0,0,0,0,5
"TACAACGCAGATCATC",0,3,0,0,0,3,116
"TACAACGCAGTAACAA",3,26,10,3,7,49,268
"TACAACGCAGTGGGTA",3,32,3,2,4,44,1098
"TACAACGCATTAGGCT",50,97,30,4,24,205,9291
"TACAACGGTTAATCGC",2,17,3,2,0,24,718
"TACAACGTCGGTCACG",0,3,0,0,0,3,23
"TACAACGTCGTGCATA",0,0,0,0,0,0,12
"TACACCCAGGGAGGTG",4,20,3,0,3,30,711
"TACACCCCACACGCCA",0,2,0,0,0,2,100
"TACACCCCATCCCACT",6,44,13,5,6,74,2368
"TACACCCGTGTTTACG",7,55,13,2,10,87,4977
"TACACCCTCGTAGCCG",28,72,25,4,14,143,5874
"TACACCCTCTCGAACA",3,13,3,2,0,21,528
"TACAGGTAGAACGTGC",0,0,0,0,0,0,17
"TACAGGTAGGCATCGA",6,17,5,2,8,38,566
"TACAGGTCACCCTATC",2,3,6,0,0,11,109
"TACAGGTCAGTTAGGG",61,84,28,8,18,199,7209
"TACAGGTTCCAACCGG",3,7,2,0,6,18,420
"TACAGGTTCTCGCTCA",0,6,2,0,0,8,228
"TACATTCAGAACCGCA",3,10,5,0,2,20,433
"TACATTCAGCAAGCCA",11,72,15,4,15,117,3368
"TACATTCAGGCTAGCA",0,8,2,0,4,14,552
"TACATTCCAGCTGCCA",11,64,110,6,23,214,11296
"TACATTCGTGGCTGCT",0,2,0,0,0,2,16
"TACATTCTCCCATAAG",3,45,20,4,9,81,121
"TACATTCTCCGATGCG",2,38,10,0,6,56,1944
"TACATTCTCTCGCGTT",2,6,2,0,0,10,319
"TACCCACAGTGGCAGT",0,9,3,0,3,15,304
"TACCCACCACTTGGGC",1,19,5,0,0,25,131
"TACCCACCAGCTTCCT",3,24,19,3,0,49,1766
"TACCCACCATCCTTCG",317,2178,544,405,395,3839,177630
"TACCCACCATGGTACT",2,15,7,3,15,42,1739
"TACCCACGTTAGAGTA",4,36,19,3,57,119,5109
"TACCCACTCAACTACG",4,22,4,0,5,35,584
"TACCCACTCGCGCTGA",0,7,0,0,0,7,35
"TACCCACTCGTCCATC",1,3,0,0,0,4,201
"TACCCACTCTTACGTT",2,23,5,0,4,34,727
"TACCCGTAGCGAGTAC",12,145,29,8,19,213,8945
"TACCCGTAGTCGGCCT",3,6,3,0,4,16,371
"TACCCGTTCATACGAC",2,6,3,2,3,16,181
"TACCCGTTCCTCCACA",0,8,0,0,0,8,200
"TACCGAAAGAGAGGGC",0,2,0,0,2,4,68
"TACCGAAAGTCAGGGT",1,12,0,0,4,17,311
"TACCGAACAATTCTTC",0,5,4,2,0,11,167
"TACCGAACACCGAATT",0,3,0,0,0,3,103
"TACCGAAGTCTTAGTG",1,7,2,0,0,10,212
"TACCGAAGTGGATGAC",2,31,24,0,7,64,2131
"TACCGAAGTTCTCGTC",0,4,0,0,0,4,100
"TACCGAATCAGCCTTC",94,646,158,44,124,1066,50517
"TACCGAATCTTGTGCC",5,42,7,0,5,59,1307
"TACCGGGAGACTCATC",0,2,0,0,0,2,15
"TACCGGGAGGTCGTGA",0,0,0,0,0,0,5
"TACCGGGCACGAGGTA",3,17,5,0,4,29,499
"TACCGGGCATTGCAAC",0,0,2,0,0,2,7
"TACCGGGGTAACTTCG",3,15,6,3,3,30,470
"TACCTCGAGCCTGTGC",4,29,20,6,28,87,3426
"TACCTCGCATGACTAC",0,0,0,0,0,0,169
"TACCTCGGTACGTGAG",7,33,38,2,16,96,3092
"TACCTCGGTACTCAAC",2,29,6,0,0,37,760
"TACCTCGGTCGCTTAA",69,30,7,5,7,118,1969
"TACCTCGTCCCTCTAG",1,7,0,0,0,8,142
"TACCTGCAGAGCCATG",0,5,3,0,0,8,151
"TACCTGCAGCATACTC",0,6,0,0,0,6,166
"TACCTGCAGTGCTCGC",3,29,10,0,5,47,972
"TACCTGCGTAGGACTG",24,179,62,12,34,311,16425
"TACCTGCGTATTCTCT",18,80,67,9,113,287,14624
"TACCTGCGTCCACTCT",8,3,0,0,0,11,509
"TACCTGCGTTGGGATG",8,19,18,4,6,55,2018
"TACCTGCTCATAGCAC",0,5,2,2,0,9,133
"TACCTGCTCCCGTGAG",2,13,2,0,3,20,760
"TACGCTCAGGACTGGT",1,7,4,0,0,12,172
"TACGCTCCAGTGTGGA",1,6,2,2,2,13,241
"TACGCTCCATCTTCGC",11,38,71,4,28,152,5911
"TACGCTCCATGGTGGA",1,2,0,0,0,3,8
"TACGCTCTCAAAGGTA",23,71,155,25,34,308,16662
"TACGCTCTCAGACATC",1,2,4,0,0,7,50
"TACGGGCAGATTGACA",65,170,418,28,103,784,39930
"TACGGGCCAGCCTATA",2,3,3,0,0,8,113
"TACGGGCCATTAAGCC",0,2,0,0,0,2,210
"TACGGGCGTCGCATTA",1,17,4,0,3,25,296
"TACGGGCGTCGTATGT",1,5,2,0,2,10,69
"TACGGGCTCCTACGAA",0,5,0,0,0,5,132
"TACGGTAAGCCGCTTG",0,9,0,0,0,9,311
"TACGGTACATAGGAGC",8,56,12,0,13,89,2862
"TACGGTAGTGCACATT",1,9,5,0,6,21,35
"TACGGTATCCACGGAC",0,6,4,0,0,10,182
"TACGGTATCTCAACCC",151,752,202,62,151,1318,61693
"TACGTCCAGCCAAGCA",1,17,11,2,4,35,987
"TACGTCCAGGCATCTT",2,33,9,2,10,56,841
"TACGTCCAGGTCACCC",0,0,2,0,0,2,11
"TACGTCCAGTATTCCG",0,3,0,0,0,3,35
"TACGTCCAGTTTGTCG",13,67,159,12,24,275,13065
"TACGTCCCACAAGCCC",0,0,0,0,0,0,5
"TACGTCCCAGACCAAG",2,3,8,0,2,15,457
"TACGTCCTCCGATGTA",5,67,17,0,7,96,3007
"TACTGCCAGTAGCAAT",7,32,43,2,6,90,4117
"TACTGCCCACATGAAA",1,2,2,0,0,5,19
"TACTGCCCACATTCGA",1,22,0,0,2,25,610
"TACTGCCCACTCCTGT",0,2,0,0,0,2,26
"TACTGCCCAGAGACTG",2,3,2,0,5,12,421
"TACTGCCGTAACATGA",0,7,0,0,0,7,111
"TACTGCCGTTCTCCAC",0,4,0,0,0,4,194
"TACTGCCTCACATCAG",4,31,6,0,8,49,669
"TACTGCCTCCTAGCTC",3,38,7,0,5,53,1131
"TACTTACAGACGCAGT",0,0,3,0,3,6,95
"TACTTACAGGCTTAAA",3,21,8,2,11,45,559
"TACTTACAGTTAGAAC",2,15,0,0,0,17,172
"TACTTACTCAGACATC",1,30,12,4,8,55,1482
"TACTTCAAGACAAGCC",96,232,646,43,118,1135,54480
"TACTTCAAGCAAGCCA",20,69,73,13,119,294,14548
"TACTTCAAGCGGACAT",3,27,6,4,5,45,604
"TACTTCACACCATATG",0,4,0,0,0,4,107
"TACTTCACATAAGCGG",0,4,0,0,0,4,163
"TACTTCAGTGCCGGTT",0,26,5,2,2,35,1184
"TACTTCATCTAGCAAC",1,10,2,0,4,17,142
"TACTTCATCTCCAATT",1,0,2,0,0,3,70
"TACTTGTAGTCAGCCC",0,6,0,0,0,6,110
"TACTTGTCATTCCTCG",106,194,133,18,52,503,22694
"TACTTGTGTTGTGCAT",2,12,4,0,2,20,501
"TACTTGTTCCAATCTT",3,25,14,2,7,51,1010
"TACTTGTTCCCAGGAC",0,5,4,0,4,13,158
"TAGACCAAGGTGCTGA",0,5,2,0,0,7,137
"TAGACCAAGTCACGCC",1,9,5,0,5,20,235
"TAGACCACACCTGTCT",1,4,4,0,0,9,258
"TAGACCACAGAGTCTT",2,4,0,0,0,6,65
"TAGACTGAGATGATTG",3,20,3,0,3,29,799
"TAGACTGAGCATTGTC",0,3,0,0,2,5,130
"TAGACTGAGCGACTGA",19,85,46,10,166,326,16662
"TAGACTGAGGGTTTCT",1,15,6,0,2,24,234
"TAGACTGCAGCGTTGC",62,158,431,35,88,774,38054
"TAGACTGCAGGTATGG",58,339,177,22,75,671,35819
"TAGACTGCAGGTGAGT",3,9,0,0,6,18,143
"TAGACTGGTAAGCTCT",2,31,12,2,4,51,1224
"TAGACTGGTGGTCAAG",1,21,3,0,5,30,327
"TAGACTGTCAAGTCTG",0,2,2,0,0,4,11
"TAGAGTCAGAAAGCGA",0,0,0,0,0,0,60
"TAGAGTCAGCTCCGAC",0,17,7,0,3,27,620
"TAGAGTCAGGCGAAGG",1,9,0,0,2,12,373
"TAGAGTCAGTAGCCAG",0,3,3,0,0,6,56
"TAGAGTCCACGCGCTA",1,5,0,0,0,6,326
"TAGAGTCCACTGCGAC",1,14,4,0,4,23,797
"TAGAGTCCATCGCTGG",1,0,0,0,0,1,3
"TAGAGTCGTGGATGAC",0,2,0,0,0,2,103
"TAGAGTCTCACCGGTG",1,11,3,0,0,15,67
"TAGAGTCTCCATCTCG",11,76,17,6,14,124,3259
"TAGAGTCTCGCTAAAC",140,1208,309,56,184,1897,95484
"TAGATCGAGATCACCT",5,18,2,0,0,25,594
"TAGATCGAGCGAGTAC",1,24,6,3,3,37,433
"TAGATCGAGGGTCTTT",77,474,127,28,96,802,38183
"TAGATCGAGGTACAGC",3,24,12,0,7,46,818
"TAGATCGCAGGTTCAT",6,11,3,3,5,28,871
"TAGATCGCATAGCACT",3,14,4,0,8,29,910
"TAGATCGGTAGTCGTT",1,2,2,0,0,5,106
"TAGATCGGTCCAACGC",1,4,0,0,2,7,85
"TAGATCGGTGTATTCG",26,102,98,15,32,273,10940
"TAGATCGGTTCGTGCG",2,6,0,0,0,8,58
"TAGATCGTCCTACAAG",1,21,3,0,4,29,378
"TAGATCGTCTTAGCTT",28,249,76,13,51,417,22371
"TAGCACAAGAGCCCAA",62,537,112,30,93,834,36668
"TAGCACAAGCTGCCTG",1,11,3,0,0,15,544
"TAGCACAAGGGACACT",2,17,6,2,0,27,101
"TAGCACAAGTCAGGGT",0,6,2,0,0,8,22
"TAGCACAAGTCATACC",0,16,3,0,2,21,535
"TAGCACACAAGATCCT",0,0,0,0,0,0,4
"TAGCACAGTGAACCGA",1,5,2,0,0,8,172
"TAGCACATCAAGTGTC",2,55,10,3,8,78,1123
"TAGCACATCAGGTGTT",6,37,13,3,35,94,4132
"TAGCACATCTCAACGA",2,10,0,0,0,12,482
"TAGGAGGAGAGAGTTT",5,31,8,3,6,53,1906
"TAGGAGGCAGGGTTGA",1,3,0,0,0,4,39
"TAGGAGGGTCGTCATA",2,7,2,0,2,13,266
"TAGGAGGTCAACTACG",0,20,10,0,5,35,649
"TAGGAGGTCAAGCCCG",1,10,3,0,0,14,198
"TAGGAGGTCATAGGCT",17,91,21,10,19,158,6035
"TAGGAGGTCCTAGAGT",127,745,171,45,128,1216,49578
"TAGGAGGTCTGGGATT",41,284,75,21,66,487,20235
"TAGGGTTAGATACTGA",244,433,232,634,164,1707,69893
"TAGGGTTAGGCATGGT",2,6,0,0,0,8,69
"TAGGGTTCAGTTAAAG",5,35,9,0,18,67,1536
"TAGGGTTCATAATGCC",0,2,0,0,0,2,22
"TAGGGTTGTCTCACAA",3,20,10,0,4,37,848
"TAGGGTTTCAGCGGAA",2,29,7,0,6,44,711
"TAGGGTTTCTGCGGGT",9,48,109,9,21,196,8834
"TAGGTACAGATGCTAA",0,3,0,0,0,3,157
"TAGGTACAGCGTGAGT",3,23,19,2,6,53,1192
"TAGGTACAGCTATCTG",0,8,3,0,0,11,178
"TAGGTACAGGGATCAC",0,5,2,0,2,9,193
"TAGGTACCATCGATCA",27,90,133,16,39,305,14360
"TAGGTACGTAGAGACC",0,5,0,0,0,5,178
"TAGGTACTCAAGCCAT",0,4,2,0,0,6,275
"TAGGTACTCGTAGAGG",6,46,47,6,16,121,4963
"TAGGTTGAGATCCTAC",0,10,3,0,0,13,134
"TAGGTTGAGCTACTAC",3,15,4,0,4,26,1005
"TAGGTTGAGTAGGAAG",0,4,0,0,2,6,78
"TAGGTTGCAGGTCTCG",54,182,53,21,51,361,13636
"TAGGTTGGTACTGACT",0,4,0,0,0,4,70
"TAGGTTGGTGTTATCG",25,29,14,6,7,81,2384
"TAGTGCAAGAGTCTTC",8,27,15,2,46,98,4738
"TAGTGCAAGCCTGACC",3,25,5,0,4,37,1243
"TAGTGCACACCCTTGT",0,5,0,0,0,5,109
"TAGTGCACATCACCAA",1,4,2,2,0,9,385
"TAGTGCACATGTGGCC",1,4,2,0,0,7,145
"TAGTGCATCATCTCTA",37,81,30,46,25,219,9623
"TAGTGCATCTCACCCA",0,0,0,0,0,0,83
"TATACCTAGCCTGACC",11,9,0,0,4,24,739
"TATACCTAGCGATCGA",5,11,4,0,2,22,290
"TATACCTAGCTCGGCT",1,7,3,0,2,13,109
"TATACCTAGGGAGTGG",1,4,0,0,0,5,138
"TATACCTCAGAAATTG",1,0,0,0,0,1,37
"TATACCTGTAGTTAGA",85,666,162,44,117,1074,49555
"TATACCTGTCTTGCTC",1,11,2,0,3,17,304
"TATACCTGTGATAGTA",0,10,2,0,0,12,84
"TATACCTGTGGACTGA",0,11,4,0,0,15,275
"TATACCTTCACATCAG",19,94,172,8,38,331,16843
"TATACCTTCAGTCATG",2,21,6,0,0,29,446
"TATACCTTCCGCCTAT",2,8,5,0,2,17,530
"TATACCTTCCTTCAGC",11,76,17,2,10,116,4762
"TATACCTTCGCCGAGT",12,38,16,5,41,112,3213
"TATATCCAGACATGCG",3,21,2,0,3,29,554
"TATATCCCAGCGACAA",0,6,0,0,0,6,101
"TATATCCGTAGCGTTT",0,26,11,0,7,44,696
"TATATCCGTCGCATGC",2,15,7,0,6,30,580
"TATATCCGTCGGTAAG",34,121,78,21,256,510,21297
"TATATCCTCGTGCAGC",5,26,7,2,0,40,1110
"TATCAGGAGAAACCCG",55,197,314,23,167,756,30122
"TATCAGGAGTATGTAG",1,35,7,0,7,50,802
"TATCAGGCAACTCATG",1,17,4,0,0,22,520
"TATCAGGCAAGCCATT",6,47,12,2,5,72,2511
"TATCAGGGTTGGGATG",8,11,5,0,10,34,1077
"TATCAGGTCCGTTGAA",0,4,3,0,0,7,150
"TATCAGGTCGTAGAGG",12,51,37,8,51,159,5947
"TATCCTAGTACCCGCA",1,5,3,0,0,9,114
"TATCCTAGTATTCCTT",4,25,6,0,5,40,130
"TATCCTATCCTCACCA",3,25,8,3,5,44,1102
"TATCCTATCGGTTCAA",8,32,10,0,13,63,1956
"TATCGCCAGCGCTGAA",17,61,59,11,88,236,9247
"TATCGCCAGGGAGTTC",2,4,5,0,2,13,197
"TATCGCCAGTGCTACT",1,23,3,0,5,32,1026
"TATCGCCCACATAACC",1,6,0,0,0,7,332
"TATCGCCCAGGCATGA",0,5,2,0,2,9,263
"TATCGCCGTTAGGGTG",82,83,33,10,15,223,7189
"TATCGCCTCGCCTTGT",2,15,2,0,2,21,1102
"TATCGCCTCTGGGCCA",44,103,27,10,19,203,9123
"TATCTGTAGACATACA",7,54,10,17,12,100,4049
"TATCTGTCAAAGCACG",11,44,13,4,43,115,5384
"TATCTGTCAAGACCGA",10,98,26,3,11,148,6875
"TATCTGTCAATGCTCA",1,7,3,0,5,16,484
"TATCTGTGTATCGCAT",0,5,2,0,0,7,167
"TATCTGTTCATCCTGC",1,7,2,0,0,10,149
"TATCTGTTCCCACAGG",0,2,0,0,0,2,44
"TATCTTGAGACATCAA",2,18,3,0,3,26,662
"TATCTTGAGACCATAA",0,5,4,0,2,11,58
"TATCTTGAGACCTCCG",1,0,0,0,0,1,55
"TATCTTGAGCGCCTCA",1,5,2,0,2,10,215
"TATCTTGAGCGGTAGT",1,23,6,0,3,33,52
"TATCTTGAGCTGGTGA",24,182,49,15,37,307,13450
"TATCTTGAGTATGGCG",3,19,10,3,2,37,1141
"TATCTTGGTTCTTGCC",5,51,10,7,7,80,1471
"TATCTTGGTTTGGCTA",0,2,0,0,0,2,25
"TATCTTGTCAGTGTTG",33,170,43,11,32,289,13937
"TATGTTCAGAAACCAT",14,92,23,4,20,153,5638
"TATGTTCAGAGGTATT",0,9,2,0,0,11,105
"TATGTTCAGTGCAGCA",1,14,5,0,3,23,494
"TATGTTCCAAGGGTCA",0,4,0,0,0,4,125
"TATGTTCCAATGAACA",2,23,4,6,4,39,139
"TATGTTCGTGTCCAAT",4,24,22,0,9,59,2377
"TATGTTCTCCTTGAAG",0,21,9,0,3,33,549
"TATGTTCTCGCTTACC",0,3,0,0,0,3,13
"TATTCCAAGCAACTTC",1,4,7,0,0,12,518
"TATTCCACATCGCCTT",0,25,8,0,6,39,968
"TATTCCAGTTCGGCCA",0,22,4,3,5,34,703
"TATTCCAGTTTCCCAC",8,76,14,5,10,113,3271
"TATTCCATCCACAGCG",9,79,18,3,12,121,4621
"TATTCCATCCCAGGAC",1,18,5,0,4,28,779
"TATTGCTAGCAATAAC",0,6,0,0,2,8,68
"TATTGCTAGTGCCGAA",7,49,19,2,27,104,2766
"TATTGCTAGTGGTTAA",7,76,17,7,15,122,5906
"TATTGCTCACACAGCC",0,0,0,0,0,0,70
"TATTGCTGTCATACCA",0,6,0,0,3,9,134
"TATTGCTTCCAAGCAT",5,30,10,0,7,52,791
"TATTGCTTCGGTGAAG",12,94,25,4,17,152,7120
"TATTGCTTCTCGTCGT",0,0,0,0,0,0,27
"TATTGCTTCTTGAACG",5,26,9,3,3,46,866
"TATTGGGAGTTCCAGT",0,3,0,0,0,3,100
"TATTGGGAGTTTGTCG",217,225,107,25,67,641,26322
"TATTGGGCACCAACAT",1,19,10,0,7,37,498
"TATTGGGCATCCGGTG",1,19,4,0,4,28,1775
"TATTGGGGTCCCGTGA",28,27,15,2,4,76,2716
"TATTGGGGTGGTTTAC",0,5,0,0,0,5,200
"TATTGGGTCCATCACC",0,0,0,0,0,0,107
"TATTTCGAGAAGGTAG",0,5,0,0,2,7,193
"TATTTCGAGAGATGCC",4,24,5,0,0,33,176
"TATTTCGAGTCGCTAT",0,2,0,0,0,2,12
"TATTTCGCATGTTCGA",55,141,351,28,87,662,33341
"TATTTCGGTACCGCGT",2,13,3,0,2,20,407
"TATTTCGGTAGGGAGG",2,19,5,0,4,30,410
"TATTTCGGTATCGATC",0,7,2,0,0,9,193
"TATTTCGTCTCGGTCT",0,8,2,0,0,10,187
"TATTTCGTCTGAACGT",0,24,8,0,2,34,482
"TCAAGACAGATAACGT",5,23,3,0,4,35,602
"TCAAGACAGGAACGAA",2,17,3,2,0,24,508
"TCAAGACCACTTGTCC",0,2,0,0,0,2,121
"TCAAGACCAGAGGTAC",1,18,4,0,13,36,1711
"TCAAGACGTAACTTCG",1,5,0,0,0,6,138
"TCAAGACGTGCGAACA",1,10,3,0,0,14,354
"TCAAGACTCAATGTCG",0,6,2,0,0,8,138
"TCAAGCAAGAGGCTGT",1,2,2,0,5,10,478
"TCAAGCAAGCACCCAC",28,77,89,15,93,302,12168
"TCAAGCAAGGCCTTCG",17,49,28,9,107,210,9158
"TCAAGCACAAATCCCA",0,0,2,0,0,2,4
"TCAAGCACACAAGCTT",287,244,99,34,75,739,28107
"TCAAGCAGTCGGTACC",0,0,0,0,0,0,81
"TCAAGCAGTCTACGTA",2,5,0,0,0,7,57
"TCAAGCATCCATACTT",0,2,2,0,0,4,7
"TCAAGTGAGGCCTAAG",2,4,2,0,0,8,181
"TCAAGTGCAATCGCAT",1,9,2,0,0,12,219
"TCAAGTGCACACCTAA",198,151,149,21,75,594,27525
"TCAAGTGCATCTATCT",1,0,0,0,0,1,16
"TCAAGTGGTCACCGAC",4,52,11,0,11,78,3508
"TCAAGTGGTTAGAAAC",3,18,4,0,2,27,464
"TCAAGTGTCGTAACCA",10,47,27,3,4,91,3864
"TCAATCTAGATGGCAC",0,16,3,0,0,19,168
"TCAATCTAGCGAATGC",0,0,0,0,0,0,261
"TCAATCTGTCCGGCAT",1,24,10,0,5,40,731
"TCAATCTGTTACTCAG",3,25,8,3,7,46,1034
"TCAATTCAGATCACTC",2,2,4,0,2,10,228
"TCAATTCAGGCTCACC",3,19,6,2,7,37,1593
"TCAATTCCAAACTGCT",1,11,0,0,0,12,217
"TCAATTCCAAGAGAGA",64,528,139,35,96,862,36583
"TCAATTCCACATACGT",0,8,5,0,2,15,180
"TCAATTCCAGTCGGTC",0,2,0,0,0,2,69
"TCAATTCGTTGCCGCA",1,2,0,0,0,3,182
"TCAATTCTCATTCACT",1,26,6,0,6,39,637
"TCAATTCTCGGTGAAG",0,5,0,0,2,7,104
"TCAATTCTCTAGGCAT",14,96,25,5,18,158,6312
"TCAATTCTCTCACTCG",3,20,2,0,5,30,626
"TCACAAGAGAGGCTGT",0,5,3,0,4,12,273
"TCACAAGAGGTAAGTT",1,35,12,0,4,52,543
"TCACAAGAGTTGCCCG",9,38,36,0,11,94,2599
"TCACAAGCACTCATAG",1,3,2,0,4,10,62
"TCACAAGCAGAGATTA",0,6,0,0,0,6,101
"TCACAAGGTCAGGTAG",1,22,6,0,0,29,712
"TCACAAGGTCCGATCG",0,6,3,0,0,9,171
"TCACACCCAAATTGGA",0,8,3,0,2,13,52
"TCACACCCAAGAGCTG",1,7,0,0,3,11,192
"TCACACCCACAGCTGC",0,7,0,0,0,7,160
"TCACACCCACATAGCT",0,8,3,0,0,11,188
"TCACACCGTGTTCCTC",0,9,2,0,0,11,274
"TCACACCGTTGAATCC",3,10,4,0,5,22,594
"TCACACCTCACATTGG",1,3,0,0,0,4,103
"TCACACCTCAGGGTAG",0,3,0,0,0,3,42
"TCACACCTCGTGCAGC",0,3,3,0,0,6,212
"TCACACCTCTCCGAGG",0,3,2,0,0,5,145
"TCACATTAGGATTTAG",25,83,132,18,32,290,14001
"TCACATTCACATGAAA",12,55,37,6,41,151,6016
"TCACATTCACTTGACA",3,26,7,0,4,40,1065
"TCACATTGTAGTCTTG",2,22,3,0,2,29,250
"TCACATTGTCCGCAGT",2,0,0,0,3,5,96
"TCACATTGTGAGCGAT",0,6,4,0,0,10,196
"TCACATTGTGCAACAG",0,3,3,0,0,6,183
"TCACATTGTGCGAGTA",0,2,0,0,0,2,11
"TCACATTGTGTTAAAG",0,3,2,0,3,8,443
"TCACATTGTTCAAGTC",26,175,57,11,34,303,12271
"TCACATTTCCTCATAT",1,0,0,0,0,1,8
"TCACATTTCTCACGAA",0,2,0,0,0,2,116
"TCACGCTAGTAGCCAG",2,22,2,0,3,29,573
"TCACGCTCATCTCCCA",27,217,66,14,40,364,16362
"TCACGCTGTCTAATCG",0,0,0,0,0,0,7
"TCACGGGAGGTTGAGC",33,125,180,17,192,547,28748
"TCACGGGCATCACAGT",0,12,0,0,3,15,485
"TCACGGGGTAACATAG",3,10,2,0,0,15,130
"TCACGGGGTCAATCTG",1,9,0,0,0,10,365
"TCACGGGGTCAGGCAA",5,25,14,0,3,47,1073
"TCACGGGTCAGGAAAT",1,15,4,0,0,20,280
"TCACGGGTCCGAACGC",0,4,0,0,0,4,14
"TCACGGGTCCGTTGGG",6,50,11,0,8,75,3323
"TCACGGGTCCTGGGTG",0,0,0,0,0,0,38
"TCACGGGTCGAGTGAG",1,3,2,0,0,6,53
"TCACGGGTCGTGCTCT",16,84,21,10,22,153,5766
"TCACTATCAAAGACTA",0,0,0,0,0,0,14
"TCACTATCAACTCATG",12,47,67,4,17,147,5228
"TCACTATGTACAGAAT",0,6,0,0,0,6,195
"TCACTATTCACTGGTA",0,3,3,0,4,10,92
"TCACTATTCAGTCATG",1,9,2,0,3,15,173
"TCACTATTCTCCCAAC",2,6,0,0,0,8,116
"TCACTCGAGATTGGGC",3,21,5,4,0,33,618
"TCACTCGAGCCTCCAG",32,171,40,14,35,292,13691
"TCACTCGAGTTTGGCT",0,5,0,0,0,5,6
"TCACTCGCATTGACAC",54,210,292,33,158,747,34585
"TCACTCGGTAGTGATA",1,7,0,0,0,8,141
"TCACTCGGTGATTAGA",1,5,2,0,0,8,432
"TCACTCGTCAGAACCT",22,29,15,2,7,75,2695
"TCACTCGTCCTCTTTC",1,16,4,0,5,26,816
"TCACTCGTCGCTGATA",0,3,3,0,0,6,86
"TCAGCAACACAACCGC",0,4,0,0,0,4,186
"TCAGCAACACAGTGAG",46,129,314,20,69,578,28980
"TCAGCAACAGGCTACC",87,227,63,16,47,440,15989
"TCAGCAACATCATTTC",6,21,7,0,14,48,1974
"TCAGCAATCGTTACCC",3,20,18,0,4,45,1466
"TCAGCCTCAACACTAC",3,20,7,0,2,32,517
"TCAGCCTCAAGTTTGC",3,20,3,2,2,30,624
"TCAGCCTCAGTAGTGG",2,22,8,0,3,35,1144
"TCAGCCTCATTATGCG",0,5,0,0,0,5,139
"TCAGGGCCAAAGCTAA",1,12,0,0,5,18,150
"TCAGGGCCAAATCAAG",1,15,3,0,0,19,535
"TCAGGGCCAATGTCTG",0,5,0,0,0,5,119
"TCAGGGCCAGGTTCCG",1,10,0,0,0,11,154
"TCAGGGCCATAAGCGG",25,72,71,7,57,232,9254
"TCAGGGCTCGTAGTGT",2,21,5,0,0,28,589
"TCAGGGCTCTGGGCCA",165,550,132,51,102,1000,48412
"TCAGGTAAGCGAGTAC",1,4,2,0,0,7,77
"TCAGGTACAACCGTGC",4,6,2,0,0,12,266
"TCAGGTACACCAAAGG",3,17,2,0,7,29,1323
"TCAGGTACATCAGCGC",0,4,0,0,0,4,38
"TCAGGTAGTGCATGTT",0,10,4,0,0,14,208
"TCAGGTAGTTTACCAG",76,535,120,38,91,860,42892
"TCAGGTATCCAACCGG",1,0,0,0,0,1,74
"TCAGTCCAGTCACTGT",0,12,0,0,0,12,193
"TCAGTCCGTCACTTCC",0,18,5,2,5,30,1806
"TCAGTCCGTTCCACAA",63,469,133,33,89,787,37006
"TCAGTGAAGCACGATG",12,41,79,3,11,146,5701
"TCAGTGAAGCCGTTAT",2,6,2,0,0,10,138
"TCAGTGAAGTAACAGT",4,15,2,3,2,26,526
"TCAGTGACAGCAGATG",1,12,5,0,2,20,564
"TCAGTGACAGTAGAAT",8,22,10,3,5,48,997
"TCAGTGAGTAGTCCTA",1,8,2,0,0,11,576
"TCAGTGAGTCAGTCTA",6,21,11,3,17,58,2051
"TCAGTGAGTGGTTTAC",0,17,5,0,0,22,403
"TCAGTTTAGAGCATCG",5,28,26,0,15,74,2894
"TCAGTTTCAAGCCCAC",1,3,2,0,0,6,41
"TCAGTTTCAATTGGTC",0,13,3,0,0,16,313
"TCAGTTTCATTCTGTT",0,3,0,0,0,3,210
"TCAGTTTGTAGCGCTC",0,2,2,0,0,4,67
"TCAGTTTGTGTTGCCG",1,21,0,0,2,24,421
"TCAGTTTTCCCGAGAC",2,20,7,0,4,33,890
"TCAGTTTTCGATTTCT",207,1166,342,97,230,2042,100432
"TCATACTAGTAGACAT",54,242,119,124,154,693,32130
"TCATACTCACTTCTCG",0,6,3,0,0,9,152
"TCATACTGTACCGTCG",0,0,2,0,0,2,66
"TCATACTGTACGTGAG",0,0,2,0,0,2,102
"TCATACTGTAGGCAGT",1,5,4,0,2,12,521
"TCATACTGTCCGGTGT",2,48,12,4,4,70,1795
"TCATACTGTCGACTGC",1,2,0,0,0,3,60
"TCATACTTCAGAGTTC",0,0,0,0,0,0,0
"TCATATCAGGAGAGGC",2,29,14,2,7,54,664
"TCATATCAGGGCATGT",0,2,3,0,0,5,68
"TCATATCCAGGGAATC",3,49,13,4,7,76,122
"TCATATCCATGCCATA",2,2,0,0,0,4,18
"TCATATCCATGGCCCA",141,370,101,21,71,704,36433
"TCATATCGTAACACCT",0,4,2,0,0,6,186
"TCATATCGTCGAAACG",0,2,0,0,0,2,63
"TCATATCTCGCTGCGA",1,5,0,0,0,6,169
"TCATATCTCTCCTGTG",2,8,2,0,2,14,442
"TCATCATAGATTACCC",0,4,2,0,0,6,14
"TCATCATAGTCAAGCG",0,3,0,0,0,3,176
"TCATCATCAAGATGTA",1,8,2,0,4,15,148
"TCATCATCAGACCAGA",25,99,23,6,12,165,8861
"TCATCATCATAGAAAC",1,10,6,0,5,22,421
"TCATCATGTCGTACAT",8,32,36,3,5,84,3473
"TCATCATTCATGACAC",3,25,4,0,6,38,966
"TCATCATTCATTCGGA",4,31,13,0,2,50,1111
"TCATCATTCCAAAGGG",2,3,0,0,2,7,155
"TCATCATTCTATGTGG",7,39,52,0,11,109,5277
"TCATCCGAGCAGGTCA",0,7,2,0,3,12,147
"TCATCCGAGGATAATC",4,27,2,3,6,42,631
"TCATCCGAGGGTAGCT",5,27,22,3,10,67,2274
"TCATCCGCAATTCGTG",338,2383,711,175,463,4070,210208
"TCATCCGCAATTGTGC",15,57,95,9,22,198,10032
"TCATCCGCAGTAGAAT",0,0,0,0,0,0,4
"TCATCCGCATAACTCG",2,6,0,0,0,8,132
"TCATCCGGTGCGTCGT",0,0,4,0,0,4,74
"TCATCCGGTTGGCTAT",0,3,0,0,0,3,36
"TCATCCGTCACCTTAT",0,4,0,0,0,4,62
"TCATCCGTCCGAGGCT",0,3,0,0,0,3,25
"TCATCCGTCTGTACAG",3,18,6,0,6,33,443
"TCATGAGAGATTACCC",0,4,0,0,0,4,150
"TCATGAGAGCAAGTCG",1,6,3,2,3,15,322
"TCATGAGAGGATTCAA",0,3,0,0,0,3,12
"TCATGAGCAAGCGCAA",15,54,106,7,17,199,10065
"TCATGAGCAATTGAGA",0,2,0,0,0,2,14
"TCATGAGCATTACTCT",0,7,0,0,0,7,178
"TCATGAGTCCCTTCCC",6,36,10,2,27,81,2537
"TCATGAGTCTACCAGA",1,3,0,0,2,6,94
"TCATGCCAGCATCAGG",2,15,4,2,8,31,882
"TCATGCCAGGTTGGTG",3,16,3,0,2,24,974
"TCATGCCCAAGGATGC",23,81,27,5,16,152,6851
"TCATGCCGTACGGGAT",0,9,0,0,0,9,239
"TCATGCCGTATTAAGG",3,25,18,3,8,57,1891
"TCATGCCGTCCAGCAC",4,33,11,2,8,58,1201
"TCATGCCGTCGCATTA",2,21,6,4,4,37,1705
"TCATGCCGTGTTCGAT",347,271,418,58,139,1233,53554
"TCATGCCTCAGTCATG",3,2,3,0,6,14,420
"TCATGCCTCGGTGTAT",18,105,26,5,22,176,6680
"TCATGGAAGAAGCGGG",0,0,0,0,0,0,1
"TCATGGAAGGAAACGA",1,10,2,0,0,13,171
"TCATGGAAGTTGTAAG",2,33,14,0,8,57,613
"TCATGGACAGCTACTA",0,0,0,0,0,0,63
"TCATGGACAGTTGTCA",1,36,9,0,4,50,592
"TCATGGATCACTACTT",2,32,8,0,5,47,860
"TCATGTTAGTGTAGAT",29,19,5,2,6,61,3175
"TCATGTTCAAATACAG",1,27,7,0,4,39,556
"TCATGTTCACTAGAGG",0,10,4,0,2,16,100
"TCATGTTGTCGCATTA",9,46,48,5,8,116,4021
"TCATGTTGTTGTAAAG",0,2,2,0,0,4,93
"TCATGTTTCCAGCCTT",0,8,0,0,3,11,254
"TCATGTTTCGGACGTC",0,0,0,0,0,0,15
"TCATTACAGCACACAG",3,22,8,0,0,33,809
"TCATTACAGTAACCGG",4,33,13,0,4,54,645
"TCATTACAGTTGTAGA",1,17,6,0,0,24,226
"TCATTACGTGCGGTAA",0,11,2,0,2,15,291
"TCATTACTCACTACTT",0,2,0,0,0,2,12
"TCATTACTCCACTGAA",5,25,5,2,6,43,636
"TCATTACTCTGTGCGG",1,2,2,0,0,5,91
"TCATTCAAGGGAGTTC",0,3,0,0,0,3,13
"TCATTCAAGGTGTGAC",0,2,0,0,0,2,30
"TCATTCATCAGTCTTT",56,23,19,6,18,122,5583
"TCATTCATCGCTGCGA",0,3,0,0,0,3,132
"TCATTCATCTGATTCT",0,3,0,0,0,3,93
"TCATTCATCTTGCAGA",6,27,24,0,9,66,1956
"TCATTGTAGCTCATAC",0,8,2,0,0,10,79
"TCATTGTAGGATTCCT",1,12,2,0,0,15,220
"TCATTGTGTCTTACTT",1,3,2,0,0,6,82
"TCATTGTGTGGACTGA",1,0,3,0,0,4,54
"TCATTGTTCACTTCTA",0,4,0,0,2,6,140
"TCATTGTTCAGACAAA",0,6,4,0,0,10,176
"TCATTTGAGGAACGAA",1,6,0,0,0,7,63
"TCATTTGCAAGGTACG",0,13,4,0,2,19,105
"TCATTTGCACGTGAGA",1,25,5,0,5,36,935
"TCATTTGCAGTAACCT",0,0,2,0,0,2,11
"TCATTTGCATTGACTG",0,0,0,0,0,0,27
"TCATTTGGTCGTGCCA",4,19,5,2,2,32,390
"TCATTTGTCGGCTATA",2,23,6,0,3,34,612
"TCATTTGTCGGTAACT",3,9,3,0,0,15,610
"TCCACCAAGAGAGCCT",5,22,11,0,4,42,784
"TCCACCAAGATGACAT",9,35,28,3,11,86,3837
"TCCACCAAGGGATGTC",0,0,0,0,0,0,84
"TCCACCACAAGACTGG",0,0,0,0,0,0,10
"TCCACCACACTTCATT",5,37,18,5,13,78,1555
"TCCACCACAGAGAAAG",2,2,0,0,4,8,274
"TCCACCAGTCCATAGT",0,3,5,0,0,8,190
"TCCACCAGTCTGTGAT",32,301,100,16,56,505,25344
"TCCACCAGTTTAGACC",22,145,57,113,40,377,18122
"TCCACGTCATGCTGCG",1,18,2,2,2,25,450
"TCCACGTGTACAGTTC",0,2,2,0,0,4,97
"TCCACGTGTGGTCCCA",1,17,3,0,3,24,551
"TCCAGAAAGCGCTTCG",2,27,7,3,2,41,1005
"TCCAGAACACGCTGTG",4,36,10,0,6,56,1032
"TCCAGAACACTGTGTA",1,25,5,3,5,39,844
"TCCAGAACAGCATGCC",13,73,16,7,12,121,2573
"TCCAGAACAGCGACCT",1,15,9,0,5,30,757
"TCCAGAAGTGAGCAGT",0,4,0,0,0,4,96
"TCCAGAAGTTCCTTGC",3,32,14,0,6,55,720
"TCCAGAAGTTTCGGCG",0,4,0,3,0,7,116
"TCCAGAATCGAGCTGC",0,9,2,0,0,11,133
"TCCAGAATCTCCAATT",5,23,11,2,7,48,532
"TCCATCGAGCAGGGAG",0,3,2,0,0,5,195
"TCCATCGAGCTTCTAG",0,14,4,3,4,25,442
"TCCATCGAGTCGCGAA",0,3,0,0,2,5,225
"TCCATCGAGTGTTCAC",1,17,3,0,5,26,618
"TCCATCGCAAGACAAT",1,3,3,0,0,7,107
"TCCATCGGTAGATGTA",0,2,0,0,0,2,10
"TCCATCGGTATACGGG",3,25,4,2,4,38,875
"TCCATCGGTCGAGTTT",4,17,7,0,2,30,687
"TCCATCGGTGCTGATT",70,426,110,29,86,721,36206
"TCCATGCAGTACCGGA",60,479,108,36,85,768,36540
"TCCATGCAGTTCCTGA",5,15,2,0,7,29,597
"TCCATGCGTGAGAACC",1,4,0,0,0,5,73
"TCCATGCGTGATTAGA",0,5,0,0,0,5,147
"TCCATGCGTTGCATGT",3,14,0,0,0,17,240
"TCCATGCTCGGATAAA",1,19,7,0,0,27,344
"TCCCACAAGCCACAAG",65,209,487,32,81,874,40295
"TCCCACAAGCCTTCTC",89,348,315,47,242,1041,49784
"TCCCACAAGGAACGAA",1,2,2,0,0,5,119
"TCCCACAAGGCTCCCA",0,0,0,0,0,0,3
"TCCCACAGTAGCACAG",0,0,0,0,0,0,17
"TCCCACAGTATAGGAT",2,20,3,0,4,29,117
"TCCCAGTAGACTTCAC",17,114,34,8,22,195,8796
"TCCCAGTCAAATAAGC",1,8,0,0,0,9,157
"TCCCAGTGTGGTACAG",1,5,2,0,2,10,111
"TCCCAGTTCCACCCTA",1,20,0,0,5,26,311
"TCCCAGTTCGAAACAA",0,2,3,0,0,5,121
"TCCCAGTTCGGAGTGA",5,26,8,0,7,46,896
"TCCCATGCACGTAGAG",1,0,0,0,0,1,19
"TCCCATGCATTGCTTT",2,24,7,0,2,35,419
"TCCCATGGTACGACTT",1,11,5,0,0,17,398
"TCCCATGGTAGCTTGT",14,57,92,8,25,196,9951
"TCCCATGGTGATATAG",1,3,0,0,0,4,60
"TCCCATGTCGGCATTA",2,14,9,2,4,31,633
"TCCGAAAAGAGAGTTT",1,40,10,3,2,56,522
"TCCGAAAAGATTAGTG",4,47,14,4,25,94,2953
"TCCGAAAAGGCCACCT",0,3,0,2,0,5,197
"TCCGAAACAAGACTGG",2,22,8,0,5,37,536
"TCCGAAACACACCAGC",0,2,0,0,0,2,22
"TCCGAAACACAGTCAT",7,39,7,0,17,70,1592
"TCCGAAACACCGCTAG",3,7,0,0,0,10,266
"TCCGAAACATACACCA",0,9,4,0,2,15,243
"TCCGAAAGTAGACGGT",0,2,0,0,0,2,193
"TCCGAAAGTGCTTATG",1,13,6,0,5,25,458
"TCCGAAATCCAACCGG",109,885,209,72,156,1431,64580
"TCCGATCAGTACCGGA",1,15,0,0,0,16,98
"TCCGATCCAAGAGGTC",0,2,0,0,0,2,25
"TCCGATCCACTCTGCT",1,21,11,4,7,44,1072
"TCCGATCCACTTGAGT",1,5,0,0,0,6,63
"TCCGATCCATAGGTAA",7,23,20,6,37,93,3722
"TCCGATCTCAGCGTCG",0,50,4,10,6,70,390
"TCCGATCTCCGTCAAA",2,10,2,0,0,14,257
"TCCGATCTCGCTTAAG",9,34,20,4,66,133,7123
"TCCGGGAAGGGTCACA",2,15,4,0,3,24,574
"TCCGGGACACTGTCGG",0,3,0,0,0,3,72
"TCCGGGAGTACTGCGC",0,0,0,0,0,0,52
"TCCGGGAGTCGCGTCA",0,0,2,0,0,2,20
"TCCGGGAGTGGCTGCT",13,123,31,6,20,193,7938
"TCCGGGAGTGTGGACA",1,7,2,0,0,10,85
"TCCGGGATCAAACTGC",16,52,28,5,79,180,7470
"TCCGGGATCCTTGACC",0,8,3,0,0,11,563
"TCCGGGATCGAGTCCG",3,22,12,0,3,40,839
"TCCGTGTCAACGACAG",0,5,0,0,0,5,28
"TCCGTGTCACACCTGG",37,251,61,38,54,441,21859
"TCCGTGTTCAAGCTTG",0,10,0,0,2,12,435
"TCCGTGTTCACCGGTG",2,9,3,0,2,16,761
"TCCGTGTTCGCAACAT",0,3,4,0,0,7,123
"TCCTAATAGAGCCGTA",3,32,9,0,7,51,870
"TCCTAATAGAGTACCG",108,200,75,16,43,442,18041
"TCCTAATAGCGACATG",0,6,0,0,0,6,41
"TCCTAATAGTCACTCA",1,4,0,0,0,5,260
"TCCTAATCAAGCGATG",3,24,6,0,2,35,1144
"TCCTAATCACAGCTTA",10,14,6,0,5,35,2104
"TCCTAATTCGATGCTA",0,0,0,0,0,0,1
"TCCTAATTCTTTGGAG",2,13,0,0,0,15,190
"TCCTCCCAGAGGGCGA",0,0,0,0,0,0,12
"TCCTCCCAGGCTTCCG",0,0,0,0,0,0,24
"TCCTCCCCAAATAGCA",0,21,4,0,2,27,606
"TCCTCCCGTAGCGATG",0,3,0,0,0,3,144
"TCCTCCCTCATAGCAC",24,89,261,15,51,440,20525
"TCCTCCCTCCAATCTT",0,5,0,0,3,8,205
"TCCTCCCTCGAGCACC",0,2,0,0,0,2,61
"TCCTCCCTCGTAGGGA",0,6,0,0,0,6,58
"TCCTCCCTCTAGATCG",1,2,0,0,0,3,103
"TCCTCCCTCTGGGTCG",1,6,0,0,0,7,135
"TCCTCGAAGAGCAGCT",19,75,132,6,112,344,20683
"TCCTCGAAGGACCCAA",5,25,11,0,0,41,1077
"TCCTCGAAGTCATGCT",25,72,168,14,27,306,15000
"TCCTCGACACGCGCTA",0,2,0,0,0,2,143
"TCCTCGACATAACTCG",4,14,5,0,0,23,383
"TCCTCGAGTCATCCGG",1,18,3,2,3,27,671
"TCCTCGATCGCGCCAA",0,0,0,0,0,0,53
"TCCTCTTAGACTCGAG",0,9,0,2,3,14,186
"TCCTCTTAGGAGAATG",13,98,24,7,18,160,8116
"TCCTCTTCAACAGATA",335,714,219,62,168,1498,64123
"TCCTCTTCAACTGATC",0,5,0,0,0,5,158
"TCCTCTTCAGATCCTA",2,5,0,0,0,7,210
"TCCTCTTCATGGAAGC",0,6,0,0,2,8,180
"TCCTCTTTCCGGTTCT",91,206,68,15,41,421,19980
"TCCTGCAAGCGCATCC",6,22,9,2,6,45,1160
"TCCTGCACAAAGACGC",0,4,0,0,0,4,176
"TCCTGCACAATTGTGC",1,3,3,0,0,7,112
"TCCTGCACACTGTGTA",0,0,2,0,0,2,16
"TCCTGCACAGTAGTGG",2,11,2,2,3,20,767
"TCCTGCAGTGGCGTAA",20,18,5,2,3,48,1297
"TCCTGCATCAATGTCG",1,5,4,0,0,10,135
"TCCTGCATCCAATCTT",1,2,2,0,0,5,208
"TCCTGCATCGCCAATA",2,20,3,2,7,34,694
"TCCTGCATCTTTGATC",2131,837,539,158,436,4101,172695
"TCCTTCTAGAAGCGGG",2,11,5,2,4,24,443
"TCCTTCTAGGTCACAG",2,7,2,0,0,11,99
"TCCTTCTAGTAAGACT",4,30,8,0,7,49,782
"TCCTTCTCAAACTAAG",3,24,3,2,4,36,540
"TCCTTCTCAAGTTCGT",13,43,92,4,19,171,7535
"TCCTTCTCACAATGTC",0,7,2,0,0,9,174
"TCCTTCTGTACGATTC",1,7,0,0,2,10,188
"TCCTTCTGTCGTTCAA",2,27,5,2,4,40,506
"TCCTTCTTCTACCAGA",0,6,6,0,0,12,146
"TCCTTCTTCTTCGGAA",1,2,0,0,0,3,24
"TCCTTTCCAAGAATAC",0,2,0,0,0,2,12
"TCCTTTCTCGCGGTAC",0,7,3,0,0,10,186
"TCGAACACAAGCCCAC",1,6,0,0,0,7,327
"TCGAACACACTGGATT",0,6,0,0,0,6,209
"TCGAACACAGACCTGC",58,291,101,273,69,792,30875
"TCGAACACAGCTGTTA",0,10,0,0,0,10,40
"TCGAACATCTTGGATG",0,8,3,0,0,11,218
"TCGAAGTAGACCAGCA",30,101,102,22,126,381,14007
"TCGAAGTAGTCTCCTC",2,25,12,0,2,41,645
"TCGAAGTAGTTACGGG",0,2,0,0,0,2,66
"TCGAAGTCAATGTCTG",3,19,2,2,0,26,530
"TCGAAGTCAATGTGGG",0,4,0,0,0,4,113
"TCGAAGTGTAACTAAG",1,18,6,0,5,30,366
"TCGAAGTTCGACCAAT",0,10,6,0,0,16,371
"TCGAAGTTCGAGAAAT",1,15,7,0,2,25,1015
"TCGAAGTTCTCCCTAG",5,19,8,0,4,36,481
"TCGAAGTTCTCGTCGT",2,21,3,0,4,30,336
"TCGAAGTTCTTACACT",0,28,5,2,3,38,649
"TCGACCTAGATGACCG",93,359,90,39,65,646,25221
"TCGACCTCAACCAACT",56,239,243,19,66,623,29002
"TCGACCTTCTAACGGT",1,21,4,2,2,30,280
"TCGACGGCACCCTAGG",1,29,7,0,3,40,542
"TCGACGGCACTAGGCC",0,2,0,0,0,2,3
"TCGACGGCAGCTCTGG",1,11,3,0,4,19,47
"TCGACGGCATATGCGT",0,3,0,0,0,3,26
"TCGACGGGTCTTTATC",18,49,96,7,22,192,9317
"TCGACGGGTTAGGGTG",0,0,0,0,0,0,22
"TCGATTTAGATCCTAC",10,52,21,2,63,148,6785
"TCGATTTAGTTCTCTT",3,6,5,2,3,19,389
"TCGATTTCACGACTAT",0,6,0,0,0,6,167
"TCGATTTGTTGCAAGG",1,2,0,0,0,3,21
"TCGCACTAGCTGCCAC",21,169,36,9,25,260,9443
"TCGCACTCAGGGACTA",0,4,0,0,0,4,228
"TCGCACTCAGTGTATC",0,0,0,0,0,0,5
"TCGCACTGTTCCTACC",1,14,8,0,0,23,626
"TCGCACTTCTCCTGAC",6,26,12,0,29,73,2573
"TCGCACTTCTTGCGCT",2,13,4,0,2,21,158
"TCGCAGGAGACCGCCT",2,18,2,0,0,22,513
"TCGCAGGAGGCAGGGA",2,5,2,0,3,12,126
"TCGCAGGCAAGTACCT",0,0,2,0,2,4,133
"TCGCAGGCAGCGCGTT",1,2,4,0,0,7,223
"TCGCAGGCATCAGTCA",68,257,433,30,87,875,39137
"TCGCAGGCATCTGTTT",2,13,6,2,4,27,835
"TCGCAGGCATTCAGGT",23,107,26,8,25,189,6898
"TCGCAGGCATTGAGGG",0,6,0,0,0,6,119
"TCGCAGGGTGAACGGT",0,3,0,2,0,5,48
"TCGCAGGGTGCTATTG",0,2,0,0,0,2,51
"TCGCAGGGTGGCAGAT",0,0,0,0,0,0,26
"TCGCAGGGTTCTTGTT",0,0,0,0,0,0,2
"TCGCAGGTCCGATCTC",0,7,2,0,2,11,522
"TCGCAGGTCGCATTAG",30,152,206,23,47,458,23052
"TCGCAGGTCGCTTGCT",2,10,2,0,0,14,30
"TCGCAGGTCGTCTAAG",1,6,3,0,0,10,32
"TCGCAGGTCTCCTGAC",1,17,9,0,4,31,491
"TCGCTCAAGACTCATC",2,30,9,2,6,49,1484
"TCGCTCAAGCCTGGAA",0,0,0,0,0,0,3
"TCGCTCACAAGCAGGT",0,6,0,0,0,6,156
"TCGCTCACACTTGTGA",0,3,8,0,0,11,636
"TCGCTCATCCAACCAA",2,24,5,0,7,38,621
"TCGCTCATCTATTGTC",0,22,11,0,5,38,645
"TCGCTTGAGGAAAGTG",0,0,0,0,0,0,13
"TCGCTTGAGTAGGAAG",2,3,2,0,2,9,196
"TCGCTTGGTAGTCTTG",0,2,0,0,0,2,26
"TCGCTTGGTATGAGCG",33,125,241,18,110,527,26783
"TCGCTTGGTTGTCTAG",1,13,2,0,2,18,801
"TCGCTTGTCCATTGGA",2,14,7,0,3,26,830
"TCGCTTGTCCCGTTCA",1,15,5,3,3,27,975
"TCGCTTGTCCGTTGGG",1,0,0,0,0,1,38
"TCGCTTGTCTGGGATT",4,35,13,2,22,76,2641
"TCGCTTGTCTGGGCAC",0,2,0,0,0,2,12
"TCGGATACAAGAGTAT",3,18,7,0,6,34,793
"TCGGATAGTCTCAGAT",0,10,4,0,2,16,202
"TCGGATAGTTTGCAGT",0,5,0,0,2,7,141
"TCGGATATCAAGCCTA",2,3,0,0,0,5,206
"TCGGATATCGCAGTCG",103,62,19,5,17,206,4474
"TCGGGACAGAGTATAC",0,2,0,0,2,4,126
"TCGGGACAGCTAATGA",0,5,0,0,0,5,127
"TCGGGACAGTAGTCCT",3,21,5,0,5,34,812
"TCGGGACAGTGACACG",0,0,0,0,0,0,41
"TCGGGACCAGTCGAGA",0,2,0,0,0,2,27
"TCGGGACGTACACGTT",69,30,20,8,16,143,4926
"TCGGGACGTATTGGCT",1,10,2,0,2,15,242
"TCGGGACGTCTACGAT",0,5,2,0,0,7,181
"TCGGGACGTTGATGTC",18,146,99,12,80,355,18755
"TCGGGACTCAAACTGC",0,4,2,0,0,6,177
"TCGGGACTCCGGTAAT",43,333,75,19,63,533,20748
"TCGGGCAAGATTGCGG",0,7,5,0,0,12,562
"TCGGGCAAGGACTATA",16,83,25,3,18,145,5315
"TCGGGCAAGGTAGTCG",0,2,0,0,0,2,74
"TCGGGCACACAAGTGG",0,0,0,0,0,0,25
"TCGGGCAGTGCATGTT",0,0,0,0,0,0,41
"TCGGGCAGTTGTTTGG",1,5,0,0,0,6,199
"TCGGGCATCGAACGGA",0,4,0,0,0,4,127
"TCGGGTGCAAATGCGG",1,3,3,0,2,9,438
"TCGGGTGCAAGGATGC",38,322,82,11,54,507,22191
"TCGGGTGCAATAACCC",1,9,3,0,2,15,174
"TCGGGTGCACTGAGGA",1,5,0,0,2,8,220
"TCGGGTGGTAGATCGG",14,67,52,4,17,154,7275
"TCGGGTGGTATCAAGA",0,4,0,0,0,4,76
"TCGGGTGGTCACTACA",0,3,0,0,0,3,82
"TCGGGTGTCCTCACGT",0,2,2,0,0,4,56
"TCGGGTGTCTGGTCAA",1,0,0,0,0,1,17
"TCGGTCTAGTGATAAC",4,19,8,0,0,31,505
"TCGGTCTCAACAACAA",1,14,2,0,0,17,462
"TCGGTCTCACCTTCCA",1,3,6,0,2,12,136
"TCGGTCTTCCCGGTAG",11,36,13,3,52,115,3814
"TCGTAGAAGTAAACAC",5,32,12,0,11,60,909
"TCGTAGAAGTATTCCG",0,0,0,0,0,0,9
"TCGTAGACAATTCTCT",83,645,169,47,137,1081,52803
"TCGTAGACAGGCTTGC",0,4,0,0,0,4,129
"TCGTAGACAGTGGGTA",2,19,5,0,3,29,448
"TCGTAGAGTGCCTGAC",0,5,0,0,3,8,80
"TCGTAGATCACCGGGT",0,4,0,0,4,8,127
"TCGTAGATCAGACTGT",1,2,0,0,0,3,45
"TCGTAGATCGAGTTGT",0,0,0,0,0,0,133
"TCGTCCACAGGCGATA",1,21,6,2,2,32,406
"TCGTCCAGTGTCCCTT",0,0,0,0,0,0,3
"TCGTCCAGTTCATCGA",0,6,0,0,0,6,150
"TCGTCCATCCTTCGAC",9,52,11,0,8,80,2829
"TCGTCCATCGACCAAT",61,310,74,18,54,517,21009
"TCGTCCATCGATGGAG",3,30,10,0,6,49,650
"TCGTCCATCGCATGAT",0,0,0,0,0,0,11
"TCGTGCTAGAACTTCC",9,136,43,6,14,208,6241
"TCGTGCTAGATGTAGT",1,6,0,0,2,9,130
"TCGTGCTAGGCAGTCA",0,20,20,0,20,60,1286
"TCGTGCTAGGCCTAAG",0,10,11,0,6,27,603
"TCGTGCTAGTCGGGAT",2,3,0,0,2,7,113
"TCGTGCTCACAGTCAT",0,0,0,0,0,0,37
"TCGTGCTCACCTGATA",0,2,0,0,0,2,15
"TCGTGCTTCAACGAGG",0,2,0,0,0,2,14
"TCGTGCTTCGGTGTTA",0,5,3,0,3,11,194
"TCGTGGGAGATTAGTG",0,5,0,0,0,5,52
"TCGTGGGAGTGGTCAG",85,72,41,10,14,222,5243
"TCGTGGGCAACCGACC",0,3,0,0,0,3,49
"TCGTGGGGTAATTGGA",1,0,0,0,0,1,30
"TCGTGGGGTAGTCGGA",0,0,0,0,0,0,38
"TCGTGGGGTCATCGCG",0,2,2,0,0,4,49
"TCGTGGGGTCGCAACC",0,16,2,0,4,22,35
"TCGTGGGTCCCTTTGG",3,12,5,0,0,20,443
"TCGTGGGTCTTTCTAG",0,2,0,0,0,2,77
"TCTAACTAGGTCCCTG",0,7,0,0,2,9,138
"TCTAACTAGGTCGACA",8,79,20,5,16,128,7641
"TCTAACTAGTAAGCAT",1,5,0,0,0,6,70
"TCTAACTTCGACCCAG",209,254,80,19,81,643,28668
"TCTACATCAGACACAG",0,8,0,0,2,10,511
"TCTACATCAGCCCACA",0,2,0,0,0,2,77
"TCTACATGTGTAGTGG",0,5,0,0,0,5,150
"TCTACATTCTACAGGT",3,18,9,3,20,53,2177
"TCTACATTCTCAGTCC",1,3,0,0,2,6,136
"TCTACCGAGCCTAGGA",21,89,67,8,25,210,10285
"TCTACCGAGGATTTGA",0,3,3,0,2,8,252
"TCTACCGGTAGTCGTT",3,25,7,0,5,40,852
"TCTACCGGTCAGACTT",11,36,51,2,13,113,5723
"TCTACCGGTCGGTAAG",2,9,3,2,2,18,671
"TCTACCGGTCTCTCCA",3,7,0,3,2,15,317
"TCTACCGTCCCGAACG",1,12,2,0,3,18,509
"TCTATACAGAGAACCC",80,221,104,22,54,481,21864
"TCTATACAGCAATAGT",1,6,0,0,0,7,158
"TCTATACAGCCACAAG",0,8,3,0,2,13,710
"TCTATACAGGGACTGT",0,0,0,0,0,0,11
"TCTATACCACCACATA",0,3,2,0,0,5,220
"TCTATACCAGAGATGC",47,266,60,17,53,443,17378
"TCTATACCAGAGGTTG",5,8,2,0,2,17,453
"TCTATACCAGGAACCA",0,3,0,0,0,3,13
"TCTATACGTCAGACTT",1,3,0,0,0,4,21
"TCTATACGTTAATCGC",0,0,0,0,0,0,174
"TCTATACTCTATCGGA",2,10,16,0,3,31,1150
"TCTATCAAGATAACAC",5,46,59,5,10,125,5298
"TCTATCAAGTAGAATC",0,0,0,0,2,2,39
"TCTATCAAGTGTGTTC",2,32,11,3,8,56,709
"TCTATCAGTCTGTAGT",7,56,12,2,8,85,1092
"TCTATCAGTTTACGTG",0,0,0,0,0,0,10
"TCTATCATCCTAAGTG",1,28,8,0,3,40,452
"TCTCACGAGCGTGAAC",0,3,0,0,0,3,206
"TCTCACGAGGGAGATA",1,30,10,0,0,41,653
"TCTCACGAGGTGCCAA",0,11,0,0,0,11,168
"TCTCACGCAACACAAA",0,2,3,0,2,7,66
"TCTCACGGTTGACTGT",1,24,5,0,3,33,1519
"TCTCACGTCGCGGACT",0,0,2,0,0,2,84
"TCTCACGTCTCCCTAG",1,8,2,0,0,11,151
"TCTCAGCAGAGGTCAC",1,6,0,0,0,7,145
"TCTCAGCCAATAGTAG",0,0,0,0,0,0,4
"TCTCAGCCATAGGCGA",0,2,2,0,0,4,113
"TCTCAGCCATGCCGAC",0,0,0,0,0,0,2
"TCTCAGCGTCAGCTTA",2,17,6,3,4,32,572
"TCTCAGCGTTTCGCTC",1,7,0,2,0,10,79
"TCTCAGCTCACCCATC",0,0,0,0,0,0,19
"TCTCAGCTCCGGCTTT",0,2,0,0,0,2,34
"TCTCAGCTCGGTCTGG",8,33,12,0,5,58,1317
"TCTCAGCTCTCATGCC",14,38,89,2,11,154,6366
"TCTCCGAAGACCGCCT",0,2,0,0,0,2,11
"TCTCCGAAGAGGCCAT",2,23,4,0,4,33,743
"TCTCCGAGTGACAACG",2,10,0,0,0,12,632
"TCTCCGAGTTGGACCC",3,19,6,0,3,31,483
"TCTCCGATCATTCCTA",124,877,296,56,174,1527,55160
"TCTCCGATCGATAACC",0,2,0,0,0,2,4
"TCTCCGATCTCTCCGA",1,18,9,0,5,33,999
"TCTCTGGAGGCGTTAG",2,25,6,0,19,52,1200
"TCTCTGGAGTAAACGT",0,17,4,0,3,24,501
"TCTCTGGAGTCTTCGA",5,21,41,5,5,77,3802
"TCTCTGGCAAATGGTA",0,8,3,0,0,11,81
"TCTCTGGCAACCCTCT",1,8,2,0,0,11,195
"TCTCTGGTCACACCCT",4,37,69,5,18,133,6294
"TCTCTGGTCACTGGTA",1,3,6,0,0,10,472
"TCTCTGGTCTGAGAAA",5,24,5,3,6,43,56
"TCTCTGGTCTGTCCGT",1,23,8,0,7,39,1069
"TCTGCCAAGTATAGGT",1,5,0,0,0,6,131
"TCTGCCACAAAGCGTG",4,25,7,0,3,39,819
"TCTGCCACAAGAAATC",2,23,7,0,5,37,751
"TCTGCCACATCACGGC",0,0,0,0,0,0,14
"TCTGCCAGTCGCTGCA",42,334,73,20,47,516,22735
"TCTGCCAGTCTTGCGG",2,8,4,0,0,14,384
"TCTGCCATCGTGTGGC",0,2,2,0,0,4,155
"TCTGCCATCTCCGATC",3,16,0,0,0,19,735
"TCTGGCTAGCGACTAG",8,34,21,3,26,92,2510
"TCTGGCTCAAACGTGG",2,0,3,2,2,9,399
"TCTGGCTCAACCGCTG",6,27,10,4,38,85,3988
"TCTGGCTCAACTGCTA",0,12,2,0,0,14,313
"TCTGGCTCATAAGCAA",1,7,0,0,0,8,100
"TCTGGCTGTAGTTAGA",20,98,92,13,116,339,13618
"TCTGGCTGTCCAGCGT",0,5,0,2,0,7,71
"TCTGGCTGTCCAGTTA",67,497,132,36,87,819,47288
"TCTGGCTGTCTTTCAT",1,4,2,0,0,7,182
"TCTGGCTTCCGGTAGC",9,87,27,10,18,151,5300
"TCTGGCTTCGGAATGG",6,24,38,4,9,81,4156
"TCTGGCTTCTCACCCA",0,0,0,0,0,0,9
"TCTGTCGAGACTGTTC",17,55,24,88,23,207,7756
"TCTGTCGCAAATGAGT",14,93,18,4,16,145,7135
"TCTGTCGCAATCTGCA",0,9,2,0,0,11,511
"TCTGTCGCATTCCTCG",5,25,10,2,20,62,1685
"TCTGTCGTCATGCCGG",1,19,4,0,2,26,705
"TCTGTCGTCTGTGTGA",0,3,0,0,0,3,102
"TCTTAGTAGAAGCGAA",3,12,7,0,3,25,466
"TCTTAGTAGAATCCCT",0,0,0,0,0,0,4
"TCTTAGTAGACAAGCC",0,7,0,0,0,7,139
"TCTTAGTGTGCCGTAC",300,146,72,23,59,600,25096
"TCTTCCTAGAAATGGG",0,4,2,0,0,6,147
"TCTTCCTAGTTGAAGT",4,26,4,0,4,38,783
"TCTTCCTTCCGCCTAT",0,2,0,0,0,2,3
"TCTTCCTTCGGTCTGG",0,7,0,0,0,7,261
"TCTTCCTTCTCACCCA",3,21,6,2,3,35,893
"TCTTGCGAGAGAGTGA",1,11,0,0,2,14,293
"TCTTGCGAGCATTTGC",0,2,0,0,0,2,13
"TCTTGCGAGGATTTAG",0,4,0,0,2,6,54
"TCTTGCGAGTGCACTT",2,6,2,0,0,10,64
"TCTTGCGCAAAGAACT",1,11,3,0,2,17,619
"TCTTGCGCACGTAACT",5,11,5,0,4,25,1069
"TCTTGCGCACTCAGAT",1,9,2,0,0,12,432
"TCTTGCGGTATGTGTC",0,4,3,0,0,7,256
"TCTTGCGTCCTCTCTT",2,9,0,0,0,11,113
"TCTTGCGTCTAAGAAG",7,62,23,4,14,110,4101
"TCTTTGAAGCACACCC",10,27,50,5,7,99,3924
"TCTTTGAAGGAATGTT",0,3,2,0,0,5,130
"TCTTTGAAGGGATGTC",0,2,0,0,0,2,161
"TCTTTGAAGTTGGACG",24,178,39,13,33,287,14105
"TCTTTGACAATGAAAC",3,42,9,2,6,62,923
"TCTTTGACACTGGAAG",3,6,2,0,0,11,398
"TCTTTGACAGAGGAAA",3,11,8,0,4,26,560
"TCTTTGACAGAGTCAG",56,220,64,27,49,416,12866
"TCTTTGACAGCACAGA",0,9,0,0,4,13,164
"TCTTTGACATATCTCT",1,9,0,0,0,10,213
"TCTTTGAGTTGTTGCA",1,19,6,0,0,26,638
"TCTTTGATCCCATACC",1,4,2,0,0,7,23
"TGAACGTAGATACTGA",1,3,2,0,0,6,132
"TGAACGTAGGAGTACC",0,3,0,0,0,3,22
"TGAACGTAGTATTCCG",17,52,69,4,12,154,5710
"TGAACGTCAATGAAAC",2,29,9,0,6,46,597
"TGAACGTCAGACCTGC",0,2,0,0,2,4,76
"TGAACGTCATAATCGC",2,24,6,0,2,34,654
"TGAACGTGTTTCAGAC",398,259,113,35,84,889,35830
"TGAACGTTCCAACACA",2,3,0,0,0,5,118
"TGAACGTTCCGATCGG",1,18,6,0,5,30,621
"TGAACGTTCCGTGTGG",9,34,4,0,5,52,1599
"TGAACGTTCCTCACCA",1,16,3,0,0,20,738
"TGAATCGAGATGTTCC",3,27,9,0,2,41,558
"TGAATCGAGGAACGTC",0,3,0,0,0,3,148
"TGAATCGAGTAAAGCT",0,3,2,0,0,5,153
"TGAATCGCAAGTGATA",2,27,3,2,2,36,595
"TGAATCGCACTAACCA",45,313,71,13,50,492,22156
"TGAATCGCATTACGGT",3,25,16,0,4,48,1689
"TGAATCGGTATGCGTT",0,8,0,0,0,8,47
"TGAATCGGTCGAAGCA",0,5,3,0,0,8,63
"TGAATCGGTTTACGAC",1,3,0,0,0,4,108
"TGAATCGTCCCAAGTA",0,0,0,0,0,0,8
"TGAATCGTCTAGCAAC",3,5,0,0,0,8,174
"TGAATCGTCTGAGCAT",23,41,16,3,9,92,3183
"TGAATGCAGAATAACC",1,0,0,0,0,1,25
"TGAATGCAGCCATTCA",0,0,0,0,0,0,66
"TGAATGCAGCGCTTCG",0,6,0,0,0,6,90
"TGAATGCCAGAGTGTG",1,4,0,0,0,5,123
"TGAATGCTCAAACCTG",0,2,0,0,0,2,140
"TGAATGCTCGGTATGT",2,22,3,6,5,38,662
"TGAATGCTCTGCATAG",7,25,9,0,6,47,484
"TGACAGTAGATGTTAG",0,0,0,0,0,0,33
"TGACAGTAGGTCCCTG",42,124,136,27,210,539,26057
"TGACAGTCAGAGTTGG",0,0,0,0,0,0,94
"TGACAGTGTACCTAAC",1,6,5,0,0,12,80
"TGACAGTGTTAGGCCC",1,18,7,0,0,26,416
"TGACAGTTCATTCTTG",0,0,0,0,0,0,91
"TGACAGTTCGAGTGAG",2,29,3,0,8,42,454
"TGACCCTAGGTAGTAT",65,584,136,21,100,906,42705
"TGACCCTCACCTGCGA",2,16,4,2,5,29,530
"TGACCCTGTACGGTTT",0,3,0,0,0,3,32
"TGACCCTGTTGGGACA",1,11,0,0,3,15,148
"TGACCCTTCGCCGATG",31,84,237,15,40,407,21521
"TGACCCTTCGTGGGAA",27,32,13,3,10,85,2587
"TGACGCGAGCAAATCA",2,8,0,0,0,10,172
"TGACGCGCACCTAAAC",1,5,0,0,0,6,68
"TGACGCGGTAATGCTC",1,10,0,0,0,11,89
"TGACGCGGTAGGTCAG",0,8,2,0,0,10,179
"TGACGCGGTCGGTGTC",26,82,43,14,207,372,15051
"TGACGCGGTCTTCAAG",2,17,4,0,4,27,1364
"TGACGCGGTTGGGAAC",0,4,2,0,0,6,206
"TGACTCCAGCATCTTG",0,0,0,0,0,0,11
"TGACTCCCATTCAGGT",3,24,4,0,8,39,640
"TGACTCCGTCTAACGT",0,3,0,0,0,3,12
"TGACTCCGTGATACCT",8,51,25,0,13,97,4053
"TGACTCCTCTCGACCT",2,11,0,0,0,13,36
"TGACTCCTCTGTTCAT",0,0,3,0,0,3,50
"TGAGACTTCGACATAC",0,2,0,0,0,2,20
"TGAGACTTCGTCCTCA",4,31,16,0,10,61,633
"TGAGCATAGCTTACGT",3,16,0,0,2,21,480
"TGAGCATAGGAACGTC",28,80,192,17,36,353,17117
"TGAGCATCAGCTATAC",0,2,2,0,0,4,84
"TGAGCATCATAGAATG",69,534,217,39,82,941,41847
"TGAGCATCATCGAACT",1,2,2,0,0,5,213
"TGAGCATCATTGGATC",0,9,0,0,0,9,237
"TGAGCATGTAGACTGG",47,116,277,20,73,533,20107
"TGAGCATGTGGCCTCA",3,22,4,0,4,33,635
"TGAGCATTCCGAGCTG",14,53,145,8,24,244,8960
"TGAGCATTCTCATGGA",4,26,9,0,4,43,246
"TGAGCATTCTCGAGTA",13,81,21,5,17,137,7324
"TGAGCGCAGAAACCCG",0,2,0,0,0,2,146
"TGAGCGCCAATTGGTC",17,51,31,7,14,120,3621
"TGAGCGCCACAGAGCA",85,475,195,47,337,1139,47659
"TGAGCGCCAGCAGATG",0,5,2,0,2,9,44
"TGAGCGCCAGCTGCCA",6,43,16,3,7,75,2005
"TGAGCGCCAGTCCCGA",0,4,0,0,0,4,46
"TGAGCGCGTGACGTCC",1,12,3,2,14,32,908
"TGAGCGCTCCCTCTTT",0,2,0,0,0,2,69
"TGAGCGCTCCGCATAA",0,5,0,0,0,5,159
"TGAGCGCTCTTCACAT",4,26,3,0,4,37,1229
"TGAGCGCTCTTGAACG",0,4,2,0,0,6,355
"TGAGGAGAGCCACAAG",7,33,42,2,21,105,4594
"TGAGGAGCATGTGGTT",12,90,21,4,22,149,4736
"TGAGGAGGTAGACTGG",0,5,0,0,0,5,153
"TGAGGAGGTGTGTGGA",0,4,0,0,0,4,38
"TGAGGAGTCCGAGGCT",0,10,3,0,2,15,90
"TGAGGAGTCGCGGTAC",4,10,7,0,3,24,491
"TGAGGGAAGAGCTGCA",0,6,0,0,0,6,99
"TGAGGGAAGCTCCGAC",2,3,0,0,0,5,126
"TGAGGGACACAGCTTA",0,23,5,0,0,28,461
"TGAGGGAGTAGGAAAG",2,26,12,0,8,48,635
"TGAGGGAGTGTCTAAC",0,0,0,0,0,0,3
"TGAGGGATCAAGCTTG",0,3,0,0,2,5,163
"TGAGGGATCATGAAAG",0,12,3,0,0,15,336
"TGAGGGATCCAAACCA",2,5,3,0,0,10,175
"TGAGGGATCTTAGGAC",2,4,5,0,0,11,74
"TGAGGTTAGGGCAACT",11,54,12,2,11,90,3935
"TGAGGTTAGGTAACTA",0,0,0,0,0,0,8
"TGAGGTTAGTAGCCAG",0,4,0,0,2,6,162
"TGAGGTTAGTGTAGTA",2,11,8,2,0,23,293
"TGAGGTTCAAATCGTC",2,30,12,0,6,50,1037
"TGAGGTTGTCTAGGCC",1,21,6,0,0,28,58
"TGAGGTTTCACACCCT",1,12,2,0,3,18,205
"TGAGGTTTCAGCTTCC",3,20,6,2,3,34,501
"TGAGGTTTCTCCTGCA",10,39,43,2,9,103,3181
"TGAGTCAAGTCAGCCC",0,2,2,0,0,4,82
"TGAGTCACAAACGAGC",2,16,6,0,3,27,922
"TGAGTCAGTACTGAGG",2,4,3,0,0,9,158
"TGAGTCATCACAGAGG",1,0,0,0,2,3,13
"TGAGTCATCATTGCTT",2,23,3,0,2,30,995
"TGAGTCATCCAACACA",2,14,6,0,3,25,397
"TGATCAGAGCTTCGTA",0,3,0,0,0,3,12
"TGATCAGAGTGGTCAG",6,23,9,4,29,71,2197
"TGATCAGCACGCTATA",5,7,2,0,0,14,571
"TGATCAGCATCTCATT",0,0,0,0,0,0,22
"TGATCAGGTCATCAGT",1,0,0,0,0,1,171
"TGATCAGGTCTTACTT",42,99,45,74,36,296,12334
"TGATCAGGTTTCTATC",1,17,4,0,2,24,557
"TGATCAGTCACAGTGT",2,15,2,0,3,22,773
"TGATCTTAGGCTCAAG",25,74,171,10,28,308,15697
"TGATCTTCAGTGGCTC",2,5,0,0,0,7,180
"TGATCTTGTATGTCTG",15,81,25,22,16,159,7284
"TGATCTTGTCGGCACT",2,29,7,0,5,43,970
"TGATCTTTCAGTGCGC",1,3,0,0,0,4,128
"TGATCTTTCCATACAG",0,0,2,0,0,2,6
"TGATGCAAGACATATG",4,26,14,0,3,47,1031
"TGATGCACAACCACAT",1,8,0,0,0,9,117
"TGATGCACATCTCAAG",3,16,5,0,2,26,48
"TGATGCAGTAACATGA",0,3,0,0,0,3,25
"TGATGCAGTAGTTAGA",1,2,2,0,0,5,66
"TGATGCATCTCAGAAC",1,7,2,0,0,10,209
"TGATGCATCTGAGATC",0,2,0,0,0,2,264
"TGATGGTAGCCTATTG",53,128,321,26,58,586,33762
"TGATGGTAGGCACAAC",0,2,0,0,0,2,66
"TGATGGTCATTGCAAC",37,243,62,18,41,401,21580
"TGATGGTGTAGTGCGA",3,13,3,0,5,24,373
"TGATGGTGTCGTTGCG",5,17,3,0,4,29,494
"TGATGGTGTGACTGTT",1,5,0,0,0,6,136
"TGATGGTTCCGTCCTA",38,102,227,16,47,430,20677
"TGATTCTAGCCGGAAT",2,29,7,0,4,42,614
"TGATTCTAGTCTGCAT",0,7,4,0,3,14,186
"TGATTCTCACTTCTCG",2,10,2,0,2,16,553
"TGATTCTGTCAGTCCG",515,230,147,37,109,1038,49138
"TGATTCTGTCTTGCTC",0,5,3,0,0,8,133
"TGATTCTGTGCTGATT",1,22,3,2,2,30,513
"TGATTCTGTGTTCCTC",0,4,0,0,0,4,42
"TGATTTCAGAAACTGT",0,3,0,0,0,3,7
"TGATTTCAGTCATGGG",0,0,0,0,0,0,109
"TGATTTCCAAGAGATT",15,99,28,6,13,161,6388
"TGATTTCCAAGTTGGG",2,29,8,0,8,47,847
"TGATTTCCACACCGCA",1,8,0,0,0,9,358
"TGATTTCTCAGGACAG",0,0,0,0,0,0,32
"TGATTTCTCTGTCTCG",72,56,24,8,18,178,7016
"TGCACGGAGATGAACT",3,11,5,0,0,19,407
"TGCACGGAGCAAGGAA",1,4,3,0,0,8,165
"TGCACGGCACGACTAT",1,7,0,0,0,8,229
"TGCAGATCAATGTTGC",1,4,2,0,0,7,96
"TGCAGATCATGTCGTA",37,211,66,81,47,442,15400
"TGCAGATGTCCCTGAG",0,5,3,0,2,10,115
"TGCAGATTCTGCATAG",0,2,2,0,0,4,197
"TGCAGGCCAAGCGGAT",2,14,0,0,3,19,733
"TGCAGGCCACCAAATC",0,2,0,0,0,2,188
"TGCAGGCTCGACATCA",3,19,3,0,5,30,505
"TGCAGGCTCTCATGCC",1,22,7,2,0,32,597
"TGCAGTAAGACCATAA",1,8,0,0,0,9,117
"TGCAGTAAGTGCACTT",29,85,72,11,156,353,16631
"TGCAGTACAACTCGAT",5,38,9,0,5,57,2923
"TGCAGTACACAAAGCG",16,48,22,117,24,227,9078
"TGCAGTACAGGAATCG",2,6,5,0,7,20,399
"TGCAGTACATGGCTGC",0,6,0,0,5,11,556
"TGCAGTAGTGCGAGTA",0,0,0,0,0,0,14
"TGCAGTATCCTGGGTG",1,0,0,0,0,1,14
"TGCATCCCAAATCAAG",1,3,0,0,0,4,167
"TGCATCCCAAGCAATA",3,14,2,5,3,27,353
"TGCATCCGTACTAACC",15,133,27,5,22,202,7300
"TGCATCCGTAGAGACC",2,9,3,0,0,14,32
"TGCATCCGTAGGTTTC",107,274,821,47,155,1404,68186
"TGCATCCGTGAATTGA",4,10,0,0,0,14,94
"TGCATCCTCAGCTTCC",0,2,0,0,0,2,10
"TGCATGAAGGACTTCT",1,4,4,0,0,9,92
"TGCATGAAGGCATGCA",2,22,9,2,4,39,672
"TGCATGAAGTATGTAG",13,55,77,8,24,177,6658
"TGCATGACAACTCGAT",0,3,0,0,0,3,85
"TGCATGACAATTGCCA",1,19,4,8,4,36,623
"TGCATGACAGACATCT",1,0,2,0,2,5,76
"TGCATGAGTAGCCAGA",0,4,2,0,0,6,159
"TGCATGAGTGTCTCCT",1,0,0,0,0,1,13
"TGCATGATCAGTGGGA",2,17,14,0,3,36,1199
"TGCATGATCCCGATCT",0,0,0,0,0,0,5
"TGCATGATCTGGACTA",6,12,7,4,3,32,154
"TGCCGAGAGTGTTCAC",0,0,2,0,0,2,14
"TGCCGAGCAAGATGGC",0,3,0,0,0,3,110
"TGCCGAGCAGGCGAAT",0,21,2,0,3,26,61
"TGCCGAGGTCACAGAG",5,103,18,10,17,153,7155
"TGCCGAGGTTCGTACA",0,0,0,0,0,0,25
"TGCGACGAGCTGGAGT",0,2,0,0,2,4,39
"TGCGACGAGTGTCATC",5,43,9,0,7,64,1945
"TGCGACGCACAGTCAT",0,2,2,0,2,6,177
"TGCGACGCAGTCGAGA",10,5,3,0,3,21,597
"TGCGACGCATCGTGCG",0,4,0,0,0,4,96
"TGCGACGGTACCTAGT",0,3,0,0,2,5,154
"TGCGACGGTGGATCAG",7,31,55,3,12,108,5016
"TGCGACGGTTATGACC",0,6,3,0,0,9,172
"TGCGACGTCTCGACCT",1,23,6,0,3,33,832
"TGCGATACAAGTCCAT",4,17,4,2,3,30,574
"TGCGATACAGGATTCT",14,101,32,8,19,174,7037
"TGCGATACAGTGGCTC",0,4,0,0,5,9,86
"TGCGATAGTCCAGGTC",2,0,0,0,0,2,216
"TGCGATAGTCCATAGT",9,55,14,0,7,85,3946
"TGCGATATCAAGCGTT",0,0,0,0,0,0,26
"TGCGATATCCAACACA",90,238,623,52,149,1152,58660
"TGCGGCAAGAAGGGAT",1,14,7,0,2,24,523
"TGCGGCAAGACGTCCC",0,4,2,0,2,8,332
"TGCGGCACAATGCAGG",1,5,2,0,2,10,386
"TGCGGCACAGGAATAT",2,29,3,0,8,42,122
"TGCGGCAGTCAAATCC",0,4,0,0,2,6,196
"TGCGGCAGTGGATCAG",5,14,4,0,5,28,1785
"TGCGGCATCAACACGT",0,0,2,0,0,2,72
"TGCGGCATCTGTGCTC",0,4,0,0,0,4,126
"TGCGGGTAGACATAGT",2,8,0,0,0,10,201
"TGCGGGTAGCTTGTTG",1,5,2,0,0,8,58
"TGCGGGTAGGGAGGGT",9,29,59,3,7,107,4688
"TGCGGGTCACAAATCC",0,0,0,0,0,0,8
"TGCGGGTGTGATAGTA",3,19,16,4,6,48,1724
"TGCGGGTTCTCATTAC",0,4,0,0,0,4,132
"TGCGGGTTCTTGAGCA",23,124,35,10,22,214,8848
"TGCTCCACATGACTCA",0,7,4,0,0,11,163
"TGCTCCAGTCATCCGG",2,6,0,0,0,8,62
"TGCTCCAGTCCCTGTT",2,3,0,0,2,7,187
"TGCTCCAGTCTAATCG",1,5,2,0,0,8,129
"TGCTCCAGTTCTCTCG",3,31,13,2,8,57,1268
"TGCTCCAGTTTCGGCG",3,6,0,0,0,9,141
"TGCTCCATCCCGAGGT",0,7,2,0,0,9,263
"TGCTCGTAGTGATTCC",12,42,41,6,12,113,3986
"TGCTCGTCACCCAATA",0,2,0,0,0,2,65
"TGCTCGTCACTCCCTA",3,19,7,0,2,31,816
"TGCTCGTGTACGACTT",32,214,78,10,45,379,14166
"TGCTCGTGTATACCCA",19,192,75,11,32,329,11605
"TGCTCGTGTATGGTAA",352,838,252,53,166,1661,59271
"TGCTCGTGTCGTACAT",0,0,2,0,0,2,20
"TGCTCGTTCAAACCCA",4,15,4,0,4,27,350
"TGCTCGTTCGGTCGAC",2,17,12,0,6,37,804
"TGCTGAAAGGCCCAAA",10,73,19,5,49,156,6304
"TGCTGAACAATTGCAC",2,20,5,3,4,34,547
"TGCTGAACACACCTTC",0,6,0,0,0,6,125
"TGCTGAACAGAATCGG",11,56,11,3,9,90,4515
"TGCTGAACAGGACTTT",0,11,6,0,4,21,324
"TGCTGAACATCTAACG",0,10,0,0,0,10,102
"TGCTGAAGTATGACAA",0,4,2,0,0,6,141
"TGCTGAATCAGCTTGA",0,2,0,0,0,2,13
"TGCTTCGAGATGAAGG",3,23,7,0,6,39,378
"TGCTTCGCACCTGATA",1,7,0,0,0,8,143
"TGCTTCGCACTTCAAG",0,0,5,0,0,5,77
"TGCTTCGCATGGAAGC",0,7,0,0,0,7,230
"TGCTTCGCATTGCCTC",4,4,0,0,0,8,303
"TGCTTGCAGAGCAGTC",31,306,57,13,35,442,21435
"TGCTTGCAGGCAGCTA",3,26,9,3,27,68,2806
"TGCTTGCCACATTCGA",1,17,2,2,0,22,268
"TGCTTGCCATGGAATA",106,205,73,65,54,503,19300
"TGCTTGCGTATTTCGG",0,5,0,0,0,5,118
"TGCTTGCGTTAAACAG",0,0,0,0,0,0,3
"TGCTTGCGTTGGAGGT",0,0,0,0,0,0,43
"TGCTTGCTCAGGCGAA",1,2,0,0,0,3,51
"TGCTTGCTCCGACGGT",2,8,0,0,0,10,158
"TGGAACTAGAAGTCTA",4,21,12,0,5,42,633
"TGGAACTAGCGACCCT",0,3,0,0,0,3,100
"TGGAACTCAAGACGGT",0,2,0,0,0,2,25
"TGGAACTCAATCGCCG",3,13,10,0,2,28,1286
"TGGAACTCAGCTATTG",0,7,0,0,2,9,171
"TGGAACTCAGTCTACA",12,42,73,6,17,150,5669
"TGGAACTCATCCCACT",0,8,4,0,0,12,86
"TGGAACTCATTCACAG",0,5,3,0,0,8,138
"TGGAACTGTCACTCTC",9,40,39,5,22,115,4713
"TGGAACTTCACTGGTA",0,0,0,0,0,0,113
"TGGAACTTCGTGCTCT",5,22,6,0,8,41,495
"TGGAGAGAGCAGCGAT",3,20,6,0,4,33,75
"TGGAGAGAGCTGTACT",3,26,7,0,4,40,407
"TGGAGAGAGGGTGAGG",2,20,8,0,4,34,322
"TGGAGAGCAACACGTT",0,0,0,0,0,0,14
"TGGAGAGCAATTGCGT",154,670,201,45,139,1209,52789
"TGGAGAGCATGAATCC",178,1163,259,78,235,1913,81826
"TGGAGAGCATGACGTT",39,126,248,15,71,499,24759
"TGGAGAGGTACTTGTG",1,8,0,0,2,11,665
"TGGAGAGTCAAACGAA",0,0,0,0,0,0,11
"TGGAGAGTCACCTTGC",2,3,0,0,0,5,125
"TGGAGGAAGAACGTGC",1,31,9,0,3,44,448
"TGGAGGACACTGTTCC",0,3,0,0,0,3,206
"TGGAGGAGTAGTTACC",0,9,4,0,0,13,73
"TGGAGGAGTCCACACG",0,0,0,0,4,4,26
"TGGAGGATCAACTGAC",0,21,3,3,2,29,436
"TGGAGGATCCTACACC",0,6,0,0,0,6,51
"TGGATCAAGAAAGTCT",3,23,7,0,3,36,414
"TGGATCAAGCAATTCC",0,0,0,0,0,0,22
"TGGATCAAGCTTAGTC",0,13,5,0,0,18,63
"TGGATCAAGGCAATGC",28,210,69,22,37,366,19520
"TGGATCACAAACGAGC",35,342,63,19,49,508,20186
"TGGATCACACCGTACG",0,12,0,0,2,14,362
"TGGATCACAGGACAGT",0,8,2,0,0,10,79
"TGGATCACAGTTAAAG",3,5,3,0,0,11,180
"TGGATCACATGCGTGC",1,2,4,0,0,7,230
"TGGATCACATGTGGCC",3,17,2,0,6,28,523
"TGGATCAGTCGGATTT",27,177,54,11,40,309,12499
"TGGATCATCAAGAAAC",4,33,6,0,4,47,702
"TGGATCATCCTGATAG",0,4,3,0,0,7,105
"TGGATGTAGATGAAGG",0,4,0,0,2,6,215
"TGGATGTAGCTTACGT",1,2,0,0,0,3,57
"TGGATGTAGTCTCCTC",2,2,0,0,2,6,191
"TGGATGTCAATTCTCT",0,0,0,0,0,0,10
"TGGATGTCACAGACGA",0,3,2,0,0,5,93
"TGGATGTCATGTTTGG",0,3,0,0,0,3,20
"TGGATGTGTACTGCGC",1,2,2,0,0,5,153
"TGGATGTGTCACTAGT",0,2,0,0,0,2,234
"TGGATGTTCCGGACTG",1,9,0,0,0,10,317
"TGGCGTGAGAAGCGAA",107,267,261,52,680,1367,61835
"TGGCGTGCAGCGGATA",4,25,2,2,7,40,575
"TGGCGTGCAGGAGGTT",1,5,2,2,0,10,107
"TGGCGTGCATCTAACG",0,7,0,0,0,7,81
"TGGCGTGGTGAATAAC",0,3,2,0,0,5,61
"TGGCGTGGTTCCTAGA",0,5,2,0,2,9,202
"TGGCGTGTCGCAGTGC",1,6,0,0,0,7,77
"TGGCGTGTCTCTCAAT",1,15,5,2,0,23,507
"TGGGAAGAGGCGTTAG",1,0,0,0,3,4,270
"TGGGAAGCACCAGCGT",2,11,2,0,3,18,416
"TGGGAAGGTAGCGATG",2,3,0,0,0,5,57
"TGGGAAGGTATTCCGA",1,3,4,0,2,10,226
"TGGGAAGGTTATTCTC",1,10,2,0,3,16,146
"TGGGAAGTCCCTCGAT",1,22,10,0,4,37,733
"TGGGAAGTCGTTGCCT",14,31,9,2,4,60,734
"TGGGAGAAGGGTAATT",5,29,4,0,2,40,447
"TGGGAGAAGTTATGGA",1,0,2,0,0,3,76
"TGGGAGACAAAGGATT",0,3,0,0,2,5,90
"TGGGAGACAATTGAAG",5,26,7,2,3,43,712
"TGGGAGACACACACTA",1,4,0,0,0,5,115
"TGGGAGACATCCGTGG",1,6,0,2,0,9,227
"TGGGAGACATTGTACG",5,32,56,4,10,107,3764
"TGGGAGAGTGGTCTTA",0,2,0,0,0,2,48
"TGGGAGAGTTGCATTG",0,20,0,0,8,28,486
"TGGGAGATCATAGCAC",3,2,0,0,0,5,120
"TGGGATTAGCCGTTGC",2,11,4,0,3,20,515
"TGGGATTGTAGACGGT",1,5,5,2,0,13,140
"TGGGATTGTTAGAGTA",66,446,127,26,85,750,39548
"TGGGATTTCCATAAGC",0,5,2,0,2,9,67
"TGGGATTTCCGCATAA",0,3,0,0,2,5,150
"TGGGATTTCGCAGTCG",2,18,20,2,4,46,1465
"TGGGCGTCACTATCGA",70,385,129,132,156,872,40532
"TGGGCGTCAGTCGCTG",3,17,5,0,3,28,343
"TGGGCGTGTATCGAGG",1,7,3,0,13,24,511
"TGGGCGTTCTCGACGG",3,46,10,0,9,68,1741
"TGGGCTGCATCTTTCA",0,25,7,0,4,36,465
"TGGGCTGGTGCGGTAA",18,59,73,8,80,238,10314
"TGGGCTGGTGTAGCAG",3,11,4,2,6,26,773
"TGGGCTGGTTCGGTAT",0,3,0,0,0,3,394
"TGGGCTGGTTTCGGCG",1,4,2,2,0,9,74
"TGGGCTGTCCTACGGG",1,6,2,0,0,9,134
"TGGGTTAAGTAAGGGA",0,0,0,0,0,0,4
"TGGGTTACAGTCAGCC",41,112,135,23,141,452,18958
"TGGGTTAGTCCTTAAG",0,0,0,0,0,0,12
"TGGGTTAGTGACGTCC",0,0,0,0,0,0,16
"TGGGTTAGTGCTAGCC",1,5,2,0,2,10,114
"TGGGTTATCACAGTGT",1,12,0,0,0,13,108
"TGGGTTATCCACTAGA",1,8,0,0,0,9,87
"TGGGTTATCCCTTGGT",0,0,0,0,0,0,17
"TGGGTTATCCTAACAG",3,3,0,0,2,8,144
"TGGGTTATCTCATTAC",0,0,0,0,0,0,27
"TGGTACAAGATACCAA",1,36,7,0,2,46,1086
"TGGTACAAGTGGTGAC",0,0,0,0,0,0,8
"TGGTACACAAGAGTGC",1,5,0,0,0,6,112
"TGGTACACAGTCCGTG",1,3,2,0,0,6,69
"TGGTACAGTCGAACGA",0,20,2,0,5,27,36
"TGGTACAGTGTCATTG",0,0,0,0,0,0,28
"TGGTACATCCCTATTA",2,29,6,0,0,37,538
"TGGTAGTAGGCACCAA",1,35,6,2,2,46,2018
"TGGTAGTAGGTGCAGT",4,16,2,0,4,26,364
"TGGTAGTCAGCCGTCA",0,3,0,0,0,3,29
"TGGTAGTCATGTGGCC",1,2,0,0,0,3,24
"TGGTAGTGTCTTACAG",17,61,104,10,24,216,9027
"TGGTAGTGTGCAACAG",87,171,54,18,41,371,15193
"TGGTAGTTCATGCCAA",6,38,12,3,8,67,3186
"TGGTGATCAAAGGATT",0,5,4,0,0,9,154
"TGGTGATCAATTAGGA",2,14,9,0,3,28,571
"TGGTGATGTCCGTTTC",4,24,13,0,5,46,724
"TGGTGATGTCCTTAAG",1,6,2,0,0,9,316
"TGGTGATGTTAGAGAT",2,25,7,0,6,40,731
"TGGTGATTCCCATAGA",0,0,0,0,0,0,1
"TGGTGATTCCGTCCTA",3,37,6,3,4,53,659
"TGGTTAGAGAGGTTTA",2,20,6,0,8,36,462
"TGGTTAGAGGAGTATT",0,0,0,0,0,0,6
"TGGTTAGCACCTATCC",4,27,10,0,7,48,1483
"TGGTTAGGTCACCTTC",1,11,2,2,0,16,49
"TGGTTAGGTTAAGTCC",0,5,0,0,0,5,100
"TGGTTAGGTTCCGCAG",6,22,4,0,4,36,568
"TGTAACGAGCGTTCCG",0,4,0,0,0,4,51
"TGTAACGAGGTGCTTT",3,23,6,0,5,37,749
"TGTAACGCAAGTGGTG",0,7,0,0,0,7,172
"TGTAACGCATCAGCTA",0,2,0,0,0,2,11
"TGTAACGGTTAAGAAC",7,13,4,2,2,28,912
"TGTAACGGTTGTTGTG",21,48,108,3,27,207,9662
"TGTAACGTCATTATCC",36,93,231,18,42,420,20564
"TGTAAGCAGCCTTTCC",1,12,0,0,4,17,348
"TGTAAGCAGTCTTCGA",0,3,0,0,0,3,89
"TGTAAGCCACCGTACG",33,16,9,5,9,72,2391
"TGTAAGCGTGTCTCCT",2,2,2,0,0,6,102
"TGTAAGCTCCCAGGAC",1,7,0,0,2,10,494
"TGTACAGAGATGTTAG",0,6,0,0,0,6,79
"TGTACAGAGCAGCCCT",1,8,4,0,0,13,731
"TGTACAGGTCAAGGCA",1,14,2,0,0,17,418
"TGTACAGGTCGCATCG",28,96,185,14,49,372,18247
"TGTACAGGTTATGACC",0,5,0,0,0,5,120
"TGTACAGTCGGCTGGT",1,6,0,0,2,9,60
"TGTACAGTCTTGCAAG",2,26,9,0,4,41,530
"TGTAGACAGCCTATCA",0,4,0,0,0,4,81
"TGTAGACCAGTTTCGA",0,11,0,0,2,13,127
"TGTAGACTCTGACAGT",175,1459,357,82,248,2321,114855
"TGTCAGAAGCTGGCCT",3,21,3,2,5,34,562
"TGTCAGACAAATGGCG",6,27,40,3,12,88,3771
"TGTCAGACAGATGCGA",5,14,4,0,5,28,779
"TGTCAGACATGGAGAC",17,55,105,9,21,207,7927
"TGTCAGAGTGGAAGTC",3,21,22,0,8,54,1702
"TGTCAGATCATTACGG",1,19,5,2,7,34,440
"TGTCAGATCCTTCTGG",0,20,2,0,0,22,353
"TGTCAGATCGTCGACG",24,121,265,8,48,466,16606
"TGTCAGATCTGTCGCT",42,381,78,20,49,570,24911
"TGTCCACAGAGCCTGA",0,5,0,0,0,5,11
"TGTCCACAGTTGCGCC",1,3,0,0,0,4,164
"TGTCCACCAATTTCCT",3,9,5,2,3,22,545
"TGTCCACGTGCCCACA",1,5,0,0,0,6,155
"TGTCCACGTTTACTTC",0,4,0,0,2,6,39
"TGTCCCAAGCGCTGAA",0,2,3,0,0,5,44
"TGTCCCAGTAACGTTC",0,0,0,0,0,0,64
"TGTCCCATCGACGAGA",0,3,0,0,0,3,137
"TGTCCTGAGATCGCCC",3,23,9,0,5,40,1160
"TGTCCTGAGGTAAGTT",1,4,2,0,0,7,69
"TGTCCTGCATATCTCT",5,41,5,0,6,57,1302
"TGTCCTGGTGGCTACC",11,86,20,5,22,144,6134
"TGTCCTGGTGTCTAAC",2,2,0,0,0,4,25
"TGTCCTGGTTCCCAAA",0,7,0,0,0,7,142
"TGTCCTGTCCTTACCG",277,185,81,20,63,626,23869
"TGTCCTGTCGAAACAA",3,22,10,0,3,38,565
"TGTGAGTAGATCCTAC",22,171,43,14,28,278,11280
"TGTGAGTAGGTGATCG",45,270,73,17,63,468,22512
"TGTGAGTGTGGAAATT",1,24,4,0,6,35,75
"TGTGAGTTCAGTGGGA",125,682,221,58,140,1226,52317
"TGTGAGTTCGCCGAGT",2,17,7,3,6,35,879
"TGTGAGTTCGTACCTC",1,8,0,0,3,12,106
"TGTGATGAGTGGAATT",0,0,0,0,0,0,7
"TGTGATGCACTACGGC",5,20,6,0,2,33,572
"TGTGATGCATTAGGAA",315,559,336,972,244,2426,111533
"TGTGATGGTGTACAGG",1,7,3,0,0,11,280
"TGTGATGTCCATCACC",1,33,3,0,2,39,950
"TGTGATGTCCCAAGCG",1,4,0,0,2,7,82
"TGTGCGGAGCCGTTGC",4,18,8,0,6,36,808
"TGTGCGGAGGTATTGA",0,3,0,0,0,3,82
"TGTGCGGAGTCGAGGT",1,4,0,0,0,5,56
"TGTGCGGCAAGACAAT",1,8,2,0,3,14,521
"TGTGCGGCACACTTAG",0,2,0,0,0,2,12
"TGTGCGGCACAGCGCT",0,5,0,0,0,5,101
"TGTGCGGCATACCATG",1,2,0,0,0,3,153
"TGTGCGGGTACTTCCC",1,2,0,0,0,3,104
"TGTGCGGGTCCTTAAG",22,61,41,5,17,146,7651
"TGTGCGGGTGATACAA",4,29,7,0,3,43,2742
"TGTGCGGGTGTACAGG",0,3,2,0,0,5,72
"TGTGCGGGTTGCGGCT",13,42,25,8,88,176,8714
"TGTGCGGTCCCAAGCG",1,3,0,0,0,4,53
"TGTGCGGTCTTACCGC",6,38,32,0,7,83,4788
"TGTGGCGAGCGTACAG",1,3,0,0,0,4,129
"TGTGGCGAGGCTAACG",0,8,2,0,0,10,113
"TGTGGCGAGGGAGTTC",1,3,0,0,0,4,60
"TGTGGCGCAGAAGTTA",45,265,88,34,65,497,20769
"TGTGGCGGTAACCAGG",0,0,0,0,0,0,11
"TGTGGCGGTAGAATGT",0,0,0,0,0,0,1
"TGTGGCGGTCACTCAA",26,72,44,16,160,318,13958
"TGTGGCGGTTCAGGTT",1,0,0,0,0,1,6
"TGTGGCGTCAGCTCTC",1,6,0,0,2,9,140
"TGTGGCGTCATTGCGA",85,140,71,155,46,497,17158
"TGTGGCGTCCGAGATT",0,5,0,0,0,5,24
"TGTGGCGTCTTCGTAT",0,4,0,0,0,4,64
"TGTGTGAAGAGGGTGG",1,6,0,0,0,7,105
"TGTGTGAAGCAGGCTA",0,13,2,0,3,18,327
"TGTGTGAAGGTGGGTT",34,261,77,17,61,450,22328
"TGTGTGACAACCAGAG",0,4,2,0,0,6,85
"TGTGTGACAGACCATT",0,0,0,0,0,0,6
"TGTGTGACATTCACCC",0,3,2,0,0,5,202
"TGTGTGAGTTGCCTAA",0,8,0,0,0,8,81
"TGTGTGAGTTGTGCCG",0,5,0,0,0,5,213
"TGTTACTAGAGACAAG",3,40,11,0,4,58,1044
"TGTTACTCAGCCATTA",20,141,32,5,22,220,10349
"TGTTACTCATGACAGG",1,16,3,0,5,25,539
"TGTTACTCATGGAGAC",0,2,0,0,0,2,48
"TGTTACTGTCTTCAAG",1,7,0,0,0,8,148
"TGTTACTTCCAAAGGG",0,13,3,0,5,21,101
"TGTTACTTCCACAGGC",1,4,0,0,0,5,10
"TGTTACTTCTTCACGC",0,5,2,0,4,11,202
"TGTTCATAGGTAAACT",1,13,7,3,2,26,70
"TGTTCATGTCACTTCC",1,6,2,0,0,9,55
"TGTTCATGTCGGAAAC",2,7,0,0,2,11,58
"TGTTCATGTTCGGCCA",1,6,0,0,0,7,142
"TGTTCATGTTGGCCTG",4,10,3,0,2,19,197
"TGTTCATTCAAGGACG",0,6,2,0,0,8,293
"TGTTCATTCTCTTAAC",0,13,4,0,3,20,735
"TGTTCCGAGACGCTCC",0,6,2,0,0,8,147
"TGTTCCGAGAGTATAC",29,80,152,10,35,306,14303
"TGTTCCGCACGTCATA",0,4,3,0,2,9,104
"TGTTCCGCAGGTTCGC",0,5,0,0,0,5,149
"TGTTCCGGTACTGTTG",11,70,22,5,16,124,6047
"TGTTCCGGTCAGCGTC",0,8,18,0,0,26,416
"TGTTCCGGTGTTCATG",1,0,0,0,0,1,24
"TGTTCCGGTTTCAGAC",0,6,2,0,0,8,156
"TGTTCCGTCGAGAAAT",0,14,5,0,0,19,363
"TGTTCCGTCTCAGAAC",0,7,0,0,2,9,136
"TGTTCCGTCTGCATAG",2,17,13,0,3,35,687
"TGTTCCGTCTGTCGCT",1,0,0,0,0,1,35
"TGTTCTAAGTTTCAGC",0,2,0,2,0,4,172
"TGTTCTAGTAGATTAG",4,46,8,3,7,68,965
"TGTTCTAGTAGGCAAC",1,0,0,0,0,1,43
"TGTTCTATCATAGGCT",2,13,3,0,0,18,455
"TGTTGAGCAAGTCGTT",0,0,0,0,0,0,7
"TGTTGAGCAGCGAACA",5,23,5,0,4,37,424
"TGTTGAGCATAAGCAA",1,5,0,0,0,6,191
"TGTTGAGCATACCATG",0,7,0,0,2,9,99
"TGTTGAGGTCGTGCCA",0,0,0,0,0,0,36
"TGTTGAGGTCTGTCAA",27,58,121,12,33,251,11984
"TGTTGAGTCACGGGAA",1,2,2,0,0,5,106
"TGTTGAGTCCCAGGAC",0,0,0,0,0,0,11
"TGTTGAGTCGACACCG",0,0,0,0,0,0,18
"TGTTGAGTCGAGAGAC",3,27,5,0,3,38,557
"TGTTGAGTCTCTCTAA",0,3,0,0,2,5,43
"TGTTGGACACGCTATA",1,5,2,0,2,10,176
"TGTTGGAGTCATGACT",0,7,2,0,0,9,340
"TGTTGGAGTTCGGCCA",1,18,5,3,2,29,679
"TGTTGGAGTTGATCGT",1,0,0,0,0,1,18
"TGTTGGAGTTGTGGCC",1,0,0,0,0,1,37
"TGTTGGATCGGCGATC",2,8,5,0,0,15,377
"TGTTGGATCGTTAGTG",0,3,0,0,2,5,297
"TGTTGGATCTCCACTG",1,2,2,0,0,5,53
"TGTTTGTAGCAGGTCA",0,7,0,0,0,7,103
"TGTTTGTCACGGGTAA",2,5,4,0,0,11,107
"TTAATCCAGTTAGAAC",3,46,12,0,8,69,1304
"TTAATCCCAATCTCGA",1,7,0,0,0,8,164
"TTAATCCCAGCCCACA",0,27,9,0,3,39,1116
"TTAATCCCAGGTTCAT",0,0,0,0,0,0,7
"TTAATCCCAGTGACCC",3,15,6,0,3,27,505
"TTAATCCGTACGACTT",0,8,0,0,2,10,116
"TTAATCCGTATGCTTG",0,14,2,0,0,16,343
"TTAATCCGTTCGTGCG",1,3,2,0,0,6,63
"TTAATCCTCAAGCGTT",1,2,0,0,3,6,181
"TTAATCCTCGTCACCT",0,8,2,0,2,12,191
"TTACAGGAGCCGATTT",16,46,96,8,21,187,7726
"TTACAGGAGTGTGTTC",0,3,2,0,0,5,23
"TTACAGGGTATACCTG",2,33,9,3,7,54,1256
"TTACAGGTCGCTTACC",1,6,0,0,3,10,166
"TTACAGGTCTCGGGAC",0,14,2,0,2,18,270
"TTACCATAGTGATAAC",2,16,7,0,3,28,391
"TTACCATCAACAACAA",0,6,3,0,2,11,131
"TTACCATGTCATAGTC",1,20,13,2,3,39,828
"TTACCATGTTGTTTGG",8,34,46,6,9,103,3637
"TTACCATTCAAGCCAT",0,10,3,0,2,15,401
"TTACCGCAGAATCGAT",1,27,5,2,3,38,405
"TTACCGCCAATTAGGA",1168,6487,1832,920,1375,11782,488921
"TTACCGCCACTGAATC",1,7,0,0,0,8,297
"TTACCGCCATGGACAG",84,146,51,9,34,324,12394
"TTACCGCCATGGCGCT",0,9,2,0,0,11,126
"TTACCGCTCCATCTCG",0,0,0,0,0,0,157
"TTACCGCTCGCAAGAG",0,0,4,0,0,4,357
"TTACGCCAGACTCTTG",6,34,18,2,9,69,2323
"TTACGCCTCCGGCAGT",1,2,2,0,0,5,263
"TTACGTTAGCGAGGAG",15,44,69,8,23,159,5315
"TTACGTTCATCCTAAG",0,2,0,0,2,4,73
"TTACGTTGTACTTGTG",1,22,4,0,4,31,643
"TTACGTTGTATCTCGA",35,272,68,25,56,456,19817
"TTACGTTTCAAGAGGC",0,3,0,0,0,3,145
"TTACGTTTCACAGAGG",2,4,4,0,0,10,94
"TTACGTTTCGGATAAA",36,249,62,86,48,481,21693
"TTACTGTAGCCTCAAT",244,1637,406,101,310,2698,116900
"TTACTGTAGCTACAAA",0,3,0,0,0,3,50
"TTACTGTCATTCCTAT",1,4,2,0,2,9,166
"TTACTGTGTCACAATC",0,10,0,0,0,10,35
"TTACTGTGTCTGATAC",0,6,5,0,0,11,200
"TTACTGTGTTCCTAGA",0,3,0,0,2,5,102
"TTACTGTTCACCGCTT",14,45,46,6,11,122,4433
"TTACTGTTCCGACGGT",13,97,25,6,21,162,7123
"TTACTGTTCCGTACGG",3,18,8,0,3,32,529
"TTAGGCAAGACATATG",0,2,0,0,0,2,25
"TTAGGCACAAGTCCAT",4,28,11,3,3,49,1612
"TTAGGCACAGCAGGAT",49,187,48,18,38,340,12373
"TTAGGCAGTTCTTGTT",62,355,130,37,109,693,35005
"TTAGGCATCGACCAAT",0,5,0,0,0,5,195
"TTAGGCATCGGCTATA",0,7,6,0,0,13,159
"TTAGGCATCTAGAACC",1,6,2,0,0,9,179
"TTAGGGTAGTAGTCCT",0,10,2,0,0,12,365
"TTAGGGTCACCTTCCA",2,9,0,0,0,11,129
"TTAGGGTCACTTGTGA",1,7,0,0,0,8,126
"TTAGGGTCATGGAACG",8,57,13,0,11,89,3519
"TTAGGGTTCGTAGAGG",0,8,4,0,3,15,129
"TTAGGGTTCTGCTTTA",0,0,0,0,0,0,8
"TTAGTCTAGTGGGAAA",1,4,0,0,0,5,62
"TTAGTCTCATCATTGG",14,51,55,12,67,199,8279
"TTAGTCTCATCCCGTT",0,4,3,0,3,10,367
"TTAGTCTGTTGCCAAT",3,28,11,2,8,52,1516
"TTAGTCTTCCCGTTCA",0,3,0,0,0,3,72
"TTAGTCTTCTCCGAGG",0,4,0,0,0,4,132
"TTAGTCTTCTGGCCAG",9,28,29,6,11,83,3800
"TTATTGCCATGCCATA",0,4,3,0,0,7,125
"TTATTGCGTAGCCAGA",1,13,2,3,0,19,379
"TTATTGCGTGCCCAGT",1,8,3,0,0,12,218
"TTATTGCTCAAGGTGG",3,13,7,0,3,26,372
"TTATTGCTCGTCTCAC",9,42,27,4,20,102,4475
"TTATTGCTCTATCACT",31,183,46,18,35,313,13912
"TTCAATCAGGTACTGG",61,551,114,33,114,873,45321
"TTCAATCCAAACTCTG",0,5,0,0,0,5,61
"TTCAATCCATGCCGGT",1,19,3,2,3,28,577
"TTCAATCGTGCTGCAC",3,26,5,0,7,41,1013
"TTCAATCTCGACCCAG",0,3,0,0,0,3,71
"TTCACCGAGATCCCGC",1,8,0,0,0,9,147
"TTCACCGAGATGACAT",1,2,0,0,0,3,65
"TTCACCGAGTGATAGT",2,28,5,2,0,37,527
"TTCACCGCAACTCCAA",0,15,3,0,6,24,655
"TTCACCGCATCTGTTT",1,7,0,0,0,8,567
"TTCACCGGTAGCGCTC",2,19,5,0,3,29,522
"TTCACCGGTCGCTTAA",1,4,0,0,4,9,292
"TTCACCGGTCGTTGGC",2,13,5,0,6,26,409
"TTCACCGTCCACTAGA",3,32,4,0,5,44,817
"TTCACCGTCGGTCGGT",1,5,0,0,5,11,170
"TTCACGCAGACCGCCT",1,10,6,2,7,26,399
"TTCACGCAGCTTTCTT",0,0,0,0,0,0,3
"TTCACGCAGTTGCCCG",69,452,104,34,79,738,32787
"TTCACGCCAGAGGCTA",1,2,3,0,2,8,75
"TTCACGCGTATTTCTC",13,55,27,7,63,165,8324
"TTCACGCGTCGACTTA",2,0,0,0,0,2,58
"TTCACGCGTTCCGCGA",0,5,0,0,0,5,179
"TTCACGCTCCCAAGCG",0,3,0,0,0,3,16
"TTCACGCTCGGTCGGT",1,10,0,0,0,11,494
"TTCAGGACAAGACGGT",3,9,4,0,7,23,477
"TTCAGGACAATACGCT",0,5,4,0,2,11,49
"TTCAGGACAATCGTCA",0,7,0,0,0,7,116
"TTCAGGACACACCGAC",1,0,0,0,0,1,11
"TTCAGGACAGCGTTGC",4,17,2,0,4,27,286
"TTCAGGACAGGACAGT",0,3,2,0,0,5,153
"TTCAGGACATAAGCAA",4,22,11,5,28,70,2733
"TTCAGGAGTATTAAGG",0,6,0,0,0,6,102
"TTCAGGAGTCCTGGGT",1,21,0,0,3,25,469
"TTCAGGATCAGGAAGC",1,17,6,0,2,26,669
"TTCATGTAGATTCGAA",4,16,4,0,2,26,439
"TTCATGTAGCGAGTCA",18,150,68,13,20,269,8578
"TTCATGTAGGAGTATT",8,5,3,0,0,16,829
"TTCATGTCAGCTTTGA",0,4,0,0,0,4,171
"TTCATGTGTAATGTGA",8,27,10,0,9,54,970
"TTCATGTGTACTAGCT",1,20,6,0,5,32,486
"TTCATGTGTCACCGCA",0,5,2,0,0,7,189
"TTCATGTGTCCGGACT",0,5,2,0,0,7,157
"TTCATGTGTGAGCCAA",1,21,6,0,5,33,266
"TTCATGTGTTCGTTCC",0,14,3,0,0,17,89
"TTCATGTGTTTACTTC",12,44,54,10,53,173,9075
"TTCATGTTCCCGTTGT",5,25,8,0,0,38,416
"TTCATTGAGCCTATTG",2,32,5,0,2,41,1094
"TTCATTGCAGAGGCTA",1,8,0,0,2,11,124
"TTCATTGCATACAGAA",1,25,2,2,4,34,464
"TTCATTGGTTCCTACC",1,19,6,0,7,33,152
"TTCATTGGTTCTCGTC",1,21,3,0,3,28,620
"TTCATTGTCCCGATCT",0,3,0,0,0,3,46
"TTCATTGTCCTTGACC",2,11,3,0,3,19,472
"TTCCAATAGCTCATAC",0,4,0,0,0,4,84
"TTCCAATTCCACAAGT",0,3,3,0,0,6,121
"TTCCAATTCCGATCTC",1,5,0,0,0,6,417
"TTCCACGAGAGGCGTT",0,9,0,0,0,9,118
"TTCCACGAGTAGCATA",0,2,0,0,0,2,27
"TTCCACGGTATCGCAT",10,5,0,0,0,15,934
"TTCCACGGTCCTGGGT",0,5,4,0,2,11,171
"TTCCACGGTGCGTTTA",1,6,3,0,0,10,185
"TTCCACGTCTACGCGG",0,15,6,0,0,21,519
"TTCCACGTCTGCGAGC",1,5,3,0,0,9,350
"TTCCGGTCAAGCAGGT",117,295,749,71,164,1396,63160
"TTCCGGTCATTGACAC",114,891,229,61,172,1467,78813
"TTCCGGTGTGGCTACC",0,0,0,0,0,0,26
"TTCCGTGAGAATTTGG",0,8,0,0,0,8,166
"TTCCGTGAGAGGTTAT",1,24,9,4,7,45,1210
"TTCCGTGAGGCAATGC",0,2,0,0,0,2,2
"TTCCGTGAGGTATAGT",2,21,7,0,6,36,567
"TTCCGTGCAAGAGTTA",8,37,43,0,14,102,3127
"TTCCGTGCACGGTCTG",0,4,0,0,0,4,175
"TTCCGTGCAGAGATGC",6,41,16,5,6,74,1214
"TTCCGTGGTGAGATCG",3,7,0,0,0,10,82
"TTCCGTGGTGCCTATA",1,3,0,0,0,4,119
"TTCCTAAAGACTCGAG",150,745,166,43,135,1239,65491
"TTCCTAACATCTCCCA",0,3,4,0,0,7,90
"TTCCTAACATTCGATG",11,49,57,2,14,133,5371
"TTCCTAAGTGGGTTGA",6,35,12,2,10,65,1306
"TTCCTAATCTCTTGCG",1,13,3,0,2,19,573
"TTCCTAATCTTGAACG",49,212,93,24,308,686,29117
"TTCCTAATCTTGGTCC",2,24,11,0,5,42,765
"TTCCTCTCAATCTCGA",0,4,0,0,0,4,56
"TTCCTCTCAATTGCAC",0,4,0,0,0,4,149
"TTCCTCTCAGAACATA",13,115,29,6,22,185,8478
"TTCCTCTCATGTCAGT",1,0,0,0,0,1,8
"TTCCTCTGTTCGCGTG",0,2,0,0,0,2,9
"TTCCTCTTCAGGAACG",0,5,2,0,0,7,66
"TTCCTCTTCATCGCTC",7,28,10,0,4,49,866
"TTCCTCTTCCGATAGT",1,19,7,0,6,33,755
"TTCCTTCAGACATAGT",17,116,32,7,26,198,10671
"TTCCTTCAGATCCCAT",1,3,0,0,0,4,31
"TTCCTTCAGGGCCCTT",1,24,14,0,11,50,1278
"TTCCTTCCAAGAATGT",8,42,35,5,29,119,3617
"TTCCTTCCATGGAAGC",3,29,8,0,6,46,1067
"TTCCTTCTCACTTCTA",1,0,0,0,0,1,253
"TTCCTTCTCCGTTGGG",4,22,0,0,4,30,548
"TTCCTTCTCGCACGGT",1,23,4,0,5,33,1190
"TTCGATTCAAACTAGA",45,146,85,22,292,590,29455
"TTCGATTCAGCTGAGA",0,4,0,0,2,6,169
"TTCGATTCAGGTGTTT",0,2,2,0,0,4,136
"TTCGATTGTCCCGCAA",2,7,3,0,4,16,69
"TTCGATTGTCCGGATC",1,0,0,0,3,4,142
"TTCGATTTCACAGTGT",2,16,8,0,3,29,549
"TTCGATTTCTCTAAGG",1,24,6,0,7,38,641
"TTCGCTGAGATGGGCT",1,14,3,0,4,22,493
"TTCGCTGAGCACGGAT",1,15,4,0,3,23,403
"TTCGCTGAGGTCCCTG",3,22,2,0,2,29,425
"TTCGCTGAGTCATGAA",0,3,0,0,0,3,70
"TTCGCTGCATGTTCAG",0,3,0,0,2,5,128
"TTCGCTGGTAACAGGC",4,11,5,0,0,20,921
"TTCGCTGGTATCGAGG",0,5,0,0,0,5,287
"TTCGCTGGTCGGAACA",3,18,8,0,4,33,640
"TTCGCTGGTCTAGATC",1,5,3,0,0,9,106
"TTCGCTGGTTCGGACC",0,4,0,0,0,4,10
"TTCGCTGTCAACACGT",0,4,0,0,0,4,34
"TTCGCTGTCTCACTCG",1,0,0,0,0,1,102
"TTCGCTGTCTGCTGAA",2,10,0,0,0,12,138
"TTCGGTCAGCTCCATA",6,24,11,2,5,48,1067
"TTCGGTCCACGAGGAT",1,6,3,0,4,14,634
"TTCGGTCTCCCAAGTA",0,19,5,0,0,24,514
"TTCTAACAGCCACAAG",1,22,7,0,2,32,466
"TTCTAACAGGCACTAG",3,12,7,0,3,25,278
"TTCTAACAGTAAAGCT",0,2,0,0,0,2,30
"TTCTAACAGTCCCAGC",1,3,0,0,0,4,11
"TTCTAACCAAACAGGC",0,4,0,0,0,4,69
"TTCTAACCAATTCTCT",1,10,2,0,2,15,33
"TTCTAACGTACGACTT",1,2,3,0,0,6,74
"TTCTAACGTATCGGTT",69,54,32,5,21,181,7237
"TTCTAACGTCAGTTTG",0,2,0,0,2,4,190
"TTCTAACGTGTCCGGT",42,147,50,16,32,287,9186
"TTCTAGTAGAGGGTAA",10,59,21,0,12,102,2941
"TTCTAGTAGAGGGTCT",43,143,319,16,60,581,30245
"TTCTAGTAGGAAGTAG",1,5,0,0,0,6,109
"TTCTAGTAGGTCATAA",4,17,5,0,3,29,431
"TTCTAGTAGGTGATAT",3,25,4,0,4,36,464
"TTCTAGTCAAGTATAG",1,6,0,0,0,7,175
"TTCTAGTCAGGCTCTG",2,10,7,0,4,23,529
"TTCTAGTGTCAAAGCG",0,2,0,0,0,2,35
"TTCTAGTTCGTGCACG",11,46,24,6,52,139,5678
"TTCTAGTTCTTCCACG",1,19,4,2,6,32,1146
"TTCTCTCCACCGTCTT",1,19,3,2,0,25,650
"TTCTCTCCAGTTACCA",1,21,7,0,3,32,770
"TTCTCTCCATGAAGCG",2,10,2,0,0,14,451
"TTCTCTCCATGTCTAG",1,6,3,0,0,10,421
"TTCTCTCTCAGACCGC",10,50,6,0,8,74,3551
"TTCTGTAAGATGATTG",1,15,2,0,3,21,100
"TTCTGTAAGCTAAACA",0,6,2,0,0,8,186
"TTCTGTAAGTGTCATC",1,18,3,0,3,25,462
"TTCTGTACAGGCGATA",0,5,2,0,0,7,203
"TTCTGTACAGTCACGC",11,32,12,3,32,90,3882
"TTCTGTAGTACTCCCT",1,20,4,0,0,25,665
"TTCTGTATCCCATAGA",0,2,5,0,4,11,126
"TTCTGTATCCGGTTCT",3,21,8,0,4,36,986
"TTCTGTATCCGTTGAA",0,17,6,0,6,29,44
"TTCTGTATCGTAACAC",9,40,21,3,46,119,4486
"TTCTGTATCGTTATCT",6,42,17,3,57,125,5843
"TTCTTCCAGGTCCCTG",9,71,17,6,14,117,3931
"TTCTTCCCACCGTGCA",3,28,5,2,4,42,797
"TTCTTCCCACTCCACT",22,69,44,12,153,300,13882
"TTCTTCCCAGTTAGAA",0,2,3,0,0,5,72
"TTCTTCCGTATTCCTT",4,22,5,4,5,40,1197
"TTCTTCCGTCCGCAGT",1,12,0,0,2,15,256
"TTCTTCCGTTTCGTAG",0,5,2,0,0,7,106
"TTCTTGACAAGCCCAC",0,8,2,0,0,10,150
"TTCTTGACACAAATCC",49,131,230,27,156,593,30727
"TTCTTGACACAAGTTC",0,5,5,0,3,13,172
"TTCTTGATCCTTGGAA",1,21,5,3,0,30,844
"TTCTTGATCGGAGCAA",0,2,0,0,0,2,105
"TTGAACGAGAAGATCT",3,23,7,0,3,36,584
"TTGAACGCACCGGAAA",1,28,0,2,3,34,978
"TTGAACGCACGATAGG",0,6,2,0,0,8,479
"TTGAACGCACGGAAGT",2,5,0,0,0,7,180
"TTGAACGCAGACCAGA",0,3,0,0,0,3,96
"TTGAACGGTCAGTCCG",0,8,0,0,0,8,139
"TTGAACGTCGCACTCT",0,0,0,0,0,0,29
"TTGAACGTCGCAGAGA",32,258,86,14,54,444,17451
"TTGACCCAGAAGTCTA",0,3,0,0,0,3,130
"TTGACCCTCACAAGGG",0,21,3,0,4,28,666
"TTGACCCTCCCGTGAG",12,35,23,5,55,130,5237
"TTGACCCTCGCTACGG",9,86,21,4,18,138,3702
"TTGAGTGAGCTCTATG",2,17,0,0,0,19,528
"TTGAGTGAGGTCTTTG",3,22,6,2,5,38,777
"TTGAGTGCACTATCGA",0,17,4,0,4,25,864
"TTGAGTGCAGCTGCCA",2,3,2,0,2,9,472
"TTGAGTGCATTAGGAA",0,5,4,0,0,9,104
"TTGAGTGGTCTGGTTA",19,139,46,8,25,237,11151
"TTGAGTGGTTTGGCTA",1,5,0,2,0,8,138
"TTGAGTGTCATGCCGG",1,21,6,0,3,31,57
"TTGAGTGTCCACGGAC",0,9,3,0,0,12,166
"TTGAGTGTCGACATAC",29,79,148,12,31,299,13774
"TTGAGTGTCGGACCAC",1,0,0,0,0,1,12
"TTGATGGAGAAGGATG",0,7,3,0,0,10,172
"TTGATGGAGGCGAAGG",0,3,2,0,4,9,104
"TTGATGGAGGTCATAA",0,12,3,0,4,19,485
"TTGATGGCAAATGGTA",0,2,0,0,0,2,43
"TTGATGGCACAGCTTA",1,3,0,2,0,6,129
"TTGATGGCACTGTGTA",13,40,57,4,19,133,4432
"TTGATGGTCCTACGAA",1,4,0,0,0,5,38
"TTGCATTAGATCCAAA",1,8,0,0,0,9,68
"TTGCATTAGGTGATCG",1,3,2,0,2,8,143
"TTGCATTAGTAGTCTC",2,21,3,0,10,36,535
"TTGCATTAGTTGCATC",0,5,0,0,0,5,31
"TTGCATTGTACCAATC",0,0,0,0,0,0,7
"TTGCATTTCGGTGCAC",1,7,0,0,0,8,215
"TTGCATTTCTATCGGA",1,5,5,0,0,11,185
"TTGCATTTCTGAGAGG",1,11,3,0,2,17,303
"TTGCCTGAGTGGAAGA",2,7,0,0,3,12,120
"TTGCCTGCAACGGTAG",0,6,3,0,0,9,149
"TTGCCTGCACTATGTG",0,0,2,0,0,2,26
"TTGCCTGGTTCGGCTG",0,3,2,0,0,5,68
"TTGCCTGGTTTGTTCT",1,17,4,0,2,24,66
"TTGCCTGTCCTACGGG",1,8,3,0,0,12,20
"TTGCGTCCAGTCTTCC",0,4,2,0,0,6,99
"TTGCGTCCATCCGTGG",1,2,5,0,0,8,210
"TTGCGTCGTACCGCGT",0,2,0,0,0,2,15
"TTGCGTCGTTTACTTC",0,2,0,0,0,2,12
"TTGCTGCAGCTAGCCC",0,2,0,0,0,2,79
"TTGCTGCCACCCAATA",0,7,9,0,4,20,550
"TTGCTGCCAGTATTCG",2,20,8,0,0,30,745
"TTGCTGCCATCATGAC",11,54,15,5,13,98,3160
"TTGCTGCGTGAGTTGG",5,37,39,2,12,95,4055
"TTGCTGCTCGCTGTTC",0,7,0,0,0,7,97
"TTGCTGCTCTCGTTTA",1,9,2,0,0,12,140
"TTGGATGAGAACCCGA",0,0,0,0,0,0,11
"TTGGATGAGCAATAAC",3,13,6,0,2,24,305
"TTGGATGAGGTTACAA",4,58,11,3,12,88,122
"TTGGATGGTGGTCTTA",0,0,0,0,0,0,3
"TTGGATGTCACCCATC",1,5,0,0,2,8,105
"TTGGATGTCAGGACAG",0,8,5,0,3,16,179
"TTGGATGTCATGAGAA",0,21,6,0,4,31,490
"TTGGATGTCCGTCACT",1,7,0,0,2,10,158
"TTGGATGTCTAGAGCT",0,2,0,0,0,2,10
"TTGGATGTCTGTGCAA",0,9,4,0,0,13,110
"TTGGGATAGCTCCATA",1,3,0,0,0,4,113
"TTGGGATAGCTTGTTG",0,3,0,0,0,3,43
"TTGGGATAGGACGGAG",1,8,3,0,0,12,77
"TTGGGATCAACAAAGT",2,7,3,0,0,12,167
"TTGGGATCATCGCTGG",0,0,0,0,0,0,46
"TTGGGATCATGACTTG",0,7,2,0,0,9,136
"TTGGGATGTAGGTTTC",34,136,166,20,49,405,20159
"TTGGGATTCGATACTG",4,18,2,0,2,26,569
"TTGGGATTCGTAGTCA",0,10,3,0,4,17,245
"TTGGGATTCGTTGTAG",0,6,3,0,0,9,62
"TTGGGATTCTCCACTG",0,2,0,0,2,4,22
"TTGGGCGCAAGATGTA",10,44,19,2,6,81,3758
"TTGGGCGCAATAGAGT",24,142,47,4,25,242,11806
"TTGGGCGCACACTGGC",0,4,3,0,0,7,105
"TTGGGCGCACAGACGA",0,3,0,0,0,3,26
"TTGGGCGCAGGCTCTG",0,3,0,0,0,3,157
"TTGGGCGCATACATCG",0,0,0,0,0,0,13
"TTGGGCGTCCAACTGA",0,2,0,0,0,2,11
"TTGGGCGTCCCATTTA",0,2,0,0,0,2,55
"TTGGGCGTCGAGAAAT",1,8,3,0,4,16,246
"TTGGGTAAGACATAAC",0,0,0,0,0,0,12
"TTGGGTAAGCCTCACG",20,82,137,16,38,293,12249
"TTGGGTACAAGCCTGC",1,0,0,0,0,1,21
"TTGGGTACACAAAGCG",1,5,0,0,0,6,217
"TTGGGTACACACCTAA",1,9,2,0,0,12,173
"TTGGGTACACAGCCTG",0,5,2,0,0,7,240
"TTGGGTAGTAGTCACT",0,4,2,0,0,6,61
"TTGGGTAGTGCTGTCG",17,97,20,5,17,156,5522
"TTGGGTATCTGGCCTT",24,68,36,5,113,246,12948
"TTGGTTTAGCCTCATA",37,108,210,15,49,419,19686
"TTGGTTTCAGACATCT",7,36,16,4,47,110,5518
"TTGGTTTCAGCCGGTT",1,2,0,0,0,3,45
"TTGGTTTCATGAATAG",1,0,0,0,0,1,33
"TTGGTTTCATTGCAAC",0,0,0,0,0,0,8
"TTGGTTTGTCTAACTG",2,3,0,0,3,8,141
"TTGGTTTGTGTCCCTT",0,32,6,2,8,48,676
"TTGGTTTGTTCCACAA",0,0,0,0,0,0,16
"TTGGTTTGTTGCCAAT",0,0,0,0,0,0,162
"TTGGTTTTCGAAGCAG",0,2,0,0,0,2,13
"TTGTGGAAGCAACAGC",3,25,11,2,3,44,441
"TTGTGGACAGAACTAA",21,77,45,13,158,314,14968
"TTGTGGAGTATTAAGG",168,531,213,41,124,1077,57898
"TTGTGGATCGTTAGAC",1,2,0,0,0,3,13
"TTGTGGATCTCTGGTC",4,25,25,2,9,65,2031
"TTGTGTTAGAGCCGAT",0,0,0,0,0,0,20
"TTGTGTTAGCGTTCCG",1,13,0,0,3,17,429
"TTGTGTTAGGCAGGGA",1,6,3,0,0,10,104
"TTGTGTTAGTGCCGAA",0,3,3,0,0,6,79
"TTGTGTTCAAATCAAG",1,6,0,0,0,7,336
"TTGTGTTCATCTCGTC",1,7,0,0,0,8,99
"TTGTGTTGTGGTAACG",0,8,0,0,0,8,101
"TTGTGTTTCAGTGGGA",0,0,0,0,0,0,18
"TTGTGTTTCCTTGGAA",1,4,0,0,0,5,43
"TTGTTCAAGCAACTTC",5,27,29,2,6,69,3372
"TTGTTCACAGTCAACT",6,26,5,0,5,42,918
"TTGTTCAGTGGTCTTA",1,30,11,0,11,53,747
"TTGTTCAGTTCTCTCG",0,16,4,2,2,24,178
"TTGTTCATCTACCTTA",15,99,28,7,16,165,7424
"TTGTTGTAGAGTCCGA",6,43,30,3,6,88,3327
"TTGTTGTAGAGTCGAC",0,3,0,0,2,5,39
"TTGTTGTAGGACAGTC",0,0,0,0,0,0,0
"TTGTTGTCAACGATCT",3,14,4,0,6,27,661
"TTGTTGTCACTCTGCT",5,17,12,0,4,38,713
"TTGTTGTGTACGTAGG",0,5,0,0,0,5,45
"TTGTTGTGTCTTTCAT",61,150,315,24,69,619,32223
"TTGTTGTGTGTAGTGG",7,18,4,2,4,35,682
"TTGTTGTGTTGGGACA",191,95,64,12,49,411,19862
"TTGTTGTTCAAACGAA",21,49,86,6,11,173,6056
"TTGTTTGAGTATGAGT",0,31,17,0,7,55,1010
"TTGTTTGGTGTTCCTC",0,4,0,0,0,4,227
"TTGTTTGTCACCTACC",28,94,276,10,48,456,17856
"TTGTTTGTCGGTAACT",10,72,15,5,15,117,5301
"TTTACCAAGAAGTCCG",0,0,0,0,0,0,7
"TTTACCACACCAGCCA",0,2,0,0,0,2,38
"TTTACCACATACTTTC",2,34,10,2,6,54,1192
"TTTACCACATGAAAGT",1,7,0,0,0,8,135
"TTTACCAGTGCAAGAC",1,4,0,2,0,7,157
"TTTACCAGTGGCTGCT",43,200,51,13,39,346,14695
"TTTACCATCACTGATG",2,32,2,0,8,44,1005
"TTTACCATCCTACACC",0,2,0,0,2,4,98
"TTTACCATCGGACTGC",0,0,0,0,0,0,12
"TTTACCATCGGTCAGC",0,13,2,0,0,15,308
"TTTACGTAGCAATTAG",0,5,0,0,0,5,179
"TTTACGTAGCCTATTG",0,18,5,0,0,23,259
"TTTACGTAGCGCAATG",1,8,4,2,3,18,435
"TTTACGTCATACACCA",3,15,10,3,4,35,563
"TTTACGTCATGAAGCG",1,12,0,0,0,13,49
"TTTACGTCATTCCTCG",0,3,0,0,0,3,208
"TTTACGTGTCCACGCA",0,10,5,0,2,17,295
"TTTACGTGTGACAGGT",69,449,116,32,68,734,35139
"TTTACGTTCCAATCCC",3,19,6,0,0,28,497
"TTTACGTTCCTTCACG",2,5,0,0,0,7,306
"TTTACGTTCGCTGCGA",2,42,8,4,7,63,2594
"TTTACTGAGACATCCT",2,25,5,0,3,35,513
"TTTACTGAGCTGGAGT",190,1330,306,145,215,2186,106459
"TTTACTGAGTAAATGC",0,4,2,0,0,6,114
"TTTACTGAGTAGCAAT",1,17,4,0,3,25,51
"TTTACTGCAAATGGAT",3,31,12,0,7,53,1163
"TTTACTGCATGTTACG",3,4,0,0,0,7,277
"TTTACTGGTTGCTAGT",0,3,0,0,0,3,258
"TTTACTGTCCGCACGA",1,5,2,0,2,10,171
"TTTAGTCAGTCCGTCG",1,17,6,0,2,26,611
"TTTAGTCCATAATGCC",2,8,0,0,0,10,22
"TTTAGTCGTAGCTTGT",0,3,0,0,0,3,93
"TTTAGTCGTGTATTCG",1,8,3,0,0,12,282
"TTTAGTCTCTATCCAT",1,12,4,0,2,19,266
"TTTATGCAGATAGTGT",1,3,4,0,0,8,46
"TTTATGCAGATTGAGT",3,31,4,0,6,44,327
"TTTATGCAGGTAGTCG",1,20,9,0,3,33,206
"TTTATGCAGTATAACG",3,8,10,0,2,23,1406
"TTTATGCCATGACACT",0,3,2,0,0,5,48
"TTTATGCCATGACTTG",0,6,0,0,0,6,201
"TTTATGCGTATGCGTT",0,6,0,0,0,6,63
"TTTATGCGTGCATTTG",0,3,0,0,0,3,113
"TTTATGCGTGGCCTCA",0,2,2,0,0,4,140
"TTTATGCTCCTTATAC",0,5,0,0,0,5,75
"TTTCACACATCTTCGC",3,25,6,0,2,36,518
"TTTCACATCACATTGG",0,2,3,0,0,5,56
"TTTCACATCCAATCCC",1,6,6,0,0,13,159
"TTTCACATCCCTTGTG",25,119,51,5,26,226,11292
"TTTCACATCGCAGAGA",0,2,0,0,0,2,116
"TTTCAGTAGAATCGAT",2,38,12,0,4,56,1120
"TTTCAGTAGCTGGCTC",0,2,0,0,0,2,58
"TTTCAGTAGGACTTCT",566,3439,1068,261,775,6109,289617
"TTTCAGTAGGCGTCCT",0,2,3,0,0,5,101
"TTTCAGTAGTATCTGC",0,14,4,0,3,21,923
"TTTCAGTCACAAAGCG",50,318,82,22,60,532,27659
"TTTCAGTCACGGGTAA",29,199,56,14,36,334,18177
"TTTCAGTCACGGTCTG",30,115,256,23,56,480,24896
"TTTCAGTCAGTGACCC",0,4,0,0,0,4,63
"TTTCAGTGTCAACACT",0,4,0,0,0,4,150
"TTTCAGTTCCCTCTTT",3,36,9,3,6,57,903
"TTTCAGTTCGAACTCA",5,21,2,0,0,28,732
"TTTCAGTTCGCTCCTA",1,8,0,0,0,9,208
"TTTCATGCAAAGCTAA",4,16,7,0,3,30,529
"TTTCATGCAGAAGTGC",0,4,0,0,0,4,120
"TTTCATGCAGCAAGAC",149,1212,321,100,223,2005,85591
"TTTCATGGTATGTCTG",0,2,0,0,0,2,75
"TTTCATGGTTGAATCC",25,106,50,9,29,219,6830
"TTTCCTCAGGACTATA",14,42,46,5,51,158,8316
"TTTCCTCCACCAATTG",3,19,11,2,5,40,585
"TTTCCTCCAGGCACAA",0,0,0,0,0,0,17
"TTTCCTCTCTGTGCAA",160,85,39,10,38,332,16217
"TTTCGATAGAATCGTA",3,14,3,0,3,23,645
"TTTCGATAGGATCATA",0,4,0,0,2,6,127
"TTTCGATCAACGTATC",3,34,8,2,8,55,1175
"TTTCGATCACATCATG",0,0,0,0,0,0,25
"TTTCGATCACTATGTG",2,2,0,0,3,7,234
"TTTCGATCACTGGCGT",5,20,5,0,5,35,523
"TTTCGATCAGTTAGAA",2,8,2,0,0,12,117
"TTTCGATCATGGATCT",39,124,268,18,52,501,24465
"TTTCGATCATTGGCAT",1,6,2,0,0,9,338
"TTTCGATGTCGCACGT",65,171,319,33,147,735,42973
"TTTCGATTCATGAAAG",2,11,8,2,0,23,589
"TTTCGATTCGGCATTA",49,259,67,12,49,436,22332
"TTTCGATTCTCTGCCA",1,2,0,0,0,3,200
"TTTGACTAGCGACATG",1,25,7,0,4,37,720
"TTTGACTAGGTCATAA",0,5,0,0,2,7,145
"TTTGACTCAATGCAGG",0,7,0,0,0,7,227
"TTTGACTCACGCACCA",1,2,2,0,0,5,86
"TTTGACTCATTCGGGC",0,0,0,0,0,0,8
"TTTGACTGTTCAGGTT",0,9,3,0,0,12,46
"TTTGACTTCAAGCCCG",2,11,0,2,2,17,28
"TTTGACTTCCATCTGC",4,50,26,5,8,93,3794
"TTTGACTTCCGTACGG",0,3,2,0,0,5,262
"TTTGACTTCCTACTGC",0,3,0,0,0,3,13
"TTTGACTTCGATAACC",1,25,4,2,7,39,858
"TTTGATCAGAAGCGAA",0,5,2,0,0,7,227
"TTTGATCAGATGAATC",23,160,43,14,28,268,9786
"TTTGATCAGCTAAACA",2,16,0,3,3,24,649
"TTTGATCAGGGTACGT",3,15,3,0,5,26,541
"TTTGATCCACTTCAGA",1,3,4,0,0,8,91
"TTTGATCCACTTGAAC",5,21,10,35,8,79,3418
"TTTGATCCAGAGTGTG",1,5,0,0,2,8,192
"TTTGATCCATAATGCC",37,41,23,3,10,114,2481
"TTTGATCGTCACCGAC",0,0,0,0,0,0,528
"TTTGATCGTTCCGTTC",0,6,3,0,0,9,311
"TTTGATCGTTTGAAAG",1,19,6,0,3,29,49
"TTTGATCTCTCATTTG",0,0,0,0,0,0,25
"TTTGATCTCTCCGCAT",47,158,91,25,387,708,32007
"TTTGATCTCTGCTGAA",2,8,2,0,2,14,128
"TTTGGAGAGGATTACA",0,3,3,0,0,6,85
"TTTGGAGAGTACAACA",1,10,3,0,4,18,540
"TTTGGAGCAATAACGA",42,48,20,5,15,130,3924
"TTTGGAGCAATTGCCA",31,189,79,19,46,364,20690
"TTTGGAGTCTCAAAGC",3,25,7,0,0,35,566
"TTTGGAGTCTTTCCAA",5,36,5,0,7,53,2801
"TTTGGTTCAACTGCCG",1,25,4,0,3,33,683
"TTTGGTTCAGCCCACA",1,8,3,0,0,12,177
"TTTGGTTCAGTTGAAA",0,3,0,0,0,3,127
"TTTGGTTCATATGAAG",6,6,4,0,5,21,617
"TTTGGTTGTGTGTTTG",3,15,5,0,5,28,529
"TTTGGTTTCCCTGGTT",1,4,2,0,0,7,71
"TTTGGTTTCCTCTCTT",3,28,10,2,5,48,1459
"TTTGGTTTCTACGGTA",1,10,3,0,0,14,120
"TTTGTTGAGAGCATCG",0,6,0,0,0,6,83
"TTTGTTGAGCACTCAT",3,23,13,4,17,60,3927
"TTTGTTGGTAATCAAG",3,20,9,0,0,32,1225
"TTTGTTGTCGTTGTGA",8,34,16,6,46,110,3735
