"","Bar1","Bar2","Bar3","Bar4","Bar5","nUMI","nUMI_total"
"AAACCCAAGTCGTTAC",476,1886,239,54,202,2857,62806
"AAACCCACAAATGGCG",0,2,0,0,0,2,38
"AAACCCACAGCATTGT",1,14,2,0,2,19,382
"AAACCCACATAGGCGA",39,21,8,2,9,79,2762
"AAACCCAGTATGCTAC",0,0,0,0,0,0,7
"AAACCCAGTCTACTGA",0,0,0,0,0,0,103
"AAACCCATCAAACCCA",0,0,0,0,0,0,73
"AAACGAACAGAACCGA",1,0,0,0,0,1,66
"AAACGAAGTCAAAGTA",2,6,14,0,0,22,677
"AAACGAAGTCAAATCC",3,20,10,0,50,83,2716
"AAACGAAGTGCATGTT",0,21,7,0,3,31,616
"AAACGAATCATCACTT",0,4,0,0,0,4,99
"AAACGAATCCGTCACT",1,4,0,0,0,5,75
"AAACGAATCGGCTTCT",0,0,0,0,0,0,7
"AAACGAATCGTAATGC",0,3,2,0,0,5,100
"AAACGCTAGCCGATTT",14,89,22,6,18,149,4414
"AAACGCTAGTAAAGCT",1,12,2,0,0,15,214
"AAACGCTCAAATGGCG",1,7,2,0,3,13,19
"AAACGCTCAAGAATAC",2,8,0,0,0,10,39
"AAACGCTCAAGTATCC",6,18,9,0,6,39,907
"AAACGCTCACATACTG",0,4,2,0,0,6,97
"AAACGCTCACTTCCTG",0,2,0,0,0,2,34
"AAACGCTCAGAGTTCT",1,14,0,2,2,19,723
"AAACGCTGTAGATGTA",1,19,0,0,0,20,487
"AAACGCTTCCCGTTGT",0,5,4,0,0,9,119
"AAAGAACAGGCAGGTT",0,4,0,0,0,4,89
"AAAGAACAGTGGCAGT",0,0,0,0,0,0,57
"AAAGAACGTAGAGACC",1,7,0,0,0,8,107
"AAAGAACGTCCTATAG",0,5,0,0,3,8,57
"AAAGAACGTGACCGTC",8,49,108,5,19,189,4743
"AAAGAACGTGCTGTCG",0,0,0,0,0,0,4
"AAAGAACGTGTAACGG",0,5,0,0,0,5,88
"AAAGAACTCTGTGTGA",1,2,0,0,0,3,88
"AAAGGATAGCGAGTCA",0,5,0,0,0,5,93
"AAAGGATAGGTAGTAT",0,8,5,0,5,18,275
"AAAGGATAGGTCGTGA",0,0,0,0,0,0,54
"AAAGGATCAAGAGTAT",6,31,8,2,10,57,567
"AAAGGATCAATTCACG",2,16,4,2,0,24,60
"AAAGGATCACAGCGCT",0,4,3,0,0,7,144
"AAAGGATCAGATTCGT",2,21,12,0,11,46,741
"AAAGGATGTAACGATA",0,0,5,0,0,5,145
"AAAGGATGTGACTGAG",4,37,49,4,8,102,2295
"AAAGGATTCAAATGCC",20,55,8,2,14,99,2541
"AAAGGATTCTACAGGT",0,2,0,0,0,2,128
"AAAGGGCAGAAGATCT",0,0,0,0,0,0,5
"AAAGGGCAGCTACGTT",0,2,2,0,0,4,18
"AAAGGGCAGGTAAAGG",5,20,5,2,24,56,2223
"AAAGGGCGTCGTGGAA",0,0,0,0,0,0,0
"AAAGGGCGTCTGTGGC",0,5,0,0,0,5,89
"AAAGGGCGTGGCATCC",60,85,19,4,18,186,7593
"AAAGGGCTCGATTGAC",20,63,141,5,23,252,9193
"AAAGGTAAGAGTATAC",1,3,3,2,0,9,133
"AAAGGTAAGCAGCAGT",3,16,6,5,4,34,438
"AAAGGTAAGGTAGGCT",0,0,0,0,0,0,22
"AAAGGTACAGCAGTGA",0,0,0,0,0,0,8
"AAAGGTACATTCGGGC",0,3,0,0,0,3,61
"AAAGGTAGTAGACACG",0,7,0,0,4,11,57
"AAAGGTAGTCTACATG",0,4,0,0,0,4,13
"AAAGTCCAGTAGGTTA",3,23,8,0,3,37,382
"AAAGTCCAGTGATGGC",2,10,3,0,4,19,570
"AAAGTCCAGTTGGAGC",0,0,0,0,0,0,34
"AAAGTCCCAGCGTGCT",0,3,0,0,0,3,153
"AAAGTCCGTACTCCCT",0,11,4,0,2,17,325
"AAAGTCCGTAGCTGAG",0,0,0,0,0,0,31
"AAAGTCCGTAGGAGGG",0,0,0,0,0,0,17
"AAAGTCCGTCTGCATA",0,4,0,0,0,4,29
"AAAGTCCGTGAATTAG",0,0,0,0,0,0,38
"AAAGTCCGTGCTTATG",0,2,0,0,0,2,20
"AAAGTCCTCATTCCTA",0,10,0,0,0,10,310
"AAAGTCCTCCTAAACG",1,8,0,0,0,9,168
"AAAGTCCTCCTTCTTC",1,7,0,0,0,8,30
"AAAGTCCTCGAAGAAT",0,3,0,0,0,3,82
"AAAGTCCTCTCAGAAC",3,16,14,2,2,37,1039
"AAAGTGAAGAGTCACG",2,21,5,0,3,31,259
"AAAGTGAAGGAAGTCC",0,0,0,0,2,2,20
"AAAGTGAAGGGCAACT",0,13,7,0,3,23,279
"AAAGTGAAGGTGAGCT",2,7,2,2,0,13,100
"AAAGTGACAACGAGGT",1,12,0,0,0,13,252
"AAAGTGACACACCTAA",4,22,4,0,2,32,296
"AAAGTGACAGAGGACT",1,7,4,0,4,16,252
"AAAGTGAGTATTCCGA",10,20,4,0,5,39,828
"AAAGTGATCACGGTCG",0,2,0,0,0,2,68
"AAAGTGATCACGTCCT",1,9,3,0,0,13,161
"AAATGGAAGCAACCAG",18,123,28,7,20,196,4560
"AAATGGAAGTAACCTC",0,5,0,0,0,5,99
"AAATGGACAGTTGCGC",3,30,47,0,17,97,3043
"AAATGGACATGAGAAT",0,2,0,0,0,2,217
"AAATGGAGTAACCAGG",0,0,0,0,0,0,79
"AAATGGAGTCATCCGG",69,723,146,34,123,1095,38093
"AAATGGAGTCCGACGT",21,204,39,5,29,298,8923
"AAATGGAGTGGAAATT",17,108,22,4,42,193,6338
"AAATGGAGTTCAAACC",0,0,0,0,0,0,11
"AAATGGAGTTTGGAGG",0,4,0,0,2,6,71
"AAATGGATCTCGTGGG",3,9,0,0,4,16,605
"AAATGGATCTGGCTGG",1,6,0,0,3,10,267
"AAATGGATCTGGTCAA",0,0,0,0,0,0,18
"AACAAAGCACAAATAG",2,26,5,0,8,41,553
"AACAAAGCAGTTTGGT",0,0,0,0,0,0,5
"AACAAAGGTCCATAGT",4,2,4,0,0,10,263
"AACAAAGGTGTATCCA",1,19,8,0,5,33,322
"AACAAAGGTTGGTACT",0,6,0,0,0,6,108
"AACAAAGTCTTGTTAC",0,2,0,0,0,2,64
"AACAACCGTGACTGAG",1,5,2,0,0,8,121
"AACAACCTCCACGTGG",1,2,0,0,0,3,93
"AACAACCTCCAGTTCC",10,80,16,4,14,124,4058
"AACAACCTCTCAGTCC",2,3,0,0,0,5,90
"AACAAGAAGCCTGTGC",1,4,2,0,0,7,119
"AACAAGAAGCTAGTTC",0,0,0,0,0,0,28
"AACAAGAAGGGCCAAT",0,0,0,0,0,0,5
"AACAAGAAGGGTTGCA",7,25,32,3,15,82,1802
"AACAAGAAGTAACAGT",1,5,0,0,0,6,68
"AACAAGATCGATCCCT",1,2,0,0,0,3,141
"AACAAGATCTCTTGCG",0,3,2,0,0,5,101
"AACACACAGACTTCGT",19,111,21,6,22,179,6791
"AACACACAGATCGCCC",0,8,2,0,0,10,159
"AACACACAGCCATTCA",0,2,0,0,0,2,54
"AACACACAGCTCATAC",0,12,3,0,2,17,354
"AACACACAGTAGAGTT",2,31,8,2,5,48,224
"AACACACAGTTGTCAC",0,8,0,0,0,8,81
"AACACACCATTGCTGA",0,15,2,0,0,17,298
"AACACACGTCCAAGAG",0,0,0,0,2,2,62
"AACACACGTGCCTATA",2,21,8,0,4,35,618
"AACACACGTTATTCCT",26,196,47,7,33,309,10258
"AACACACTCGGATTAC",0,0,0,0,0,0,6
"AACAGGGAGGATTCAA",1,6,4,0,2,13,379
"AACAGGGAGGCAGTCA",0,0,2,0,0,2,84
"AACAGGGAGGCATCGA",0,5,0,0,0,5,64
"AACAGGGCACTCCGGA",1,11,6,0,4,22,305
"AACAGGGCAGTGTACT",37,183,101,20,382,723,24841
"AACAGGGCAGTTAAAG",1,7,3,0,4,15,222
"AACAGGGCATGCAGCC",0,2,0,0,2,4,33
"AACAGGGCATGCAGGA",15,95,18,3,17,148,4372
"AACAGGGGTTATAGCC",0,7,0,0,0,7,41
"AACAGGGTCCCTTTGG",0,0,0,0,0,0,19
"AACAGGGTCCGTGCGA",30,94,244,6,99,473,16737
"AACAGGGTCGCAACAT",0,3,0,0,2,5,78
"AACAGGGTCGGCTTGG",0,2,2,0,0,4,42
"AACAGGGTCTACTCAT",3,19,4,0,11,37,1122
"AACAGGGTCTCTATGT",0,0,0,0,0,0,55
"AACCAACAGCTTGTGT",1,13,0,0,3,17,20
"AACCAACAGTCAACAA",0,3,0,0,0,3,73
"AACCAACCACAGCATT",4,9,6,0,6,25,443
"AACCAACCAGCAGGAT",0,6,0,0,0,6,142
"AACCAACGTAGCTGTT",0,2,0,0,0,2,155
"AACCAACGTGGTACAG",2,2,3,0,0,7,123
"AACCAACGTTCATCGA",0,2,2,0,2,6,109
"AACCAACTCCATCGTC",1,14,2,0,4,21,385
"AACCAACTCCTTGACC",0,2,2,0,0,4,18
"AACCAACTCTTAAGGC",1,0,0,0,0,1,22
"AACCAACTCTTCCCAG",0,3,0,0,0,3,121
"AACCACACAAATCAGA",0,4,2,0,2,8,212
"AACCACACAAGGCCTC",1,2,0,0,0,3,82
"AACCACAGTAGGTAGC",9,6,0,0,0,15,235
"AACCACAGTTATGGTC",6,23,12,0,3,44,1145
"AACCACATCCACCCTA",2,3,0,0,2,7,167
"AACCACATCTGAGAGG",0,5,0,2,0,7,89
"AACCATGAGCGTGCCT",1,23,2,0,3,29,587
"AACCATGAGGAGATAG",2,8,0,0,4,14,306
"AACCATGAGTCGAAGC",0,4,0,0,3,7,72
"AACCATGCAGTCAACT",0,0,0,0,0,0,25
"AACCATGGTGTCGCTG",0,3,2,0,0,5,108
"AACCATGTCATCGACA",0,2,0,0,0,2,32
"AACCATGTCCGCGGAT",0,0,0,0,0,0,4
"AACCATGTCCTACAAG",3,25,6,0,4,38,496
"AACCATGTCGATGCTA",10,41,109,6,37,203,7230
"AACCATGTCTCGACGG",0,0,0,0,2,2,20
"AACCCAACATACCATG",1,3,0,0,2,6,171
"AACCCAACATCGCTAA",0,0,0,0,0,0,67
"AACCCAATCCGCTTAC",400,130,62,20,64,676,21154
"AACCTGAAGACTTCGT",0,0,0,0,0,0,35
"AACCTGAAGAGAGCCT",1,2,0,0,0,3,26
"AACCTGAAGATCCTAC",1,13,3,0,8,25,33
"AACCTGAGTACGATGG",1,4,0,0,0,5,243
"AACCTGAGTCTCAGGC",18,288,48,12,38,404,15388
"AACCTTTAGACGAAGA",1,5,0,0,0,6,14
"AACCTTTAGCTGCGAA",0,0,0,0,0,0,35
"AACCTTTAGGTTAGTA",0,4,0,0,0,4,56
"AACCTTTAGTTCCGGC",0,3,0,0,0,3,45
"AACCTTTCAACACTAC",0,5,0,0,0,5,282
"AACCTTTCATTCTCTA",0,0,0,0,2,2,21
"AACCTTTGTGTTCCTC",1,2,2,0,0,5,121
"AACCTTTGTTCTCACC",0,0,0,0,0,0,18
"AACCTTTTCACCGACG",1,12,3,3,9,28,557
"AACCTTTTCGCAGTCG",0,0,0,0,0,0,197
"AACGAAAAGAAATGGG",1,14,3,0,3,21,277
"AACGAAAAGATTAGAC",0,8,2,0,0,10,378
"AACGAAACAAGGGTCA",0,3,0,0,5,8,450
"AACGAAACAGGGATAC",1,4,0,0,2,7,55
"AACGAAAGTACCCAGC",0,4,0,0,0,4,24
"AACGAAAGTTACGGAG",1,2,0,0,0,3,53
"AACGAAATCAAGCCCG",2,18,7,0,3,30,435
"AACGAAATCAGCTTGA",0,0,0,0,0,0,3
"AACGGGAAGTAGGCCA",1,11,2,0,0,14,75
"AACGGGACAACTAGAA",0,4,0,0,0,4,86
"AACGGGAGTAGTCGGA",0,3,0,0,0,3,37
"AACGGGAGTCCCACGA",2,23,3,0,2,30,348
"AACGGGAGTCTCAGAT",0,2,0,0,0,2,3
"AACGGGAGTGTTGAGG",4,15,13,0,7,39,1328
"AACGGGAGTTGTATGC",2,5,10,2,2,21,361
"AACGGGATCCCTTGTG",1,16,2,2,4,25,407
"AACGGGATCCTAAGTG",2,3,2,0,2,9,65
"AACGGGATCGGCATAT",22,272,47,18,41,400,12545
"AACGTCAAGACCATAA",14,48,87,9,108,266,10454
"AACGTCAAGCAATTAG",33,111,340,15,61,560,19787
"AACGTCACACCCAACG",1,2,10,0,0,13,584
"AACGTCAGTCGGCACT",3,14,38,3,10,68,2272
"AACTTCTAGACTGTTC",5,20,7,0,3,35,127
"AACTTCTAGAGTCAAT",1,13,4,3,5,26,429
"AACTTCTAGGTACATA",1,25,7,0,6,39,441
"AACTTCTAGGTTCCAT",0,0,0,0,0,0,9
"AACTTCTCAAGAGAGA",0,9,0,0,0,9,69
"AACTTCTCACGCGTGT",0,5,0,0,0,5,21
"AACTTCTCAGATAAAC",4,44,68,2,14,132,4675
"AACTTCTGTGATGGCA",2,20,4,2,4,32,517
"AACTTCTGTTACACAC",1,2,0,0,0,3,48
"AACTTCTTCCTTTGAT",3,28,36,0,8,75,2687
"AACTTCTTCGCAGTGC",41,133,384,18,64,640,24753
"AAGAACAAGAGAGCCT",83,157,36,5,30,311,9416
"AAGAACAAGCGCCTAC",0,12,3,0,3,18,359
"AAGAACACATAGAGGC",0,3,0,0,0,3,14
"AAGAACAGTAGTGGCA",2,0,0,0,0,2,84
"AAGAACATCCAAGCTA",0,4,0,0,2,6,86
"AAGAACATCTCGTGAA",21,88,54,26,200,389,11788
"AAGACAAAGAGCCGTA",0,7,4,0,3,14,108
"AAGACAACACGCAGTC",1,21,7,0,4,33,439
"AAGACAACAGATTAAG",0,4,0,0,0,4,56
"AAGACAAGTCATCCGG",12,138,25,7,17,199,6377
"AAGACAAGTGGGAGAG",0,0,0,0,0,0,12
"AAGACAATCAAACGAA",1,11,2,2,0,16,280
"AAGACAATCAAAGGTA",0,16,3,0,2,21,46
"AAGACAATCACTTGGA",0,2,0,0,0,2,107
"AAGACAATCATCTACT",1,5,0,0,0,6,92
"AAGACAATCGATACTG",0,0,0,0,0,0,8
"AAGACTCAGAAGGCTC",1,0,0,0,0,1,49
"AAGACTCAGACCGTTT",1,5,0,0,0,6,106
"AAGACTCAGCGCCGTT",0,3,0,0,0,3,26
"AAGACTCAGCTCCGAC",0,0,0,0,0,0,81
"AAGACTCAGGTAAGAG",1,4,0,0,0,5,63
"AAGACTCAGGTACATA",1,14,4,0,4,23,559
"AAGACTCCAATGCTCA",1,18,4,0,5,28,697
"AAGACTCCACGTAGAG",4,11,7,6,6,34,723
"AAGACTCCATAGACTC",3,6,2,0,0,11,92
"AAGACTCTCAGCGGAA",1,13,4,0,0,18,363
"AAGATAGAGCTCCATA",202,1190,365,344,258,2359,86836
"AAGATAGAGTGCCGAA",3,25,28,0,6,62,1828
"AAGATAGAGTGGAATT",0,0,0,0,0,0,75
"AAGATAGGTCGCAACC",0,2,0,0,0,2,18
"AAGATAGGTCTTTATC",1,6,0,0,2,9,153
"AAGATAGGTGTCCCTT",0,0,0,0,0,0,6
"AAGATAGGTGTTTGCA",0,4,0,0,0,4,34
"AAGATAGGTTATAGAG",3,5,3,0,0,11,131
"AAGCATCAGCATAGGC",0,2,0,0,0,2,120
"AAGCATCCAGACTCTA",1,6,2,0,0,9,76
"AAGCATCGTAACTGCT",0,10,2,0,3,15,615
"AAGCATCGTATGACAA",7,23,44,0,10,84,3276
"AAGCATCGTCTAATCG",6,48,25,2,6,87,3189
"AAGCATCGTGCCGAAA",1,0,0,0,0,1,9
"AAGCATCGTGTGGACA",0,0,0,0,0,0,29
"AAGCATCGTTTCGTAG",0,6,2,0,0,8,38
"AAGCATCTCTCGTCGT",1,14,0,0,3,18,276
"AAGCCATAGCAGCCTC",1,0,0,0,0,1,103
"AAGCCATAGGTCGCCT",0,0,0,0,0,0,103
"AAGCCATCATGAAGGC",0,0,0,0,0,0,36
"AAGCGAGAGGTTATAG",0,3,0,0,4,7,91
"AAGCGAGCAGCGTGCT",1,7,0,0,2,10,76
"AAGCGAGCAGTAGAAT",0,0,0,0,0,0,21
"AAGCGAGGTGTGTGGA",0,0,0,0,0,0,47
"AAGCGAGTCGCGCCAA",2,10,2,0,7,21,596
"AAGCGAGTCGGACCAC",0,6,0,0,0,6,85
"AAGCGAGTCTCGAGTA",0,9,0,0,0,9,90
"AAGCGAGTCTCTCGCA",1,5,0,0,2,8,113
"AAGCGAGTCTGTGCTC",6,67,9,3,12,97,3495
"AAGCGTTAGAAGCGGG",1,0,0,0,2,3,63
"AAGCGTTAGACGATAT",0,5,0,0,0,5,96
"AAGCGTTAGCGCTGAA",0,3,0,0,0,3,62
"AAGCGTTAGTGGACTG",0,7,3,0,3,13,72
"AAGCGTTCAATAACCC",7,7,4,0,0,18,303
"AAGCGTTCAGAGTGAC",1,10,3,0,5,19,252
"AAGCGTTGTGTTCCTC",2,22,6,0,26,56,1358
"AAGCGTTGTTGAGAGC",8,25,5,3,35,76,1955
"AAGCGTTTCGAGTGAG",15,88,22,6,19,150,4726
"AAGGAATAGCCTCATA",0,0,0,0,0,0,26
"AAGGAATAGCGTCTGC",0,3,0,0,0,3,37
"AAGGAATAGCTACTGT",19,149,34,9,30,241,7296
"AAGGAATAGGATGGCT",0,4,3,0,2,9,74
"AAGGAATCAACTCCAA",0,3,2,0,0,5,33
"AAGGAATCAACTCCCT",3,7,10,0,5,25,835
"AAGGAATGTGGACCTC",0,6,0,0,3,9,73
"AAGGAATTCACATCAG",0,7,2,0,3,12,75
"AAGGAATTCCATTGGA",0,0,0,0,0,0,10
"AAGGAATTCCGCGAGT",2,9,0,0,0,11,578
"AAGGAATTCGGTCGAC",2,15,4,0,3,24,294
"AAGGTAAAGCCGGAAT",1,18,2,0,2,23,307
"AAGGTAAAGTGGCGAT",0,7,2,0,2,11,64
"AAGGTAACAATGTCTG",1,3,2,0,7,13,531
"AAGGTAACACCAGGTC",0,4,0,0,0,4,52
"AAGGTAACATGTGGCC",18,189,61,8,38,314,11211
"AAGGTAAGTAGCTGAG",0,5,3,0,0,8,77
"AAGGTAAGTCGCAACC",0,4,0,0,0,4,310
"AAGGTAATCGGACCAC",2,15,3,3,3,26,308
"AAGGTAATCTTGCAAG",1,0,2,0,0,3,90
"AAGTACCAGAACTTCC",3,16,9,2,7,37,748
"AAGTACCAGGCTAAAT",1,7,0,0,0,8,160
"AAGTACCAGTCGAAAT",6,22,7,0,3,38,864
"AAGTACCAGTGAATAC",1,14,2,0,4,21,377
"AAGTACCGTCATAAAG",1,3,0,0,2,6,84
"AAGTACCTCATGGGAG",1,6,0,0,4,11,121
"AAGTACCTCGTCGCTT",0,0,0,0,2,2,17
"AAGTACCTCTAGTACG",0,6,0,0,4,10,201
"AAGTCGTAGACCTGGA",20,76,147,10,100,353,9982
"AAGTCGTAGCTACTGT",0,2,0,0,0,2,46
"AAGTCGTAGGATTTGA",2,6,0,0,2,10,136
"AAGTCGTAGTAATACG",0,4,0,0,2,6,43
"AAGTCGTAGTCTAGAA",6,115,16,0,16,153,4626
"AAGTCGTCACTACAGT",2,4,0,0,2,8,110
"AAGTCGTCAGTGTATC",1,4,0,0,0,5,207
"AAGTCGTGTACCGTGC",0,3,0,0,0,3,88
"AAGTCGTGTCGTTGGC",0,8,0,0,0,8,292
"AAGTCGTTCGAACGGA",0,0,0,0,0,0,7
"AAGTCGTTCTACGCGG",5,16,13,0,6,40,805
"AAGTCGTTCTGGCCGA",1,2,2,0,0,5,44
"AAGTGAAAGAGGCCAT",1,7,5,0,2,15,217
"AAGTGAAAGGAATGTT",10,117,18,8,18,171,6389
"AAGTGAACAAGTGCTT",1,4,0,2,0,7,94
"AAGTGAACAGGTGTTT",5,32,6,0,4,47,634
"AAGTGAACAGTAACGG",0,2,0,0,0,2,57
"AAGTGAAGTGGCTTGC",1,12,3,0,2,18,167
"AAGTGAAGTTTACCAG",1,4,0,0,0,5,45
"AAGTGAATCTACGGGC",0,0,0,0,0,0,10
"AAGTTCGAGAGGGCGA",0,4,0,0,0,4,241
"AAGTTCGAGGAGTATT",2,11,7,0,4,24,296
"AAGTTCGGTAAGATAC",4,15,4,0,3,26,270
"AAGTTCGGTACACGTT",7,9,6,0,4,26,399
"AAGTTCGGTCTCAGAT",1,6,0,0,2,9,51
"AAGTTCGGTTTGCAGT",0,7,0,0,2,9,71
"AAGTTCGTCCAAGCCG",0,2,0,0,0,2,17
"AAGTTCGTCCAGCTCT",8,16,4,2,5,35,891
"AAGTTCGTCGCCCAGA",1,0,0,0,0,1,54
"AATAGAGAGTGGTTGG",1,13,0,0,5,19,54
"AATAGAGGTCCATCTC",1,15,5,0,3,24,412
"AATAGAGGTCTTACAG",2,18,3,3,0,26,267
"AATAGAGGTCTTCATT",0,4,0,0,0,4,37
"AATAGAGTCCCTGTTG",1,10,2,0,0,13,295
"AATAGAGTCCTCTGCA",1,0,0,0,0,1,16
"AATAGAGTCTGGTGGC",4,26,6,0,4,40,500
"AATCACGAGCTGCGAA",26,102,64,294,60,546,18096
"AATCACGAGGGCAACT",25,258,88,5,39,415,11704
"AATCACGCAATGGCAG",0,0,0,0,0,0,179
"AATCACGCACTGTTCC",1,3,0,0,3,7,14
"AATCACGGTAGCACAG",0,5,0,0,0,5,116
"AATCACGGTATATGGA",0,3,0,0,0,3,47
"AATCACGTCGCAGTCG",19,83,328,4,33,467,11569
"AATCACGTCTTGGTCC",5,11,6,0,0,22,362
"AATCGACAGGTTGACG",0,8,0,0,2,10,215
"AATCGACCACTACACA",0,4,0,0,0,4,88
"AATCGACCAGACAAGC",0,0,0,0,0,0,37
"AATCGACGTCATCCCT",3,14,4,0,6,27,440
"AATCGACGTCGCATTA",17,189,41,6,31,284,10709
"AATCGACGTTGCAAGG",3,29,4,0,6,42,1160
"AATCGACTCCACTAGA",7,14,5,2,4,32,399
"AATCGTGGTATCGCAT",0,0,0,0,0,0,11
"AATCGTGGTCCTACGG",0,7,2,0,3,12,112
"AATCGTGGTCGTTCAA",1,3,2,0,0,6,38
"AATCGTGTCCGCAGTG",4,19,4,0,3,30,660
"AATCGTGTCTAGTGTG",1,15,5,0,8,29,671
"AATCGTGTCTGAGGTT",0,3,4,0,0,7,86
"AATGAAGAGCGCCTCA",2,6,0,0,0,8,96
"AATGAAGCAATAACGA",2,14,7,0,2,25,287
"AATGAAGCACCTGCAG",1,3,3,3,2,12,199
"AATGAAGCAGACACAG",0,0,2,0,0,2,55
"AATGAAGCAGTTTCAG",1,9,6,0,3,19,401
"AATGAAGCATGGTACT",0,5,0,0,0,5,108
"AATGAAGGTTATGTCG",1,7,2,0,0,10,61
"AATGAAGGTTGAATCC",2,3,2,0,0,7,98
"AATGAAGTCCATTGTT",2,19,5,2,6,34,518
"AATGAAGTCGCCATAA",1,6,0,0,0,7,69
"AATGAAGTCTACAGGT",0,2,0,0,0,2,16
"AATGACCAGAGCACTG",0,0,2,0,0,2,12
"AATGACCAGCATCAAA",1,14,5,2,5,27,80
"AATGACCTCGGAATGG",4,23,5,2,19,53,1549
"AATGACCTCTGTGCTC",0,6,0,0,0,6,317
"AATGCCAAGGACGCTA",0,0,0,0,0,0,3
"AATGCCAAGGCACTCC",3,12,15,0,2,32,1452
"AATGCCAAGGCTTTCA",1,11,0,2,3,17,505
"AATGCCACAACCTATG",1,14,5,0,6,26,509
"AATGCCACACTATGTG",1,7,0,0,0,8,216
"AATGCCATCGATTTCT",2,18,6,0,0,26,710
"AATGCCATCTACCACC",0,4,0,0,0,4,113
"AATGCCATCTTCCCAG",1,22,5,0,2,30,1714
"AATGGAAAGACCCGCT",1,0,0,0,0,1,13
"AATGGAAAGCGTCAAG",0,2,0,0,0,2,22
"AATGGAAAGGACTAAT",2,20,2,0,18,42,988
"AATGGAAGTCTAGTGT",0,4,0,0,0,4,124
"AATGGAATCACGGGAA",0,2,0,0,0,2,74
"AATGGAATCTAGACAC",0,6,0,0,0,6,124
"AATGGCTAGAGGCGGA",0,3,0,0,0,3,40
"AATGGCTAGTTTCTTC",1,3,0,0,0,4,88
"AATGGCTCACCCAATA",0,0,0,0,0,0,9
"AATGGCTGTCTGCCTT",1,15,3,0,0,19,312
"AATGGCTGTTGATCGT",1,10,0,0,0,11,337
"AATGGCTGTTGTCTAG",3,59,13,0,12,87,3438
"AATGGCTTCTGGGCCA",2,5,2,0,0,9,286
"AATGGCTTCTTCACAT",20,93,259,7,42,421,16352
"AATTCCTAGCATCCTA",3,11,2,0,7,23,442
"AATTCCTAGTCCGTCG",0,2,0,0,0,2,55
"AATTCCTCACTGGACC",82,940,137,44,131,1334,43329
"AATTCCTGTATGGAGC",0,7,0,0,2,9,111
"AATTCCTGTCGTGCCA",1,11,4,0,2,18,88
"AATTCCTTCCACGTGG",0,4,0,0,2,6,86
"AATTCCTTCTAGGCCG",0,2,0,0,0,2,56
"AATTTCCAGAAAGTCT",5,7,0,2,4,18,59
"AATTTCCAGATTGGGC",0,5,0,0,2,7,68
"AATTTCCAGTGGATTA",9,31,61,4,15,120,3670
"AATTTCCCACATTACG",45,248,114,20,55,482,17364
"AATTTCCCACTTGTCC",0,0,0,0,0,0,13
"AATTTCCGTTTGGCTA",0,7,3,0,7,17,111
"AATTTCCTCAAGGACG",0,2,0,0,0,2,41
"AATTTCCTCCACCTGT",0,4,0,0,0,4,67
"AATTTCCTCCATCGTC",0,11,2,0,5,18,408
"AATTTCCTCGACCCAG",3,7,0,0,4,14,316
"ACAAAGAAGAGCAAGA",3,13,3,0,3,22,305
"ACAAAGAAGAGGCGTT",1,8,0,0,0,9,55
"ACAAAGAAGCATAGGC",0,3,0,0,0,3,106
"ACAAAGAAGGAAAGTG",0,2,0,0,0,2,86
"ACAAAGAAGGACAGTC",2,2,0,2,2,8,76
"ACAAAGACAGGAACCA",0,3,0,0,0,3,107
"ACAAAGACATCCCGTT",0,2,0,0,2,4,13
"ACAAAGAGTCCATAGT",1,2,0,0,0,3,7
"ACAAAGAGTTAGTCGT",1,16,5,0,3,25,561
"ACAAAGAGTTCTCTAT",1,7,2,0,2,12,26
"ACAAAGATCCACTAGA",0,3,0,0,0,3,97
"ACAAAGATCTAGTGAC",2,20,0,0,9,31,315
"ACAACCAAGATGGCAC",25,78,266,5,45,419,15640
"ACAACCAAGCGACATG",2,22,45,0,5,74,2686
"ACAACCACAACGACAG",0,0,0,0,0,0,149
"ACAACCACAGAGAATT",2,25,3,0,13,43,989
"ACAACCAGTCGTGTTA",0,4,0,0,0,4,38
"ACAACCATCAACCTCC",0,3,0,0,2,5,233
"ACAACCATCAGCAGAG",2,4,6,0,0,12,662
"ACAACCATCGCCTTGT",1,4,2,0,0,7,46
"ACAACCATCGGTTGTA",1,4,0,0,3,8,256
"ACAACCATCTCTCTTC",2,7,5,0,2,16,214
"ACAAGCTAGTCACGCC",1,0,0,0,0,1,27
"ACAAGCTCAAAGCACG",76,621,116,25,89,927,28702
"ACAAGCTCAGAGATGC",3,27,31,2,5,68,2502
"ACAAGCTGTACAGAGC",1,2,0,0,0,3,21
"ACAAGCTGTTCTTCAT",2,13,5,0,3,23,619
"ACAAGCTGTTGGGTTT",1,20,0,0,7,28,41
"ACAAGCTGTTTCACTT",0,4,0,0,0,4,29
"ACAAGCTTCCCAAGCG",0,9,2,0,2,13,96
"ACAAGCTTCTGCTGAA",1,4,0,0,0,5,5
"ACAAGCTTCTTCTGGC",1,7,6,0,3,17,383
"ACACAGTAGATGAATC",0,2,0,0,0,2,108
"ACACAGTAGGTACATA",0,0,0,0,2,2,11
"ACACAGTAGTAAACTG",8,28,70,4,9,119,4345
"ACACAGTCAACGCATT",16,239,46,7,32,340,10079
"ACACAGTCAATTGAAG",1,9,4,0,2,16,349
"ACACAGTCAGCCGTCA",5,39,7,3,6,60,2125
"ACACAGTGTGCAACAG",0,7,0,0,2,9,287
"ACACAGTGTGCGAGTA",1,2,0,0,0,3,65
"ACACAGTGTGCTAGCC",3,16,5,2,3,29,375
"ACACAGTGTTTGCCGG",16,217,30,10,25,298,10182
"ACACAGTTCAACTCTT",0,3,0,0,0,3,93
"ACACAGTTCGTAGAGG",3,22,5,3,0,33,606
"ACACCAAAGGTGCGAT",0,0,0,0,2,2,20
"ACACCAACAACGTTAC",0,2,0,0,0,2,145
"ACACCAACAATGTGGG",0,22,4,0,3,29,579
"ACACCAACAGTAGAAT",1,7,2,0,3,13,57
"ACACCAAGTAACGATA",2,2,4,0,2,10,132
"ACACCAAGTGCGTCGT",0,0,0,0,0,0,4
"ACACCAATCCTACCGT",2,40,5,2,5,54,2034
"ACACCAATCTGGAGAG",6,31,63,3,12,115,4539
"ACACCAATCTTCGATT",2,6,2,0,0,10,145
"ACACGCGAGTCACAGG",1,4,0,0,0,5,157
"ACACGCGAGTTTCGAC",0,4,0,0,0,4,63
"ACACGCGCAGCTCGGT",0,0,3,0,2,5,94
"ACACGCGCAGCTTTCC",1,10,5,0,4,20,553
"ACACGCGCAGGGTCTC",0,0,0,0,0,0,98
"ACACGCGCATAGAATG",0,0,3,0,0,3,65
"ACACGCGCATTAGGAA",0,2,0,0,0,2,137
"ACACGCGGTACGGCAA",22,228,39,7,38,334,13404
"ACACGCGGTCGCAACC",0,3,0,0,0,3,57
"ACACGCGGTTGGACTT",5,28,59,2,9,103,5042
"ACACGCGTCAAGCCGC",0,7,6,0,5,18,361
"ACACGCGTCAAGTAAG",0,3,2,0,0,5,81
"ACACGCGTCATCACTT",0,3,0,0,0,3,84
"ACACGCGTCCATAAGC",2,13,2,0,2,19,503
"ACACGCGTCCATACAG",51,31,7,0,6,95,2528
"ACACGCGTCGGCCCAA",0,2,0,0,0,2,13
"ACACGCGTCTCAAAGC",0,0,0,0,0,0,3
"ACACTGAAGGGTGAAA",522,374,108,30,109,1143,38298
"ACACTGAAGTAGTCTC",3,10,6,0,26,45,1085
"ACACTGACAAGTGGCA",1,2,2,0,4,9,115
"ACACTGAGTCAAAGTA",0,2,3,0,0,5,98
"ACACTGAGTCGAACAG",0,0,0,0,2,2,115
"ACACTGAGTCTGTCCT",2,14,2,0,3,21,241
"ACACTGAGTCTTCCGT",0,10,3,0,3,16,296
"ACAGAAAAGAAACTGT",0,2,0,0,0,2,109
"ACAGAAAAGGAACATT",0,11,4,0,5,20,236
"ACAGAAAAGTTATGGA",0,6,0,0,0,6,96
"ACAGAAACAAATGGTA",0,4,0,0,0,4,37
"ACAGAAACACAATCTG",4,9,3,0,2,18,356
"ACAGAAACACGTAACT",12,31,76,3,18,140,5274
"ACAGAAACAGCAATTC",0,0,0,0,0,0,115
"ACAGAAACAGCGTTTA",0,3,0,0,2,5,22
"ACAGAAACATACTGAC",0,6,2,0,0,8,140
"ACAGAAACATGCAGCC",2,6,0,0,0,8,110
"ACAGAAAGTGATACCT",2,10,3,0,2,17,320
"ACAGAAAGTGTACATC",0,2,0,0,0,2,14
"ACAGAAAGTTAGGAGC",0,3,0,0,0,3,16
"ACAGCCGAGACCAAAT",1,0,0,0,0,1,117
"ACAGCCGAGATTACCC",0,2,0,0,0,2,71
"ACAGCCGAGCCTGCCA",1,11,0,0,0,12,325
"ACAGCCGAGTCTTGGT",0,3,2,0,0,5,159
"ACAGCCGCAAGGCCTC",0,3,0,0,0,3,5
"ACAGGGAAGACTTCGT",0,10,2,0,2,14,161
"ACAGGGAAGCAGGGAG",0,7,2,0,0,9,284
"ACAGGGACAATTGCGT",1,12,0,2,2,17,270
"ACAGGGACAGTGGCTC",1,0,0,0,0,1,99
"ACAGGGACATCTTTCA",9,43,46,3,54,155,5738
"ACAGGGAGTCTAATCG",0,0,2,0,0,2,37
"ACAGGGAGTTTGTGGT",0,4,3,0,0,7,142
"ACATCCCCATCCTTGC",0,4,0,0,0,4,111
"ACATCCCGTCAGGCAA",0,0,0,0,0,0,33
"ACATCCCGTCCCTGAG",1,6,0,0,0,7,134
"ACATCCCGTCCTGGGT",5,16,5,0,5,31,660
"ACATCCCGTCTCGCGA",4,30,7,0,7,48,1685
"ACATCCCTCCGCACGA",0,45,8,0,3,56,1558
"ACATCGAAGACCGCCT",0,6,3,0,0,9,82
"ACATCGAAGTTGCGCC",0,2,0,0,0,2,51
"ACATCGACATGATAGA",5,22,8,3,17,55,1050
"ACATCGAGTCGTGGTC",0,2,0,0,0,2,104
"ACATCGAGTTGGCTAT",0,2,0,0,2,4,27
"ACATCGATCCAAGGGA",0,0,0,0,2,2,32
"ACATCGATCCCAGCGA",0,0,0,0,0,0,80
"ACATCGATCCCATAAG",1,9,4,0,2,16,263
"ACATCGATCCGCAGTG",8,38,75,4,39,164,5233
"ACATGCAAGGAATGTT",0,3,0,0,0,3,62
"ACATGCAAGGCAATGC",9,17,10,0,51,87,3362
"ACATGCAAGGTAGGCT",0,12,3,2,10,27,889
"ACATGCAAGGTCATCT",3,9,0,0,0,12,116
"ACATGCACACTCTAGA",108,1139,251,55,183,1736,59657
"ACATGCAGTCTGCGCA",0,3,0,0,2,5,266
"ACATGCAGTGATTAGA",1,2,0,0,2,5,70
"ACATGCAGTGTTCCAA",0,2,2,0,0,4,72
"ACATGCATCTCGTCGT",1,0,0,0,0,1,51
"ACATTTCAGTTGTAGA",0,8,0,0,2,10,104
"ACATTTCCAGAGATGC",0,10,5,0,2,17,348
"ACATTTCGTAAGGTCG",4,15,5,3,25,52,1164
"ACATTTCGTGAAAGTT",2,7,2,0,2,13,296
"ACCAAACAGATGATTG",3,11,7,0,4,25,530
"ACCAAACAGCCGAATG",0,6,0,0,0,6,194
"ACCAAACAGCCGCACT",1,2,0,0,0,3,35
"ACCAAACCAAATGATG",0,0,0,0,0,0,54
"ACCAAACCAGATACCT",0,0,2,0,0,2,33
"ACCAAACGTGACATCT",0,4,0,0,0,4,137
"ACCAAACGTGAGATCG",0,2,0,0,0,2,23
"ACCAAACGTTCTTGCC",2,30,71,6,28,137,6669
"ACCAAACTCCTAGCGG",1,10,0,0,0,11,306
"ACCAAACTCGGTCGAC",0,0,0,0,0,0,77
"ACCAAACTCTAATTCC",1,0,0,0,0,1,5
"ACCAACAAGAGTTGAT",35,468,78,19,77,677,25207
"ACCAACAAGCCAAGCA",0,0,0,0,0,0,118
"ACCAACAAGTGTACAA",0,0,0,0,0,0,4
"ACCAACACAAGACTGG",1,6,3,0,2,12,25
"ACCAACACAGCATACT",6,82,12,6,16,122,4072
"ACCAACACAGGATCTT",0,5,0,0,0,5,205
"ACCAACACATTGACCA",13,172,38,6,28,257,10547
"ACCAACAGTTCCACGG",0,0,0,0,0,0,1
"ACCAACATCATTGTGG",0,4,0,0,0,4,77
"ACCAACATCCGTATGA",5,18,16,2,59,100,3686
"ACCAACATCTTCCCAG",1,11,4,0,0,16,330
"ACCAACATCTTGCAAG",0,3,4,0,0,7,104
"ACCACAAAGGTCACCC",1,12,5,2,0,20,338
"ACCACAAAGTAGGTTA",15,67,95,7,136,320,12315
"ACCACAACAGATCACT",1,7,0,0,0,8,105
"ACCACAACATAAGCGG",0,2,0,0,0,2,104
"ACCACAAGTTGGCCTG",2,8,0,0,0,10,71
"ACCACAATCAGACTGT",18,230,40,3,36,327,11710
"ACCATTTAGAACTGAT",0,0,0,0,2,2,65
"ACCATTTAGCATGCGA",9,20,5,4,27,65,1250
"ACCATTTAGGCATTTC",45,143,364,19,64,635,26229
"ACCATTTAGTGTCATC",0,2,0,0,0,2,5
"ACCATTTCAGGACTTT",0,0,0,0,0,0,93
"ACCATTTCATGATCTG",2,11,9,0,0,22,344
"ACCATTTGTAATTAGG",1,7,0,0,0,8,185
"ACCATTTGTCCTCATC",5,50,7,2,10,74,3343
"ACCATTTTCCATCCGT",1,0,0,0,0,1,162
"ACCATTTTCTTCCCGA",1,4,0,0,0,5,132
"ACCCAAAAGAATCGCG",16,162,26,9,25,238,7165
"ACCCAAAAGCTGAGCA",111,427,92,14,64,708,20807
"ACCCAAAAGGCTAAAT",0,4,2,0,0,6,158
"ACCCAAACATATGGCT",1,6,18,0,11,36,797
"ACCCAAATCAGTGATC",0,6,3,0,0,9,43
"ACCCAAATCATACGGT",1,11,4,3,3,22,350
"ACCCAAATCGTTCTGC",0,0,0,0,0,0,75
"ACCCTCAAGACCTCCG",0,7,3,0,0,10,314
"ACCCTCAAGTGAGTTA",0,5,2,0,4,11,118
"ACCCTCAGTAGGATAT",2,17,5,0,4,28,459
"ACCCTCATCAGCCTTC",0,0,0,0,0,0,9
"ACCCTTGAGGCACCAA",2,14,3,0,5,24,362
"ACCCTTGAGGTCACAG",1,0,0,0,0,1,23
"ACCCTTGCAATGAAAC",0,0,0,0,0,0,199
"ACCCTTGGTCGAGTGA",5,42,16,37,8,108,4227
"ACCCTTGGTTAACCTG",1,3,0,0,0,4,74
"ACCCTTGGTTACGTAC",0,0,0,0,0,0,20
"ACCCTTGGTTCATCTT",4,20,3,0,3,30,853
"ACCCTTGTCTAAGCGT",1,18,0,0,0,19,320
"ACCCTTGTCTAGATCG",1,5,3,0,2,11,19
"ACCGTTCAGGCCACCT",4,22,9,2,20,57,1932
"ACCGTTCAGTGTTCAC",0,14,4,2,5,25,290
"ACCGTTCCAATGAGCG",3,19,28,0,7,57,1894
"ACCGTTCCAGCCTATA",0,4,0,0,0,4,23
"ACCGTTCCAGCTCTGG",1,11,0,0,0,12,516
"ACCGTTCGTAGCTGAG",175,90,39,13,29,346,11070
"ACCGTTCGTGGCTACC",0,0,0,0,0,0,33
"ACCGTTCGTGGTCCCA",1,7,2,0,0,10,23
"ACCGTTCGTTAGAGAT",1,0,0,3,0,4,55
"ACCGTTCGTTGTCCCT",0,4,0,0,2,6,61
"ACCGTTCTCAAGCTGT",3,15,3,0,5,26,528
"ACCGTTCTCATTTCCA",3,16,12,0,5,36,633
"ACCGTTCTCCTTGACC",11,109,22,2,19,163,5470
"ACCGTTCTCGCTGTTC",0,9,2,0,0,11,845
"ACCGTTCTCTCATGCC",1,5,0,0,0,6,165
"ACCTACCAGCAGGCAT",0,0,0,0,0,0,2
"ACCTACCAGTGGATAT",19,52,105,10,30,216,7544
"ACCTACCCATCTCAAG",0,0,0,0,0,0,30
"ACCTACCCATGAAGCG",0,2,0,0,0,2,33
"ACCTACCGTCCGAAAG",11,24,12,3,58,108,2955
"ACCTACCTCATAAGGA",1,3,4,0,0,8,42
"ACCTACCTCGCTCCTA",0,4,0,0,0,4,107
"ACCTGAAAGACATGCG",1,0,0,0,0,1,76
"ACCTGAAAGAGAGGGC",0,0,0,0,0,0,2
"ACCTGAACAAATACGA",4,72,24,5,14,119,3524
"ACCTGAACAGATTAAG",3,13,5,0,4,25,317
"ACCTGAACAGTGCGCT",1,2,0,0,0,3,98
"ACCTGAACATGGGATG",0,3,0,0,0,3,115
"ACCTGAACATTAAAGG",3,25,2,0,3,33,387
"ACCTGAAGTATCAGCT",1,14,5,0,0,20,519
"ACCTGAAGTTCTTAGG",0,0,0,0,0,0,17
"ACCTGTCAGACTACGG",34,114,57,12,260,477,13036
"ACCTGTCAGAGAATCT",0,4,0,0,0,4,51
"ACCTGTCAGCTGGCTC",0,5,5,0,3,13,427
"ACCTGTCAGGTGCTTT",1,4,0,0,0,5,118
"ACCTGTCAGGTTCACT",0,0,0,0,2,2,53
"ACCTGTCCAGTGCCTG",1,13,4,0,2,20,68
"ACCTGTCGTAATACCC",0,2,0,0,0,2,41
"ACCTGTCGTAGCGAGT",0,9,0,0,0,9,356
"ACCTGTCGTGGAGGTT",3,14,2,0,0,19,272
"ACCTGTCGTGTCATGT",1,0,0,0,0,1,43
"ACCTGTCTCATATGGC",2,19,5,2,6,34,1327
"ACGATCAAGAAGGATG",2,11,0,2,3,18,333
"ACGATCAAGACGCATG",0,0,0,2,0,2,113
"ACGATCAAGCCTGAGA",13,54,131,7,32,237,8366
"ACGATCAAGGATCATA",2,31,5,2,11,51,455
"ACGATCAAGTGTAGAT",1,2,0,0,0,3,57
"ACGATCACACCTGTCT",1,7,0,0,3,11,279
"ACGATCAGTCCTATAG",0,2,0,0,0,2,31
"ACGATCAGTGTCCAAT",18,164,24,6,25,237,10190
"ACGATCATCGATTGGT",1,0,0,0,0,1,59
"ACGATGTAGTAAGACT",2,17,2,4,3,28,114
"ACGATGTCATCGCTAA",10,38,68,2,20,138,4184
"ACGATGTTCAGACTGT",1,17,5,2,3,28,333
"ACGATGTTCGAGTGGA",2,12,4,2,2,22,682
"ACGATGTTCTCGGTAA",1,0,0,0,0,1,109
"ACGATGTTCTGCCTCA",1,5,2,0,0,8,486
"ACGCACGAGAAACTGT",0,0,3,0,0,3,30
"ACGCACGGTCACTAGT",1,0,0,0,0,1,41
"ACGCACGTCTAGTCAG",2,4,4,0,3,13,341
"ACGGAAGCAAACCGGA",1,4,4,0,2,11,230
"ACGGAAGCAGGGTTGA",1,2,0,0,0,3,64
"ACGGAAGCATAACAGA",3,30,3,2,4,42,1142
"ACGGAAGGTTTCAGAC",2,12,2,3,3,22,109
"ACGGAAGTCCACGTGG",2,0,0,0,0,2,111
"ACGGAAGTCTGAGAAA",0,6,0,0,0,6,231
"ACGGAAGTCTGAGAGG",0,6,2,0,0,8,69
"ACGGGTCAGACCACGA",19,31,17,3,12,82,1553
"ACGGGTCAGCACTCAT",1,18,0,0,4,23,481
"ACGGGTCAGTGCTCGC",1,4,0,0,0,5,81
"ACGGGTCCACACCAGC",0,4,0,0,0,4,80
"ACGGTCGAGGTTTACC",0,0,0,0,0,0,7
"ACGGTCGTCATGCGGC",26,355,66,15,60,522,13025
"ACGGTCGTCCTCAGAA",1,8,8,0,2,19,301
"ACGGTCGTCGTCCTTG",0,2,2,0,0,4,32
"ACGGTCGTCTACGGGC",0,0,0,0,0,0,23
"ACGGTCGTCTTAGGAC",0,13,3,0,9,25,448
"ACGGTTAAGAGATCGC",4,25,8,2,7,46,1349
"ACGGTTAAGAGGCGTT",0,3,0,0,0,3,82
"ACGGTTAAGGCACAAC",0,3,0,0,2,5,79
"ACGGTTACAAATGAGT",1,6,2,0,0,9,77
"ACGGTTACAAATTGCC",0,0,0,0,0,0,25
"ACGGTTACATCTCCCA",0,3,0,0,0,3,43
"ACGGTTACATTCAGCA",2,15,2,2,6,27,774
"ACGGTTAGTCTAGATC",6,17,7,3,4,37,493
"ACGGTTATCAGCGGAA",24,79,15,4,8,130,5220
"ACGGTTATCCCACAGG",0,4,0,0,0,4,14
"ACGGTTATCCGTAATG",0,0,0,0,0,0,26
"ACGGTTATCGCTTAAG",0,2,3,0,2,7,66
"ACGGTTATCTAGGAAA",0,3,3,0,0,6,161
"ACGGTTATCTTTGATC",0,0,0,0,0,0,13
"ACGTAACAGATCACCT",0,3,2,0,0,5,38
"ACGTAACAGCCGTTAT",7,31,33,3,8,82,1565
"ACGTAACAGCGGTAAC",2,4,4,0,0,10,243
"ACGTAACAGGCGAACT",0,3,2,0,3,8,72
"ACGTAACAGGGCCTCT",2,17,2,2,3,26,390
"ACGTAACAGGGTAGCT",1,17,2,0,3,23,319
"ACGTAACCAGGATTCT",0,3,0,0,0,3,160
"ACGTAACTCAAGAGTA",0,6,0,0,0,6,134
"ACGTAACTCGGCTGGT",1,2,0,0,0,3,124
"ACGTAACTCTCAAAGC",1,4,0,0,2,7,93
"ACGTAACTCTTAGCCC",0,3,0,0,0,3,54
"ACGTACAAGCCAGTAG",4,24,66,2,14,110,3908
"ACGTACACAAGTGACG",5,2,0,0,0,7,125
"ACGTACACAATTCTCT",0,8,3,0,3,14,195
"ACGTACACACGTGTGC",1,3,0,0,0,4,61
"ACGTACACATAATGCC",9,38,63,0,10,120,3515
"ACGTACATCACCATAG",1,4,0,0,0,5,139
"ACGTACATCCTACCGT",1,0,0,0,3,4,27
"ACGTAGTAGGGTCACA",0,5,0,0,0,5,52
"ACGTAGTAGTTACGGG",14,57,21,4,20,116,2662
"ACGTAGTCAATTCGTG",0,0,0,0,0,0,25
"ACGTAGTTCGGATTAC",0,2,2,0,0,4,158
"ACGTAGTTCGTCAGAT",2,14,4,0,33,53,1968
"ACGTAGTTCTCGTGGG",0,0,0,0,0,0,60
"ACGTCCTAGCGTGAGT",1,13,2,0,0,16,465
"ACGTCCTCAAACCATC",0,7,0,0,0,7,83
"ACGTCCTCAACGCATT",2,6,0,0,0,8,71
"ACGTCCTCAAGGCGTA",0,5,0,0,0,5,186
"ACGTCCTCAGCTGCCA",0,0,2,0,0,2,125
"ACGTCCTGTTGTCAGT",1,16,7,0,10,34,887
"ACGTCCTTCTGGGATT",0,17,2,0,5,24,421
"ACGTTCCCAAAGAACT",1,4,0,0,0,5,134
"ACGTTCCCAGTAACCT",0,0,0,0,0,0,44
"ACGTTCCTCCCATAGA",11,60,146,7,28,252,10632
"ACGTTCCTCTAGGCCG",0,0,0,0,0,0,8
"ACTACGAAGTTCCTGA",6,30,63,3,15,117,3775
"ACTACGACAGTCCGTG",0,2,0,0,0,2,87
"ACTACGACATCGATGT",0,6,0,0,0,6,74
"ACTACGAGTCGTGTTA",22,25,10,42,10,109,1445
"ACTACGATCGAGAAAT",0,6,0,0,0,6,54
"ACTACGATCGTCTCAC",0,3,0,0,0,3,79
"ACTACGATCTCCTACG",0,4,0,0,0,4,51
"ACTATCTAGTTTCGGT",0,2,2,0,0,4,137
"ACTATCTCATGAAGCG",5,21,9,6,28,69,2458
"ACTATCTCATTGCAAC",0,3,0,0,0,3,212
"ACTATCTGTCTGCATA",1,3,0,0,0,4,142
"ACTATCTGTTTCGTTT",6,23,5,0,13,47,120
"ACTATCTTCCAGCTCT",0,0,0,0,2,2,223
"ACTATCTTCGCAATTG",16,194,38,11,39,298,10649
"ACTATCTTCTAACACG",0,0,0,0,0,0,41
"ACTATGGAGTTTAGGA",1,5,0,0,0,6,137
"ACTATGGCAAGAATGT",18,101,16,2,21,158,3952
"ACTATGGCACTACAGT",1,0,0,0,0,1,24
"ACTATGGGTGTAAATG",26,68,137,10,68,309,12761
"ACTATGGTCTCCCTAG",5,31,16,0,52,104,4264
"ACTATTCAGATACATG",0,5,0,0,0,5,75
"ACTATTCAGCCAAGTG",8,54,27,5,8,102,4120
"ACTATTCAGGTACAAT",0,6,0,0,0,6,114
"ACTATTCCACGGTGCT",12,23,7,0,7,49,603
"ACTATTCCACGTCTCT",0,2,0,0,0,2,52
"ACTATTCGTAATCAGA",5,21,6,0,10,42,508
"ACTATTCTCACTCACC",0,2,2,0,0,4,62
"ACTATTCTCGCGTCGA",0,5,0,0,0,5,41
"ACTATTCTCGTGCATA",0,6,0,0,2,8,83
"ACTCCCAAGACTCTAC",5,12,4,0,2,23,300
"ACTCCCAAGCAATTCC",0,5,0,0,2,7,285
"ACTCCCAAGGGCAGTT",4,18,3,0,5,30,1495
"ACTCCCAAGGTTTGAA",2,15,0,0,4,21,256
"ACTCCCAAGTTGGACG",0,12,3,0,9,24,843
"ACTCCCACACGTGAGA",9,101,17,3,12,142,5523
"ACTCCCACAGTACTAC",3,3,3,0,0,9,194
"ACTCCCACATTGAAGA",106,922,222,53,176,1479,50387
"ACTCCCAGTCACTGAT",0,0,0,0,0,0,6
"ACTCCCAGTGCGAGTA",0,4,0,0,0,4,89
"ACTCCCATCGTGTGGC",3,7,3,0,4,17,449
"ACTCCCATCTCCTGCA",0,0,0,0,0,0,16
"ACTCTCGAGGTTGGTG",0,7,0,0,0,7,99
"ACTCTCGCATATCTCT",0,0,0,0,0,0,60
"ACTCTCGCATCACGGC",1,0,0,0,0,1,96
"ACTCTCGTCCCTCTAG",2,6,0,0,4,12,356
"ACTCTCGTCTAAGAAG",7,25,16,4,35,87,2504
"ACTGATGAGCGCTTCG",1,2,0,0,0,3,107
"ACTGATGAGGTACTGG",0,16,5,0,3,24,373
"ACTGATGCAATCTCGA",1,11,3,0,0,15,37
"ACTGATGCACATCATG",1,2,0,0,0,3,23
"ACTGATGCATGCGTGC",1,12,4,0,0,17,399
"ACTGATGGTCCTCAGG",8,19,33,0,9,69,1945
"ACTGATGGTGAGAACC",0,0,0,0,0,0,67
"ACTGATGGTTAGGCTT",1,8,0,0,0,9,396
"ACTGATGTCTACCTTA",1,3,0,0,0,4,44
"ACTGATGTCTCAACCC",0,19,3,2,5,29,735
"ACTGATGTCTGGGCGT",1,18,3,3,14,39,652
"ACTGCAAAGAATCCCT",1,10,2,0,3,16,355
"ACTGCAAAGCTCATAC",0,0,0,0,0,0,3
"ACTGCAAAGCTGTACT",17,144,27,11,25,224,7465
"ACTGCAACAACCACGC",0,0,0,0,0,0,35
"ACTGCAACAAGCGATG",0,0,0,0,0,0,19
"ACTGCAACACTACCCT",0,3,0,0,0,3,91
"ACTGCAACACTCAAGT",4,34,9,0,9,56,1400
"ACTGCAAGTAACTAAG",0,6,0,0,0,6,9
"ACTGCAAGTAGAGATT",1,3,0,0,3,7,104
"ACTGCAATCCGGTAAT",0,0,0,0,0,0,3
"ACTGCAATCGATTGGT",0,5,0,0,0,5,140
"ACTGCAATCTAGAACC",3,8,0,0,2,13,234
"ACTGCAATCTAGGCCG",0,2,0,0,0,2,27
"ACTGTCCAGGACCCAA",0,2,0,0,0,2,118
"ACTGTCCAGTATAGAC",1,0,2,0,2,5,99
"ACTGTCCGTAGGATAT",1,2,0,0,0,3,89
"ACTGTCCGTCATCAGT",7,80,9,4,16,116,3841
"ACTGTCCGTCTCGCGA",0,3,0,0,0,3,19
"ACTGTCCGTTATGTGC",1,0,0,0,0,1,97
"ACTGTCCTCAGAATAG",1,3,0,0,0,4,160
"ACTGTCCTCTTTCTAG",0,5,0,0,0,5,56
"ACTGTGACAAGCCTGC",1,2,0,0,0,3,48
"ACTGTGACACAACGTT",0,3,0,0,0,3,149
"ACTGTGACACTGCACG",0,7,0,0,0,7,236
"ACTGTGACACTGTTCC",26,200,27,5,33,291,10152
"ACTGTGACAGTCTACA",82,316,68,15,53,534,19466
"ACTGTGACATCGATGT",1,7,2,0,0,10,172
"ACTGTGACATCTTTCA",0,2,0,0,0,2,91
"ACTGTGAGTAGCACAG",66,680,141,24,103,1014,37823
"ACTGTGAGTCAGGCAA",7,19,7,0,2,35,1301
"ACTGTGAGTCCTATAG",0,3,3,0,2,8,209
"ACTGTGAGTCGTACTA",1,14,4,0,3,22,253
"ACTGTGAGTCTGTGCG",3,12,8,0,12,35,599
"ACTGTGAGTGCCCACA",2,7,0,0,0,9,76
"ACTGTGAGTTGACGGA",0,2,0,0,0,2,116
"ACTGTGATCACAACCA",0,0,0,0,0,0,102
"ACTTAGGAGAGTCACG",34,76,29,5,19,163,4005
"ACTTAGGAGCAATTAG",177,1363,345,73,298,2256,78297
"ACTTAGGCATACCGTA",0,4,0,0,0,4,29
"ACTTAGGGTAATGATG",2,15,5,0,13,35,1226
"ACTTAGGGTTCACCGG",0,15,4,0,9,28,661
"ACTTAGGTCCTACAAG",14,123,19,3,14,173,6150
"ACTTAGGTCGCCAACG",1,4,0,0,0,5,196
"ACTTATCAGGGAGAAT",32,28,13,5,10,88,2406
"ACTTATCCACAGAAGC",1,8,3,3,3,18,488
"ACTTATCCATTGTACG",2,7,4,0,2,15,119
"ACTTATCGTGATCGTT",0,5,0,0,0,5,122
"ACTTATCGTGTGGTCC",2,16,21,2,12,53,1132
"ACTTATCTCATGAGGG",1,4,0,0,2,7,68
"ACTTATCTCGCCTTGT",0,6,0,0,0,6,296
"ACTTCCGAGGATGAGA",0,4,0,0,0,4,63
"ACTTCCGCACATACGT",1,22,7,0,8,38,343
"ACTTCCGGTAATGCTC",6,50,10,0,12,78,2661
"ACTTCCGGTTGTGTTG",0,9,0,0,5,14,215
"ACTTCCGTCACGAACT",1,4,0,0,0,5,55
"ACTTCCGTCCTACACC",0,2,5,0,0,7,119
"ACTTCGCCAAAGCTAA",1,4,0,0,2,7,83
"ACTTCGCCAATAACGA",0,5,2,0,0,7,150
"ACTTCGCCAGCACAGA",24,219,61,12,38,354,10621
"ACTTCGCCAGGTGACA",0,2,0,0,2,4,62
"ACTTCGCCATCGCTCT",2,8,3,0,9,22,105
"ACTTCGCGTGTACAGG",0,0,0,0,0,0,15
"ACTTCGCTCCCACAGG",0,2,4,0,0,6,198
"ACTTCGCTCGATGCTA",0,8,3,0,2,13,32
"ACTTCGCTCGCAGTTA",0,6,2,0,2,10,228
"ACTTTCAGTGCATGAG",0,4,3,0,0,7,133
"ACTTTCAGTGGTTTAC",0,4,0,0,0,4,86
"ACTTTCAGTGTTTGCA",2,12,2,0,7,23,494
"ACTTTCAGTTCCAGGC",0,20,2,2,4,28,545
"ACTTTCATCGTTGTTT",0,3,0,0,0,3,37
"ACTTTCATCTGGGCGT",0,5,0,0,0,5,52
"ACTTTGTGTACCCAGC",1,6,2,0,0,9,56
"ACTTTGTGTCCTTAAG",0,3,0,0,0,3,162
"ACTTTGTGTCGGATTT",0,3,0,0,0,3,288
"ACTTTGTGTTCAGGTT",0,6,2,0,0,8,83
"ACTTTGTTCCATAAGC",3,20,3,2,6,34,493
"ACTTTGTTCGGCGATC",0,2,0,0,0,2,46
"AGAAATGAGAGGCTGT",0,3,0,0,0,3,42
"AGAAATGAGCCTGGAA",1,0,2,0,0,3,49
"AGAAATGAGTCTTCCC",1,4,0,0,0,5,136
"AGAAATGAGTGGTGGT",1,8,2,0,0,11,141
"AGAAATGGTAATGTGA",37,30,20,0,10,97,1871
"AGAAATGGTCAAGCCC",80,948,164,41,128,1361,41263
"AGAAATGGTGTCGCTG",0,4,0,0,0,4,45
"AGAAATGTCGATACGT",0,4,0,0,2,6,107
"AGAAATGTCGCCTCTA",0,5,0,0,0,5,206
"AGAAATGTCGGCATCG",0,3,0,0,2,5,101
"AGAACAAAGTATGGCG",2,18,23,0,4,47,1230
"AGAACAATCACTGCTC",0,5,0,0,0,5,139
"AGAACAATCTTTACAC",2,14,3,0,7,26,366
"AGAACCTAGCAGTACG",1,0,0,0,0,1,95
"AGAACCTAGTTACGTC",0,0,0,0,0,0,32
"AGAACCTGTCACATTG",88,465,89,76,84,802,23874
"AGAACCTGTGATTGGG",1,3,12,0,0,16,744
"AGAACCTGTGCAGATG",0,0,0,0,2,2,63
"AGAACCTTCAGGAGAC",1,0,0,0,0,1,22
"AGAACCTTCCAGTACA",0,2,0,0,0,2,183
"AGAACCTTCCGCGATG",1,4,3,0,2,10,109
"AGAACCTTCCTTTAGT",20,53,31,7,164,275,9793
"AGAACCTTCTCGCGTT",0,3,2,0,0,5,86
"AGAAGCGAGCGCTTCG",3,9,36,0,4,52,2103
"AGAAGCGCAATTTCGG",0,0,0,0,0,0,93
"AGAAGCGCAGACACCC",1,7,0,3,0,11,255
"AGAAGCGCAGCAGATG",1,8,2,0,3,14,474
"AGAAGCGGTAGCGCTC",121,971,323,63,214,1692,57736
"AGAAGCGGTCTTTCAT",7,109,24,3,21,164,6023
"AGAAGCGTCAGAGCGA",2,5,3,0,3,13,77
"AGAAGCGTCATCACAG",1,0,0,0,0,1,22
"AGAAGCGTCCACGTAA",0,2,0,0,0,2,75
"AGAAGCGTCGGAAACG",2,8,0,0,3,13,58
"AGAAGTAAGCGGTATG",2,10,3,0,0,15,241
"AGAAGTACAAGAGTAT",0,2,0,0,2,4,47
"AGAAGTAGTGATACCT",2,15,5,0,6,28,341
"AGAAGTAGTGTTGACT",8,32,62,4,17,123,4133
"AGAAGTAGTTTGTTCT",4,18,3,0,5,30,236
"AGAAGTATCGAAGAAT",7,53,8,3,6,77,2062
"AGACAAACACGACAGA",0,3,0,0,0,3,92
"AGACAAACAGCAGAAC",0,5,0,0,0,5,89
"AGACAAAGTAGATTAG",20,199,38,13,38,308,9944
"AGACAAAGTCGCTTGG",0,0,0,0,3,3,41
"AGACAAAGTGAATTAG",0,4,3,0,2,9,271
"AGACAAATCAAGCCTA",3,5,0,0,0,8,142
"AGACAAATCTAGTGTG",3,21,8,0,9,41,677
"AGACACTAGGACCCAA",5,5,0,0,0,10,95
"AGACACTCAACCTATG",5,27,22,4,2,60,2014
"AGACACTCAAGTATAG",10,21,7,2,10,50,854
"AGACACTCAGTTCTAG",0,2,0,0,0,2,11
"AGACACTCATCATTGG",0,0,0,0,0,0,26
"AGACACTTCGCGTTTC",0,13,6,0,2,21,290
"AGACACTTCTACAGGT",0,5,0,0,2,7,115
"AGACAGGAGGCGACAT",0,5,0,0,0,5,78
"AGACAGGAGGGTGAGG",0,19,4,0,2,25,322
"AGACAGGCAGTTCCAA",0,0,0,0,0,0,11
"AGACAGGCATCGGAAG",0,0,0,0,0,0,59
"AGACAGGGTAGGAGGG",0,2,0,0,2,4,114
"AGACAGGGTATCAGGG",0,3,0,0,0,3,77
"AGACAGGGTCAAATCC",2,11,3,0,0,16,216
"AGACAGGGTTGTTGTG",0,3,0,0,0,3,64
"AGACAGGTCATCGGGC",1,3,3,0,0,7,37
"AGACAGGTCCACGGGT",11,34,88,4,14,151,5045
"AGACAGGTCCTCTTTC",12,56,147,5,19,239,9227
"AGACAGGTCGCGCTGA",7,30,83,3,10,133,4515
"AGACAGGTCGTGGAAG",2,3,0,0,0,5,51
"AGACCATAGAGGCGTT",0,7,0,0,0,7,60
"AGACCATAGCTGTTCA",2,5,0,0,0,7,67
"AGACCATCATGTCAGT",1,0,0,0,0,1,6
"AGACCATGTCACCGCA",456,206,80,25,81,848,25091
"AGACCATGTCAGATTC",0,4,7,0,4,15,1004
"AGACCATGTTGGAGAC",1,0,0,0,0,1,63
"AGACCATTCAGAGTTC",2,16,6,0,3,27,598
"AGACCCGAGACGCAGT",2,38,5,0,6,51,1689
"AGACCCGCACGTAGAG",0,3,0,0,0,3,86
"AGACCCGCATACCGTA",12,31,8,0,8,59,1556
"AGACCCGTCCAAGGGA",5,68,10,5,9,97,4112
"AGACTCACAGAGTCTT",4,27,0,0,4,35,694
"AGACTCACATCTTTCA",0,0,0,0,0,0,155
"AGACTCACATTGGCAT",6,91,27,5,17,146,4512
"AGACTCAGTCGCCACA",1,0,0,0,2,3,57
"AGACTCAGTGCGTCGT",0,0,0,0,0,0,14
"AGACTCATCACTTTGT",0,2,2,0,0,4,29
"AGACTCATCATCTCTA",1,6,0,0,0,7,306
"AGACTCATCCGATCGG",0,3,2,0,0,5,25
"AGACTCATCTTCTGTA",0,2,0,0,0,2,91
"AGAGAATAGGCGTTAG",68,666,149,30,109,1022,37396
"AGAGAATCAAGAGCTG",0,0,0,0,0,0,39
"AGAGAATCACACCTAA",75,858,153,35,132,1253,45186
"AGAGAATCATGACACT",1,4,0,0,2,7,209
"AGAGAATGTGCCTGCA",65,398,73,20,72,628,22176
"AGAGAATGTTACAGCT",1,12,3,0,0,16,40
"AGAGAATTCCCATTCG",0,0,0,0,0,0,53
"AGAGAATTCGCGTAGC",1,18,7,0,3,29,754
"AGAGAGCAGCACTCCG",0,0,0,0,0,0,9
"AGAGAGCCACACCTTC",2,3,0,0,0,5,36
"AGAGAGCCATTAGGAA",2,22,5,0,0,29,704
"AGAGAGCTCAGTGCGC",18,26,9,0,8,61,856
"AGAGAGCTCCAAGCTA",1,11,0,2,0,14,286
"AGAGAGCTCGCAAGAG",105,170,40,11,35,361,8904
"AGAGAGCTCGCTAATG",3,3,0,2,0,8,133
"AGAGCAGAGTCGGCAA",1,2,0,0,0,3,19
"AGAGCAGCATTGTACG",3,17,2,0,4,26,537
"AGAGCAGGTTCTCTAT",1,18,4,0,6,29,371
"AGAGCAGTCTAAGAAG",2,25,5,14,7,53,1680
"AGAGCAGTCTAGGCCG",1,12,5,3,4,25,361
"AGAGCCCAGATTAGCA",0,3,0,0,0,3,133
"AGAGCCCAGCCTATTG",2,11,3,0,9,25,669
"AGAGCCCAGGATGCGT",0,0,0,0,0,0,38
"AGAGCCCAGTGCGTCC",4,11,0,0,2,17,283
"AGAGCCCCAATTGCGT",0,4,0,0,0,4,79
"AGAGCCCCACAGTCCG",2,9,5,0,3,19,356
"AGAGCCCCACTAGAGG",7,23,57,4,12,103,3539
"AGAGCCCCACTTGAGT",0,2,0,0,0,2,94
"AGAGCCCCAGAGGTTG",1,3,2,2,3,11,311
"AGAGCCCCAGGTGTTT",1,10,2,0,3,16,284
"AGAGCCCCATGCACTA",2,3,0,0,0,5,73
"AGAGCCCTCAAGGACG",1,15,7,0,6,29,503
"AGAGCCCTCGCAGAGA",3,11,3,0,5,22,492
"AGATAGAAGTGGAATT",5,26,13,2,45,91,3201
"AGATAGACAACGTAAA",2,16,6,0,0,24,617
"AGATAGACAGAAGCTG",5,34,50,0,13,102,3499
"AGATAGACAGCACACC",0,2,2,0,0,4,80
"AGATAGACAGCGAACA",0,6,0,0,0,6,70
"AGATAGACAGTTACCA",0,0,0,0,0,0,46
"AGATAGAGTAAGCAAT",0,4,0,0,0,4,57
"AGATAGAGTACCGTGC",0,2,0,0,0,2,31
"AGATAGAGTTGCTTGA",6,39,5,2,60,112,1792
"AGATAGATCAGTGATC",0,3,2,0,0,5,120
"AGATAGATCCCAACTC",1,0,0,0,0,1,5
"AGATAGATCGAGAGAC",1,8,0,0,2,11,82
"AGATAGATCGCCTATC",6,33,5,4,36,84,2643
"AGATAGATCGTGGGAA",0,4,0,0,0,4,36
"AGATAGATCTGAGGTT",15,82,105,5,103,310,12700
"AGATCCAAGAAGCGCT",0,3,0,0,2,5,109
"AGATCCAAGGACTGGT",2,14,8,0,4,28,393
"AGATCCAAGGCCGCTT",0,6,3,0,0,9,334
"AGATCCAAGTAGGATT",0,0,0,0,0,0,55
"AGATCCACAGGTAGTG",0,4,0,0,0,4,104
"AGATCCACATAGAGGC",0,4,0,0,2,6,103
"AGATCCAGTCGAATGG",142,228,49,12,41,472,15137
"AGATCCAGTGGATACG",35,319,67,12,122,555,20246
"AGATCCAGTTGCGGCT",84,76,20,3,14,197,5341
"AGATCCATCTTAGCAG",61,686,110,14,103,974,33682
"AGATCGTAGACCTTTG",2,25,5,3,10,45,1477
"AGATCGTAGGGTTAAT",2,4,2,0,0,8,66
"AGATCGTTCTCATGCC",3,11,0,0,2,16,327
"AGATGAAAGATGCGAC",0,2,0,0,0,2,3
"AGATGAAGTCAGGAGT",0,4,0,0,3,7,155
"AGATGAAGTCTGCGCA",16,60,148,9,23,256,10031
"AGATGAATCCTGGGTG",88,789,189,36,145,1247,41730
"AGATGAATCGACCATA",1,15,5,0,5,26,92
"AGATGAATCGAGAACG",0,3,2,0,0,5,389
"AGATGAATCTAGTCAG",0,6,5,0,4,15,186
"AGATGCTAGAGGGTGG",0,6,3,0,3,12,95
"AGATGCTAGCTCCGAC",0,0,0,0,0,0,26
"AGATGCTAGGATGCGT",0,3,0,0,0,3,73
"AGATGCTAGGTCACCC",6,34,22,2,95,159,5858
"AGATGCTAGTGGACTG",0,2,0,0,0,2,20
"AGATGCTCAACCCTAA",0,0,0,0,0,0,53
"AGATGCTCAATGGGTG",0,0,0,0,0,0,9
"AGATGCTCACAGTACT",12,120,49,4,22,207,7705
"AGATGCTCACGGCGTT",0,4,0,0,2,6,62
"AGATGCTCAGCTGTCG",1,3,0,0,3,7,117
"AGATGCTGTCATCTAG",0,6,4,0,2,12,185
"AGATGCTGTCGATTTG",18,57,102,12,118,307,6580
"AGATGCTGTGTACGCC",36,403,124,18,67,648,26919
"AGATGCTGTGTGGACA",0,5,0,0,0,5,304
"AGATGCTTCAATGTCG",0,6,0,0,3,9,326
"AGATGCTTCTACGCGG",0,0,0,0,0,0,164
"AGCATCAAGCTCTGTA",11,59,65,6,15,156,4724
"AGCATCAAGGCCTGAA",2,62,12,3,14,93,3315
"AGCATCACAAGAAACT",0,2,0,0,0,2,170
"AGCATCAGTACTGCCG",33,335,55,13,57,493,14833
"AGCATCAGTCATCACA",3,14,2,0,2,21,678
"AGCATCATCATTGCGA",2,12,15,0,7,36,422
"AGCCAATAGCCAACCC",0,2,0,0,0,2,103
"AGCCAATAGGACCCAA",0,5,0,0,0,5,106
"AGCCAATAGTACAGCG",1,3,0,0,0,4,49
"AGCCAATCAGCTGGTC",0,3,4,0,3,10,222
"AGCCAATGTAAGAACT",0,0,0,0,0,0,10
"AGCCAATGTACTGCCG",0,0,0,0,2,2,20
"AGCCAATTCAACACCA",0,2,0,0,0,2,65
"AGCCAATTCATTGTTC",0,2,0,0,0,2,72
"AGCCAATTCTACCAGA",0,7,2,0,0,9,148
"AGCCACGAGGTTGGAC",0,5,0,0,0,5,189
"AGCCACGCACTCACTC",3,38,6,0,8,55,675
"AGCCACGCAGACAAGC",1,10,5,2,10,28,286
"AGCCACGCATACGCAT",7,21,54,4,15,101,3042
"AGCCACGGTCGTATTG",5,6,0,0,0,11,322
"AGCCACGGTCTGATCA",0,3,0,0,0,3,83
"AGCCAGCAGACCGTTT",1,9,3,0,3,16,308
"AGCCAGCAGGCATCGA",3,5,0,0,0,8,60
"AGCCAGCAGGTCGCCT",5,26,5,3,5,44,1609
"AGCCAGCCAAACTCGT",2,11,2,0,6,21,277
"AGCCAGCCAATAGGAT",2,19,6,0,5,32,779
"AGCCAGCCACACCAGC",1,2,0,0,0,3,5
"AGCCAGCGTATCGGTT",0,2,0,0,0,2,48
"AGCCAGCTCACAGTGT",4,47,13,4,10,78,2137
"AGCCAGCTCTAGCAAC",4,14,3,0,3,24,531
"AGCCAGCTCTCACGAA",28,336,68,8,49,489,17234
"AGCGATTAGAAGCGGG",0,18,3,0,3,24,859
"AGCGATTAGATAGCAT",10,38,13,7,81,149,4949
"AGCGATTAGGGACAGG",3,32,61,2,10,108,3993
"AGCGATTAGTTGCATC",0,3,0,0,0,3,112
"AGCGATTCAAGCGATG",1,13,3,0,6,23,384
"AGCGATTCAGCATTGT",1,0,0,0,0,1,55
"AGCGATTTCAAATAGG",0,7,0,0,2,9,23
"AGCGATTTCCACATAG",3,13,0,0,0,16,270
"AGCGATTTCCGTATAG",0,3,0,0,3,6,139
"AGCGCCAAGACTCATC",2,19,2,0,2,25,436
"AGCGCCAAGAGAGTTT",0,5,0,0,4,9,81
"AGCGCCAAGCGTGAAC",0,0,0,0,0,0,39
"AGCGCCACAATAGGAT",3,12,4,0,0,19,312
"AGCGCCAGTCAATCTG",1,0,0,0,0,1,65
"AGCGCCAGTCATAAAG",0,0,0,0,0,0,31
"AGCGCCAGTGACAACG",27,85,65,10,255,442,14417
"AGCGCCAGTTGCTAGT",1,5,2,0,0,8,98
"AGCGCCATCCATGAGT",2,7,4,0,0,13,513
"AGCGCCATCCTGTTAT",7,33,22,2,60,124,4558
"AGCGCTGAGAACCCGA",7,22,35,4,15,83,2960
"AGCGCTGAGGGCGAGA",0,19,4,0,3,26,268
"AGCGCTGAGTTCACTG",1,0,0,0,0,1,75
"AGCGCTGCACGTCGTG",0,0,0,0,0,0,0
"AGCGCTGCATTGGGAG",2,11,0,0,3,16,141
"AGCGCTGGTTACGATC",0,9,4,0,2,15,42
"AGCGCTGTCTCCCTAG",2,6,3,0,3,14,348
"AGCGCTGTCTGAATGC",1,5,0,0,4,10,343
"AGCGCTGTCTTGTTAC",51,284,175,19,307,836,30532
"AGCGTATAGGGTAGCT",3,9,5,0,0,17,503
"AGCGTATCATAATCGC",3,12,5,0,6,26,232
"AGCGTATCATGGAAGC",7,25,59,4,16,111,3071
"AGCGTATGTCTTCCGT",1,5,5,0,2,13,360
"AGCGTATTCGTTCGCT",1,3,2,0,0,6,61
"AGCGTATTCTATGTGG",11,47,97,4,23,182,7506
"AGCGTCGCAAGCAATA",0,0,0,0,0,0,7
"AGCGTCGCAGGCACTC",0,2,0,0,0,2,51
"AGCGTCGGTTGGAGGT",0,0,0,0,0,0,2
"AGCTACACAAGTCGTT",0,0,0,0,0,0,35
"AGCTACAGTACCGCGT",0,4,0,0,0,4,26
"AGCTACAGTCGATTTG",0,2,0,0,0,2,35
"AGCTACAGTCTGATAC",0,2,0,0,0,2,151
"AGCTACAGTGCTAGCC",0,5,0,0,2,7,348
"AGCTACAGTTGTTTGG",1,5,3,0,4,13,211
"AGCTACATCAGCTGTA",4,20,7,2,50,83,3095
"AGCTACATCGAACCTA",21,14,8,3,4,50,1106
"AGCTACATCTGCGGGT",1,10,2,0,3,16,510
"AGCTCAAAGCAACAGC",1,12,2,0,3,18,439
"AGCTCAAAGTATGAAC",2,18,15,0,7,42,1323
"AGCTCAACAAATGGTA",2,17,5,0,2,26,211
"AGCTCAACACACGCCA",0,5,0,0,0,5,213
"AGCTCAACAGATGCGA",8,27,96,5,14,150,5852
"AGCTCAAGTGACCGTC",9,47,146,6,62,270,8738
"AGCTCAAGTTAAGACA",1,4,0,0,0,5,73
"AGCTCAATCCTTCGAC",0,4,2,0,2,8,121
"AGCTTCCAGAAACCCG",0,4,0,0,0,4,140
"AGCTTCCCATACCACA",0,3,0,0,3,6,151
"AGCTTCCCATCGATCA",0,6,0,0,2,8,196
"AGCTTCCCATTGAGCT",0,11,2,0,4,17,264
"AGCTTCCTCTCCCATG",0,0,0,0,0,0,34
"AGGAAATAGAATGTTG",3,18,3,0,4,28,535
"AGGAAATAGATAGCAT",2,7,2,0,0,11,129
"AGGAAATAGGATATAC",0,18,3,3,3,27,347
"AGGAAATAGGTAAGAG",0,3,0,0,0,3,12
"AGGAAATAGTCACTCA",3,8,3,0,7,21,245
"AGGAAATGTGGATACG",0,5,2,0,0,7,76
"AGGAAATGTGTTGATC",0,0,0,0,0,0,1
"AGGAAATGTTGACTGT",1,4,0,0,0,5,103
"AGGAAATGTTTGGCTA",0,2,0,0,2,4,51
"AGGAAATTCCACGTCT",0,3,2,0,2,7,62
"AGGAAATTCGGAGCAA",6,27,29,2,35,99,2826
"AGGAATAGTCTGCATA",151,77,37,11,36,312,7831
"AGGAATAGTTTCCAAG",12,57,48,4,152,273,7664
"AGGAATATCGTAGCCG",1,13,2,0,4,20,284
"AGGACGACACAAGGTG",8,32,82,6,21,149,5321
"AGGACGACACGTCGTG",17,188,22,0,27,254,5490
"AGGACGACAGCTTTCC",0,2,0,0,4,6,74
"AGGACGAGTACTGACT",3,15,8,0,26,52,1308
"AGGACGAGTAGGTACG",1,3,2,0,0,6,127
"AGGACGAGTGTTCCAA",27,87,47,297,48,506,13460
"AGGACGAGTTCCTAAG",20,55,172,6,31,284,12252
"AGGACGAGTTTGAAAG",5,62,7,0,9,83,2884
"AGGACGATCTTCCCGA",12,46,124,5,23,210,6080
"AGGACGATCTTGAGCA",14,155,26,11,20,226,7686
"AGGACTTAGCTACGTT",1,6,0,0,0,7,62
"AGGACTTAGTAGACCG",0,0,0,0,0,0,14
"AGGACTTCAAGACCTT",0,6,0,0,2,8,75
"AGGACTTCATAGCACT",1,0,2,0,2,5,125
"AGGACTTTCAAGTCGT",43,182,211,24,500,960,20916
"AGGACTTTCGGCCCAA",0,0,0,0,0,0,99
"AGGACTTTCTCTGCTG",3,14,5,0,2,24,409
"AGGACTTTCTGAGATC",0,2,0,0,0,2,55
"AGGAGGTAGCAATTCC",0,4,4,0,2,10,34
"AGGAGGTAGCAGGCAT",1,4,0,0,0,5,138
"AGGAGGTCACACGGAA",1,15,4,0,0,20,340
"AGGAGGTGTATCGCTA",2,29,5,0,5,41,876
"AGGAGGTGTCCAAGAG",1,23,2,0,3,29,1339
"AGGAGGTGTGACATCT",0,6,0,0,0,6,101
"AGGAGGTGTGGTCCCA",1,0,0,0,0,1,54
"AGGAGGTGTTTGAAAG",0,3,2,0,0,5,81
"AGGAGGTTCCGCACTT",1,14,2,0,6,23,53
"AGGAGGTTCTTCCGTG",0,0,0,0,0,0,3
"AGGATAAAGAGCTGCA",2,11,0,0,6,19,76
"AGGATAAAGATGCAGC",410,156,82,19,68,735,21786
"AGGATAAAGGGATCAC",0,11,6,0,2,19,368
"AGGATAAAGGGATGTC",3,18,17,0,2,40,767
"AGGATAAAGGTTATAG",1,3,3,0,0,7,42
"AGGATAACACTGTCGG",0,14,4,0,0,18,310
"AGGATAACAGCGTATT",0,5,0,0,0,5,9
"AGGATAAGTCACTGAT",29,298,81,13,47,468,19253
"AGGATAAGTCATCCGG",6,25,10,2,41,84,3001
"AGGATAAGTTAGCGGA",10,13,7,0,3,33,789
"AGGATAATCTTCGACC",0,0,2,0,2,4,165
"AGGATCTAGATAGCAT",0,3,0,0,0,3,89
"AGGATCTAGTATGACA",0,6,0,0,2,8,321
"AGGATCTAGTCGTCTA",0,4,0,0,0,4,73
"AGGATCTAGTGCAACG",1,0,0,0,0,1,45
"AGGATCTCACAAGTGG",1,0,0,0,0,1,88
"AGGATCTCACGTACTA",13,45,109,10,23,200,6901
"AGGATCTCACTCTAGA",2,24,2,0,4,32,946
"AGGATCTCAGTAGAAT",0,2,0,0,0,2,43
"AGGATCTTCATAGAGA",0,3,0,0,0,3,93
"AGGATCTTCATGTCAG",0,0,0,0,0,0,116
"AGGATCTTCTTCCCAG",0,2,0,0,0,2,38
"AGGCATTAGGCCTTGC",16,96,19,3,21,155,5262
"AGGCATTAGTAAACGT",1,12,6,0,5,24,372
"AGGCATTCAAAGAACT",0,3,4,0,0,7,49
"AGGCATTCATTCTCCG",0,4,0,0,2,6,111
"AGGCATTTCATTCTTG",1,6,0,0,0,7,99
"AGGCATTTCCAATCTT",32,175,71,17,264,559,15007
"AGGCCACAGTTGGCTT",1,6,0,0,2,9,103
"AGGCCACCAGCTGAGA",0,0,0,0,0,0,7
"AGGCCACGTCGCGTCA",2,14,0,0,3,19,161
"AGGCCACGTTATCTGG",0,6,2,0,0,8,175
"AGGCCACGTTCCTTGC",0,0,0,0,0,0,149
"AGGCCACTCCCTCGAT",0,0,0,0,0,0,82
"AGGCCACTCGATTGAC",2,18,14,0,3,37,901
"AGGCCACTCTGAACGT",1,2,0,0,0,3,15
"AGGCTGCAGAGGGCGA",16,18,7,0,4,45,753
"AGGCTGCCAAAGCAAT",1,8,0,0,0,9,563
"AGGCTGCCAATACCTG",0,0,0,0,3,3,124
"AGGCTGCGTAAGTCAA",17,208,40,8,29,302,11740
"AGGCTGCGTGATCGTT",2,14,3,0,3,22,377
"AGGCTGCGTTAACCTG",53,206,65,13,39,376,11605
"AGGCTGCTCACCATCC",72,34,16,4,12,138,2746
"AGGCTGCTCGAGATAA",0,2,0,0,0,2,93
"AGGCTGCTCGGTCACG",4,52,10,2,7,75,2295
"AGGCTGCTCGTGAGAG",4,14,11,0,4,33,601
"AGGCTGCTCTGAGAGG",9,10,6,0,5,30,479
"AGGCTGCTCTTGCGCT",6,50,18,3,93,170,5537
"AGGGAGTAGCTTACGT",0,8,0,0,0,8,506
"AGGGAGTAGGTATCTC",0,5,2,0,0,7,70
"AGGGAGTTCGCAGTCG",0,2,0,0,0,2,99
"AGGGAGTTCTATTGTC",23,82,136,9,95,345,11190
"AGGGAGTTCTTACTGT",1,2,0,0,0,3,66
"AGGGCCTAGAAGCCTG",0,7,3,0,0,10,50
"AGGGCCTAGCGGATCA",0,0,0,0,0,0,1
"AGGGCCTAGCGGCTCT",1,5,3,0,2,11,57
"AGGGCCTCAGAGTGTG",0,2,0,0,0,2,81
"AGGGCCTCAGCTTCGG",0,3,0,0,0,3,66
"AGGGCCTGTATTAAGG",0,0,0,0,0,0,6
"AGGGCCTGTCTCGCGA",4,15,3,0,5,27,689
"AGGGCCTGTCTTTATC",0,4,0,0,0,4,149
"AGGGCCTGTGCACAAG",2,8,2,0,2,14,258
"AGGGCCTGTGCCTACG",0,2,0,0,0,2,67
"AGGGCCTGTTCTGACA",0,2,0,0,0,2,60
"AGGGCCTTCATAGACC",0,3,0,0,0,3,29
"AGGGCCTTCATTGTTC",0,4,0,0,2,6,106
"AGGGCCTTCTATACTC",3,10,2,4,3,22,377
"AGGGCCTTCTTAGCTT",1,0,0,0,0,1,96
"AGGGCTCAGTGATAAC",1,5,2,0,3,11,255
"AGGGCTCCAAGACCTT",0,2,2,0,0,4,40
"AGGGCTCCACAAATCC",1,4,0,0,0,5,77
"AGGGCTCCATCATTGG",1,3,0,0,0,4,84
"AGGGCTCCATCTAGAC",3,0,0,0,0,3,130
"AGGGCTCGTACCCAGC",0,14,3,2,3,22,389
"AGGGCTCGTCGTATTG",0,0,0,0,0,0,11
"AGGGCTCGTTAGGCTT",0,4,2,0,0,6,80
"AGGGCTCTCTACCAGA",11,70,12,2,18,113,3340
"AGGGTCCCATCTCAAG",0,2,0,0,0,2,58
"AGGGTCCCATTGGGAG",1,4,2,0,0,7,92
"AGGGTCCGTCGCAGTC",1,0,0,0,0,1,73
"AGGGTCCGTCTTACAG",0,4,0,0,0,4,71
"AGGGTCCGTGCATCTA",0,0,0,0,0,0,78
"AGGGTCCTCCCTCTCC",28,318,51,10,57,464,9736
"AGGGTGAAGCGTTACT",4,16,11,0,15,46,1743
"AGGGTGAAGGATATGT",0,2,0,0,0,2,28
"AGGGTGAAGGTAACTA",1,3,0,0,0,4,21
"AGGGTGAAGGTTCATC",0,0,0,0,0,0,39
"AGGGTGAAGTAAGAGG",0,3,0,0,0,3,91
"AGGGTGAAGTAGTGCG",0,10,0,0,0,10,206
"AGGGTGACAACTACGT",3,31,13,4,39,90,2999
"AGGGTGATCACAAGGG",1,10,4,0,3,18,297
"AGGGTGATCGTCAGAT",0,3,0,0,0,3,74
"AGGGTTTAGAACGTGC",2,14,2,0,2,20,300
"AGGGTTTAGATTGTGA",0,0,0,0,0,0,11
"AGGGTTTAGTTCACTG",0,3,2,0,2,7,95
"AGGGTTTCACGTCTCT",0,0,0,0,0,0,40
"AGGGTTTGTCGTCAGC",1,10,2,0,2,15,385
"AGGGTTTGTGTTAGCT",47,304,106,18,68,543,19823
"AGGGTTTTCACCCATC",4,20,8,2,5,39,501
"AGGGTTTTCCGTCAAA",0,0,0,0,0,0,3
"AGGGTTTTCGTAGGAG",35,16,13,2,6,72,2608
"AGGTAGGAGCATTTCG",20,63,29,29,125,266,9647
"AGGTAGGAGCCGAATG",0,2,0,0,0,2,9
"AGGTAGGAGCCGTAAG",0,13,4,0,0,17,336
"AGGTAGGCAAACTCGT",12,39,47,3,67,168,6119
"AGGTAGGTCAAGCTGT",0,0,0,0,0,0,68
"AGGTAGGTCGTTATCT",32,101,315,13,51,512,19311
"AGGTAGGTCGTTCTGC",24,71,70,9,161,335,10571
"AGGTCATAGCTGACTT",1,2,2,0,0,5,224
"AGGTCATCAAAGAGTT",2,3,4,0,0,9,152
"AGGTCATCATGGCGCT",199,95,40,10,42,386,12408
"AGGTCATGTCACTGAT",2,25,6,2,9,44,1250
"AGGTCATGTCCAGCGT",2,32,100,2,20,156,5849
"AGGTCATGTTTCGTTT",1,4,0,0,2,7,92
"AGGTCATTCATTCATC",14,172,26,8,29,249,9744
"AGGTCATTCTTACGGA",2,2,0,0,4,8,91
"AGGTCTAAGCGATGAC",62,1043,182,26,117,1430,46153
"AGGTCTAAGGAAAGGT",0,4,4,0,0,8,106
"AGGTCTAAGGAGCTGT",0,2,0,0,0,2,41
"AGGTCTAGTATGGTAA",4,14,3,0,6,27,556
"AGGTCTATCCATTGCC",2,0,0,2,0,4,90
"AGGTCTATCGGATAAA",3,13,3,0,4,23,269
"AGGTGTTAGACTTCGT",0,0,0,0,0,0,23
"AGGTGTTAGGGACAGG",2,12,6,0,3,23,360
"AGGTGTTAGTCCTGCG",1,13,2,0,3,19,223
"AGGTGTTCATTGCTTT",0,11,2,0,2,15,330
"AGGTGTTGTCTAGGTT",3,5,0,0,0,8,118
"AGGTGTTTCCCAGTGG",32,19,8,4,4,67,2419
"AGGTGTTTCCCTGTTG",0,0,0,0,0,0,23
"AGGTGTTTCGTTAGTG",2,11,2,0,6,21,308
"AGGTGTTTCTCGCGTT",3,6,0,2,5,16,452
"AGGTTACAGAGCCGAT",1,7,2,0,2,12,215
"AGGTTACAGCTAGTTC",0,2,0,0,2,4,54
"AGGTTACCATCGCCTT",0,3,0,0,0,3,79
"AGGTTACCATGAATAG",0,4,0,0,2,6,179
"AGGTTACGTGGCTACC",12,114,22,5,21,174,5839
"AGGTTACTCCCGAATA",0,0,0,0,2,2,25
"AGGTTACTCCCGAGTG",4,17,6,2,8,37,406
"AGGTTGTCAATGGCAG",0,4,0,0,0,4,38
"AGGTTGTCACAGAGAC",1,9,0,0,2,12,336
"AGGTTGTCACTTGTCC",1,17,0,0,4,22,387
"AGGTTGTCAGTTGAAA",3,0,0,0,0,3,51
"AGGTTGTCATAGGCGA",8,111,23,0,18,160,5942
"AGGTTGTGTGTTTACG",8,35,48,0,47,138,4895
"AGTAACCAGACATATG",2,8,2,0,0,12,122
"AGTAACCAGCTTAAGA",0,0,0,0,0,0,3
"AGTAACCAGGAGGCAG",1,3,0,0,0,4,33
"AGTAACCAGTGTTGTC",1,10,0,0,0,11,302
"AGTAACCCAGACACCC",0,2,0,0,0,2,133
"AGTAACCCAGGAGACT",1,2,7,0,0,10,596
"AGTAACCGTCAGACTT",0,0,0,0,0,0,85
"AGTAACCTCCAGTGCG",0,0,0,0,0,0,48
"AGTAACCTCCCATAAG",1,0,0,0,0,1,8
"AGTAACCTCGTAGAGG",4,27,7,0,5,43,375
"AGTAACCTCTGATGGT",13,174,21,3,17,228,9854
"AGTACCAAGATAACGT",0,12,4,0,0,16,137
"AGTACCAAGCCGGATA",0,0,0,0,0,0,2
"AGTACCAAGTTTAGGA",5,12,10,0,4,31,139
"AGTACCACAACGACTT",64,688,179,35,105,1071,42872
"AGTACCACATATGAAG",1,4,0,0,0,5,129
"AGTACCACATTCTCTA",0,0,2,0,2,4,150
"AGTACCAGTAATGCTC",0,3,3,2,3,11,79
"AGTACCAGTAGGTCAG",0,0,0,0,0,0,101
"AGTACCAGTGGCAACA",8,109,37,6,19,179,5793
"AGTACCATCAGCTGTA",1,0,2,0,0,3,71
"AGTACCATCCCAGGAC",0,0,0,0,2,2,117
"AGTACCATCGTAACCA",25,72,187,12,59,355,12304
"AGTACCATCTCATTGT",2,17,6,0,6,31,448
"AGTACTGAGTATAGGT",0,22,6,0,6,34,669
"AGTACTGCACCAGCCA",1,3,2,0,0,6,80
"AGTACTGGTTATTCCT",1,4,3,0,7,15,508
"AGTACTGTCGAACGCC",3,16,2,0,7,28,712
"AGTAGCTAGATCGACG",1,0,2,0,0,3,93
"AGTAGCTAGCGTGAGT",2,4,0,0,0,6,119
"AGTAGCTAGGATATGT",2,28,10,0,5,45,805
"AGTAGCTGTTCTTCAT",2,15,8,0,6,31,579
"AGTAGCTTCCCTCAAC",0,0,0,0,0,0,128
"AGTAGCTTCGACACTA",0,2,2,0,3,7,104
"AGTAGCTTCGTTAGAC",0,3,3,0,2,8,37
"AGTAGTCAGAAGCGAA",1,6,0,0,2,9,95
"AGTAGTCAGCCTAGGA",0,2,0,0,0,2,55
"AGTAGTCAGCTAATGA",0,2,3,0,0,5,47
"AGTAGTCAGTAGTCAA",1,21,2,0,5,29,583
"AGTAGTCAGTCCTACA",0,6,0,0,0,6,53
"AGTAGTCAGTCTCTGA",13,74,207,12,43,349,13108
"AGTAGTCAGTGTTGAA",8,46,68,5,17,144,5131
"AGTAGTCCACCCTTGT",0,0,0,0,0,0,12
"AGTAGTCCACTTCATT",1,4,0,0,0,5,78
"AGTAGTCCAGTCCCGA",0,0,0,0,2,2,112
"AGTAGTCGTGTGAATA",1,8,0,0,0,9,91
"AGTAGTCGTTACACTG",41,92,23,8,23,187,5383
"AGTAGTCTCCGTTTCG",0,0,0,0,0,0,66
"AGTAGTCTCGAAACAA",4,17,5,0,13,39,887
"AGTAGTCTCGACGCTG",0,5,4,0,0,9,213
"AGTAGTCTCGCCGAAC",0,5,2,0,6,13,412
"AGTCAACCAAGAATAC",2,13,6,0,4,25,343
"AGTCAACCACTTTAGG",28,314,68,10,88,508,16773
"AGTCAACGTTGCATTG",0,0,0,0,0,0,14
"AGTCAACGTTGTTGCA",1,14,5,0,2,22,614
"AGTCAACTCACATACG",0,4,0,0,2,6,26
"AGTCAACTCATCGCCT",1,0,0,0,0,1,15
"AGTCAACTCCTAAGTG",6,10,2,0,2,20,103
"AGTCAACTCCTGTACC",13,36,22,5,58,134,3659
"AGTCACAAGAAGTATC",0,0,0,0,0,0,22
"AGTCACACAGTACTAC",0,4,0,0,0,4,69
"AGTCACACATTGTACG",0,0,0,0,0,0,53
"AGTCACAGTGACAGCA",2,16,20,0,5,43,1756
"AGTCACATCGCGATCG",0,10,13,0,0,23,857
"AGTCACATCGCTTGCT",0,0,0,0,0,0,65
"AGTCATGAGCTAAGTA",0,0,4,0,0,4,62
"AGTCATGAGGACTATA",20,16,10,0,3,49,1458
"AGTCATGAGGGTCAAC",1,25,5,0,8,39,554
"AGTCATGCAAACGTGG",3,16,9,0,9,37,397
"AGTCATGCACACTTAG",1,0,0,0,0,1,8
"AGTCATGGTGCTTATG",0,0,0,0,0,0,27
"AGTCATGGTTCTTGTT",1,23,3,0,3,30,366
"AGTCATGTCCACAGGC",2,9,2,0,3,16,301
"AGTCATGTCTGTCGTC",0,10,0,0,0,10,436
"AGTCTCCAGACAAGCC",0,2,3,0,0,5,172
"AGTCTCCAGCAACCAG",0,4,0,0,0,4,6
"AGTCTCCAGTGATCGG",1,3,0,0,0,4,165
"AGTCTCCCATCAGTGT",4,13,5,0,7,29,556
"AGTCTCCGTAATACCC",0,4,2,0,0,6,27
"AGTCTCCGTACTAGCT",21,82,169,4,37,313,9728
"AGTCTCCGTCTCTCCA",1,17,3,0,8,29,453
"AGTCTCCGTTAGAAGT",0,8,2,0,0,10,54
"AGTCTCCTCCAACCGG",1,11,0,0,4,16,35
"AGTCTCCTCGTGGTAT",1,3,4,0,0,8,97
"AGTCTCCTCTCGGTCT",1,11,2,0,0,14,242
"AGTGACTAGCACTCTA",0,5,0,0,0,5,114
"AGTGACTCAATACCCA",0,2,2,0,0,4,63
"AGTGACTCACATGACT",0,0,0,0,0,0,94
"AGTGACTCAGCTATAC",0,0,0,0,0,0,34
"AGTGACTGTCAGCTTA",0,6,2,0,3,11,108
"AGTGACTGTTGTGCCG",0,4,0,0,0,4,93
"AGTGACTTCAGAACCT",2,16,5,0,8,31,304
"AGTGACTTCGCAGAGA",1,13,12,0,4,30,642
"AGTGATCAGATGCAGC",0,4,0,0,0,4,95
"AGTGATCCAATGTTGC",47,190,65,4,38,344,11857
"AGTGATCCACCTTCGT",11,103,17,6,15,152,3190
"AGTGATCCACTCATAG",0,8,0,0,0,8,112
"AGTGATCTCTGCTCTG",0,0,0,0,0,0,14
"AGTGCCGAGAACAAGG",1,0,0,0,0,1,14
"AGTGCCGAGCTGCGAA",0,0,3,0,0,3,120
"AGTGCCGAGGATATAC",1,2,0,0,0,3,62
"AGTGCCGAGGTGCGAT",52,551,219,26,112,960,37548
"AGTGCCGAGGTGCTAG",0,2,0,0,0,2,91
"AGTGCCGCACAGTCCG",0,7,3,0,3,13,419
"AGTGCCGCAGAGGACT",23,81,259,15,38,416,16099
"AGTGCCGCATGAGTAA",1,12,0,0,2,15,26
"AGTGCCGTCAAACCCA",0,4,0,0,0,4,76
"AGTGCCGTCAACCTTT",0,0,2,0,0,2,65
"AGTGCCGTCCCGAATA",0,0,0,0,0,0,21
"AGTGTTGAGACCAACG",1,7,0,0,0,8,240
"AGTGTTGCAAAGGGCT",1,3,3,0,0,7,124
"AGTGTTGCAATGAACA",0,3,0,0,0,3,65
"AGTGTTGCACTGCATA",0,4,0,0,0,4,26
"AGTGTTGCACTGTGTA",0,5,0,0,0,5,52
"AGTGTTGCATGCAGGA",0,4,0,0,0,4,115
"AGTGTTGGTAGGCTGA",6,13,6,2,22,49,1502
"AGTGTTGGTTAAACCC",0,4,6,0,4,14,322
"AGTGTTGGTTAAGTCC",0,16,5,0,4,25,242
"AGTGTTGTCAGCCCAG",0,3,0,0,0,3,30
"AGTGTTGTCGGCCTTT",1,9,3,0,2,15,283
"AGTTAGCAGCATTGTC",3,9,3,2,6,23,380
"AGTTAGCAGTTGGGAC",0,4,0,0,0,4,68
"AGTTAGCGTCACTTCC",141,350,74,27,61,653,15457
"AGTTAGCTCTGTCCCA",1,15,14,0,8,38,1429
"AGTTCCCAGCGCGTTC",0,6,3,0,3,12,368
"AGTTCCCAGCTTCATG",1,5,0,0,0,6,101
"AGTTCCCAGGTATAGT",18,60,137,8,23,246,9274
"AGTTCCCAGTGATCGG",56,539,138,26,96,855,27736
"AGTTCCCCAGCATTGT",55,28,15,3,16,117,2675
"AGTTCCCCATACAGGG",0,4,3,0,0,7,95
"AGTTCCCGTCCGGACT",18,184,31,8,27,268,10806
"AGTTCCCGTTCAACGT",2,3,0,0,0,5,42
"AGTTCCCTCTTCGATT",0,5,0,0,0,5,97
"AGTTCGAAGACCAGCA",0,2,0,0,0,2,364
"AGTTCGACACACCGCA",2,5,0,0,0,7,77
"AGTTCGACAGCTCATA",1,4,0,0,0,5,69
"AGTTCGACAGGAATAT",3,22,5,0,7,37,360
"AGTTCGACATGTGGTT",0,0,0,0,0,0,10
"AGTTCGAGTAGGACCA",0,10,0,0,0,10,38
"AGTTCGAGTATCTTCT",0,2,0,0,0,2,27
"AGTTCGAGTGCACATT",0,2,0,0,2,4,119
"AGTTCGAGTTACAGCT",0,3,0,0,0,3,106
"AGTTCGATCACAGTGT",3,27,10,3,7,50,1020
"AGTTCGATCTTCTCAA",2,2,0,0,0,4,20
"ATACCGAAGAGGACTC",0,3,2,0,0,5,28
"ATACCGAAGATGAAGG",1,5,0,0,0,6,54
"ATACCGAAGCAGTCTT",1,0,0,0,0,1,77
"ATACCGAAGGCCACCT",7,52,7,0,8,74,2074
"ATACCGAAGTTTGGCT",76,165,72,89,43,445,12587
"ATACCGACAAATGAAC",0,17,3,2,4,26,737
"ATACCGACACGACGAA",0,4,0,0,2,6,119
"ATACCGAGTCCTCCAT",0,0,0,0,0,0,23
"ATACCGATCAAGCGTT",1,2,0,0,2,5,13
"ATACCGATCATCAGTG",0,0,0,2,0,2,153
"ATACCGATCGCTGACG",0,5,0,0,0,5,95
"ATACCGATCTCATGCC",128,1093,240,47,195,1703,60288
"ATACCGATCTTTACAC",2,9,0,0,0,11,148
"ATACCTTAGCATGAAT",0,8,0,0,0,8,249
"ATACCTTAGGTTCTAC",15,52,29,3,12,111,3988
"ATACCTTCACAGTACT",1,4,0,0,0,5,100
"ATACCTTCACCAGTTA",2,15,5,3,7,32,766
"ATACCTTCAGGCCTGT",0,2,2,0,0,4,11
"ATACCTTCATCAGTCA",0,0,0,0,0,0,2
"ATACCTTGTATAGGGC",0,3,0,0,2,5,52
"ATACCTTGTGTTAAAG",30,246,109,7,37,429,17734
"ATACCTTTCGACCAAT",4,16,4,0,3,27,497
"ATACCTTTCGAGTTGT",0,2,0,0,0,2,106
"ATACCTTTCGCTTTAT",1,10,0,0,0,11,170
"ATACTTCAGAGTCTGG",0,3,0,0,0,3,90
"ATACTTCAGGACCCAA",0,0,0,3,0,3,7
"ATACTTCGTCGCTGCA",0,2,0,0,0,2,46
"ATACTTCGTTTAGTCG",13,38,84,8,19,162,5047
"ATACTTCTCCCATGGG",1,4,0,0,3,8,32
"ATAGACCAGGTTCACT",0,0,0,0,0,0,73
"ATAGACCCAAGACGAC",2,19,4,0,3,28,787
"ATAGACCCACTAGTAC",19,63,134,11,29,256,9513
"ATAGACCGTAAGTTAG",1,3,0,0,0,4,35
"ATAGACCGTATACCCA",1,0,0,0,0,1,2
"ATAGACCTCAATCAGC",0,2,0,0,0,2,91
"ATAGACCTCTACCAGA",2,52,9,2,7,72,1884
"ATAGACCTCTTGGCTC",0,5,0,0,3,8,80
"ATAGAGAAGAGCAGAA",3,9,4,0,2,18,424
"ATAGAGAAGCGTATGG",0,2,0,0,0,2,69
"ATAGAGACAAAGCTCT",1,10,2,0,2,15,245
"ATAGAGACAAGCAGGT",15,53,33,130,21,252,9159
"ATAGAGACATGCGTGC",1,2,0,0,0,3,74
"ATAGAGAGTACCATAC",0,5,3,0,3,11,115
"ATAGAGAGTCGTGGTC",2,6,2,0,0,10,17
"ATAGAGATCATAGACC",1,25,5,0,7,38,303
"ATAGAGATCTCATTAC",0,0,0,0,0,0,4
"ATAGGCTCAACCGATT",0,0,0,0,0,0,65
"ATAGGCTCACTGAGTT",21,139,28,7,24,219,6507
"ATAGGCTGTGTAACGG",0,3,0,0,0,3,79
"ATAGGCTGTTAGAAGT",3,12,4,2,3,24,287
"ATAGGCTTCCCGAGAC",0,0,0,0,0,0,10
"ATAGGCTTCGGAAGGT",0,0,0,0,0,0,63
"ATATCCTAGCGTCTGC",2,13,4,0,3,22,320
"ATATCCTCACGCGTGT",0,4,0,0,0,4,44
"ATATCCTCACTGCTTC",0,4,0,0,0,4,57
"ATATCCTCATTCAGCA",1,2,0,0,0,3,132
"ATATCCTCATTCCTCG",0,0,0,0,0,0,51
"ATATCCTGTATTCTCT",3,13,5,0,4,25,80
"ATATCCTGTGGCTCTG",1,14,5,0,4,24,417
"ATCACAGAGATGTTCC",8,35,88,4,12,147,4977
"ATCACAGAGTCATGGG",3,15,3,2,8,31,632
"ATCACAGAGTTCAACC",2,14,14,0,5,35,1011
"ATCACAGCAAAGCACG",0,0,0,0,0,0,22
"ATCACAGCATGGGTTT",0,0,0,0,0,0,6
"ATCACAGGTGCATCTA",0,3,0,0,0,3,52
"ATCACAGTCCTACGGG",0,12,4,0,5,21,783
"ATCACGAAGCAGGGAG",21,191,38,15,35,300,7701
"ATCACGACACAGCGCT",159,61,26,9,21,276,7863
"ATCACGACACATAGCT",0,2,0,0,2,4,47
"ATCACGACAGAACGCA",0,0,0,0,0,0,43
"ATCACGAGTAGGAAAG",1,4,2,0,0,7,79
"ATCACGAGTGGCTTGC",0,0,0,0,0,0,3
"ATCACGATCGACGCGT",0,2,0,0,0,2,37
"ATCACGATCGGTAGGA",3,18,3,0,4,28,572
"ATCACGATCTGCTCTG",0,2,0,0,0,2,59
"ATCACTTAGGCCCGTT",11,47,48,5,94,205,8237
"ATCACTTGTCACCACG",1,12,5,0,0,18,491
"ATCACTTGTGGAACCA",2,3,0,0,0,5,259
"ATCACTTGTTGTGCCG",133,246,47,13,54,493,14317
"ATCACTTTCACTGCTC",9,66,13,36,16,140,4981
"ATCACTTTCTTCGGAA",4,21,14,0,5,44,543
"ATCAGGTAGCGACTGA",2,18,2,0,2,24,362
"ATCAGGTAGTCGAGGT",0,0,0,0,0,0,76
"ATCAGGTAGTGCTAGG",5,33,9,0,9,56,1606
"ATCAGGTCAAGCTGCC",0,0,0,0,0,0,40
"ATCAGGTCACAGCCAC",13,55,151,5,25,249,8587
"ATCAGGTGTCCTCATC",1,0,0,0,0,1,9
"ATCAGGTGTGACCGAA",0,0,0,0,0,0,100
"ATCAGGTGTGCATGTT",0,16,5,0,4,25,409
"ATCAGGTTCGTAGTCA",3,11,0,0,3,17,411
"ATCAGGTTCTATCCAT",2,8,4,0,2,16,48
"ATCATTCAGCCATGCC",0,2,0,0,2,4,114
"ATCATTCCAACTCGAT",1,0,2,0,0,3,101
"ATCATTCCAGAGTTGG",4,30,7,3,5,49,1014
"ATCATTCCAGTTTCAG",3,12,3,0,0,18,363
"ATCATTCCATTCTGTT",0,3,2,0,0,5,87
"ATCATTCGTGACATCT",1,2,0,0,0,3,69
"ATCATTCGTTCGTACA",1,4,0,0,0,5,432
"ATCATTCTCAACCTTT",0,0,0,0,0,0,3
"ATCATTCTCATCTCTA",0,9,2,0,2,13,329
"ATCATTCTCCTTTGAT",0,2,2,0,0,4,202
"ATCATTCTCGAGCACC",0,4,0,0,0,4,42
"ATCATTCTCGGCAGTC",2,8,0,0,0,10,80
"ATCATTCTCGGTGCAC",1,4,0,0,0,5,131
"ATCATTCTCGTAGTCA",4,34,9,4,38,89,2662
"ATCATTCTCTCTCCGA",1,3,0,0,4,8,120
"ATCATTCTCTTGCGCT",20,98,54,6,214,392,13568
"ATCCACCAGACTCGAG",0,0,0,0,0,0,6
"ATCCACCCAGAGATGC",0,4,3,0,0,7,166
"ATCCACCCAGGCCTGT",6,94,13,5,9,127,5699
"ATCCACCGTATGACAA",1,0,0,0,0,1,140
"ATCCACCGTCCCACGA",37,394,115,23,63,632,18797
"ATCCATTAGGTCGTAG",1,4,0,0,0,5,67
"ATCCATTCAAGTAGTA",13,40,55,2,19,129,4139
"ATCCATTGTACCTGTA",0,9,2,0,0,11,115
"ATCCATTTCACCGCTT",0,0,0,0,0,0,74
"ATCCATTTCACTGAAC",340,113,51,14,51,569,18880
"ATCCATTTCATTCACT",5,24,8,0,8,45,584
"ATCCATTTCCAGTGCG",2,28,4,4,10,48,2146
"ATCCCTGAGGCAGCTA",25,95,250,13,41,424,17701
"ATCCCTGAGGCGATAC",2,2,0,0,0,4,118
"ATCCCTGCAATGACCT",0,5,0,0,0,5,212
"ATCCCTGCAGCACAGA",0,13,0,0,6,19,576
"ATCCCTGCAGGAGGAG",3,30,7,0,4,44,1364
"ATCCCTGCATTGTACG",1,4,8,0,0,13,669
"ATCCCTGGTGTGGACA",0,2,3,0,0,5,73
"ATCCCTGGTGTTCAGT",0,0,0,0,0,0,71
"ATCCCTGGTTCTCGTC",0,3,0,0,0,3,71
"ATCCCTGGTTGGGCCT",0,0,0,0,0,0,4
"ATCCCTGTCAACGTGT",2,21,3,0,5,31,356
"ATCCCTGTCCAAGCTA",1,12,4,0,3,20,503
"ATCCCTGTCCACTGGG",35,292,101,15,45,488,16120
"ATCCCTGTCCAGCCTT",0,2,0,0,0,2,53
"ATCCCTGTCGAGAGCA",6,72,11,2,14,105,4181
"ATCCCTGTCTCATTGT",4,8,4,0,3,19,34
"ATCCGTCAGACAGCTG",1,4,0,0,4,9,121
"ATCCGTCCAAACGTGG",3,44,8,2,12,69,2411
"ATCCGTCGTACAGTAA",5,25,23,3,44,100,2533
"ATCCGTCGTACCAATC",0,9,0,0,0,9,123
"ATCCGTCGTTGCTAGT",0,3,0,0,0,3,61
"ATCCGTCTCATTGCTT",0,7,4,0,2,13,198
"ATCCGTCTCGCAAGAG",6,78,15,3,16,118,3102
"ATCCGTCTCGCCGAAC",1,5,2,0,3,11,384
"ATCCTATAGAATCGTA",0,7,0,0,0,7,126
"ATCCTATAGGTGGCTA",1,7,3,0,2,13,262
"ATCCTATAGTGCCGAA",1,4,2,0,3,10,221
"ATCCTATCACCTCTAC",1,3,0,0,3,7,130
"ATCCTATTCAAATGAG",1,4,0,0,0,5,71
"ATCCTATTCTGCGTCT",0,6,0,0,2,8,159
"ATCCTATTCTTGAACG",4,8,5,0,3,20,404
"ATCGATGAGTCTGGTT",0,4,0,0,0,4,93
"ATCGATGAGTTAGTGA",0,0,0,0,0,0,3
"ATCGATGCACGCGTGT",50,36,17,0,15,118,3907
"ATCGATGCAGGTAGTG",156,1419,254,68,274,2171,88309
"ATCGATGCAGTAACGG",1,3,0,0,0,4,39
"ATCGATGGTAGCGTTT",84,969,193,38,160,1444,58480
"ATCGATGGTGCGTGCT",14,15,2,0,10,41,1401
"ATCGATGGTTGAATCC",1,4,0,0,0,5,98
"ATCGATGTCAACCGAT",0,0,0,0,0,0,66
"ATCGATGTCATTGCTT",1,2,0,0,0,3,91
"ATCGATGTCCGTCAAA",0,6,2,0,4,12,150
"ATCGATGTCGAAACAA",1,18,3,3,2,27,677
"ATCGATGTCTTGCAAG",1,3,3,0,0,7,54
"ATCGCCTAGCAGCCCT",1,0,0,0,0,1,6
"ATCGCCTAGGACACTG",1,7,4,0,0,12,327
"ATCGCCTAGGCAATGC",5,20,12,2,26,65,2090
"ATCGCCTCAGCGGATA",1,6,0,0,3,10,268
"ATCGCCTCATGCCATA",5,27,4,2,4,42,1541
"ATCGCCTGTCCAGTTA",0,15,8,0,4,27,523
"ATCGCCTGTTCCATTT",1,2,2,0,0,5,256
"ATCGCCTTCAGCGCAC",13,39,29,6,84,171,5884
"ATCGCCTTCCTGTTGC",0,0,0,0,0,0,162
"ATCGGATAGGATATAC",0,2,0,0,0,2,57
"ATCGGATAGGATGCGT",14,40,28,4,130,216,7099
"ATCGGATCAACTCCCT",0,0,0,0,0,0,57
"ATCGGATCAAGTGGCA",2,0,0,0,4,6,244
"ATCGGATCAATTGAGA",3,5,0,0,2,10,79
"ATCGGATCATAGGTAA",0,16,2,0,0,18,284
"ATCGGATGTCCACTTC",0,2,3,0,0,5,99
"ATCGGATTCGCGTAGC",0,4,0,0,0,4,61
"ATCGGCGAGGTCGTCC",0,0,0,0,0,0,6
"ATCGGCGCACAACGCC",0,4,0,0,0,4,138
"ATCGGCGCAGCATACT",27,196,51,169,45,488,15058
"ATCGGCGGTCTACACA",0,9,2,0,3,14,325
"ATCGGCGGTTGTTGCA",2,5,0,0,0,7,138
"ATCGGCGTCCAACTGA",1,0,0,0,0,1,21
"ATCGGCGTCTGTCCCA",1,0,0,0,0,1,32
"ATCGGCGTCTGTCTCG",0,5,0,0,3,8,191
"ATCGGCGTCTTCGTAT",0,3,2,0,2,7,45
"ATCGTAGAGACCCGCT",0,0,0,0,0,0,64
"ATCGTAGAGCCATATC",1,2,0,0,0,3,38
"ATCGTAGCAATGTCAC",3,14,2,0,0,19,48
"ATCGTAGCAGGAAGTC",0,0,0,0,0,0,106
"ATCGTAGCAGGAATAT",0,0,0,0,2,2,60
"ATCGTAGCATGCAGCC",68,48,19,6,20,161,3969
"ATCGTAGTCGCCGAGT",1,2,0,0,0,3,57
"ATCGTAGTCGGTCACG",2,4,2,0,0,8,123
"ATCGTCCAGCCTATCA",1,19,9,0,0,29,590
"ATCGTCCAGCTCGTGC",0,2,0,0,0,2,31
"ATCGTCCAGTATGCAA",0,15,5,0,3,23,499
"ATCGTCCCAATTCTTC",1,2,0,0,0,3,43
"ATCGTCCCACAACGAG",2,10,3,0,0,15,96
"ATCGTCCCACACCTTC",0,23,2,2,5,32,485
"ATCGTCCCACTTGAGT",0,4,0,0,0,4,88
"ATCGTCCGTAATGCTC",0,0,0,0,0,0,9
"ATCGTCCGTACGACAG",0,0,0,0,0,0,17
"ATCGTCCTCACTCGAA",9,39,21,0,95,164,4976
"ATCGTGACAGATTCGT",0,5,0,0,0,5,53
"ATCGTGACAGGCCCTA",2,5,0,0,4,11,267
"ATCGTGAGTACGGGAT",39,389,73,7,64,572,23083
"ATCGTGAGTGACGCCT",1,13,0,0,3,17,316
"ATCGTGATCGCCTTGT",0,4,0,0,4,8,144
"ATCGTGATCTGTAACG",49,223,53,12,47,384,12681
"ATCTCTAAGTCTTCCC",1,9,0,0,4,14,487
"ATCTCTACACTCCGGA",0,13,3,0,3,19,434
"ATCTCTATCACTAGCA",1,3,0,0,0,4,178
"ATCTCTATCCAACCGG",1,2,3,0,2,8,103
"ATCTCTATCTCGTGAA",99,1058,180,29,166,1532,60278
"ATCTTCAAGAGAGCAA",2,15,3,0,0,20,462
"ATCTTCAAGTCAGGGT",1,11,2,0,3,17,293
"ATCTTCACACAAGTGG",1,10,0,0,2,13,427
"ATCTTCACACACAGCC",1,12,3,0,0,16,439
"ATCTTCACAGCTTCGG",2,7,0,0,0,9,71
"ATCTTCACAGTGAGCA",1,4,0,0,0,5,71
"ATCTTCAGTGTGGACA",213,1905,480,104,357,3059,99311
"ATCTTCATCAGTGTCA",0,2,0,0,0,2,79
"ATCTTCATCTACCAGA",3,13,5,2,2,25,459
"ATCTTCATCTATCGGA",1,25,9,0,9,44,638
"ATGAAAGAGATACGAT",0,3,2,0,0,5,83
"ATGAAAGAGCGCCATC",0,0,0,0,0,0,19
"ATGAAAGAGTAAGAGG",1,16,5,2,5,29,288
"ATGAAAGCACAGTCAT",1,4,0,0,2,7,72
"ATGAAAGGTCGTGTTA",0,7,0,0,2,9,241
"ATGAAAGTCGAGAGCA",0,3,0,0,0,3,38
"ATGACCAAGGGTAATT",0,3,2,0,0,5,66
"ATGACCACAAGTATCC",3,43,33,5,64,148,4549
"ATGACCACACAAGCAG",0,3,0,0,0,3,92
"ATGACCACACGGAAGT",0,0,0,0,0,0,1
"ATGACCACACGGCTAC",0,9,4,0,6,19,283
"ATGACCACACTGAATC",12,49,25,10,132,228,8046
"ATGACCACAGCATTGT",229,853,183,29,155,1449,50563
"ATGACCACAGGCGTTC",4,62,13,0,7,86,2953
"ATGACCAGTAACTAAG",0,11,0,0,4,15,215
"ATGACCAGTGGTTTAC",19,225,30,25,30,329,9004
"ATGACCATCCGACGGT",1,18,5,4,4,32,259
"ATGACCATCGGTAACT",1,2,2,0,0,5,185
"ATGACCATCTTGCGCT",116,364,933,50,430,1893,72200
"ATGAGGGAGCTAGAAT",0,0,0,0,0,0,8
"ATGAGGGAGTAACCTC",1,14,2,0,3,20,290
"ATGAGGGAGTGCAAAT",49,388,74,22,68,601,22999
"ATGAGGGCATACTTTC",1,33,10,2,11,57,1066
"ATGAGGGCATCGGAAG",0,2,0,0,0,2,81
"ATGAGGGTCAGCCTTC",0,0,0,0,0,0,93
"ATGAGGGTCGAGCTGC",0,2,0,0,0,2,48
"ATGAGGGTCGGAGCAA",13,63,172,4,21,273,10794
"ATGAGGGTCTTCCGTG",121,986,298,61,197,1663,49054
"ATGAGTCAGGGTGAGG",2,6,0,0,0,8,88
"ATGAGTCCACCCATAA",5,16,33,2,4,60,1905
"ATGAGTCCAGACCATT",0,3,2,0,0,5,67
"ATGAGTCCAGGTCCCA",0,0,0,0,0,0,51
"ATGAGTCGTAGTCCTA",1,2,0,0,4,7,82
"ATGAGTCGTTTCACTT",0,0,0,0,0,0,12
"ATGAGTCTCGTTAGAC",0,5,0,0,0,5,117
"ATGATCGAGCTACTGT",3,7,3,0,0,13,69
"ATGATCGCACATAGCT",2,23,5,0,8,38,797
"ATGATCGGTCAAGCCC",1,0,0,0,0,1,45
"ATGATCGTCCGAAATC",2,7,0,0,0,9,166
"ATGATCGTCGACCTAA",1,0,0,0,3,4,81
"ATGCATGGTGATACCT",2,8,4,0,2,16,61
"ATGCATGGTTATGTGC",31,111,54,205,52,453,13183
"ATGCATGTCAGCCTCT",0,6,0,0,0,6,119
"ATGCATGTCGCTGTTC",0,0,0,0,0,0,102
"ATGCATGTCTTCCAGC",0,2,0,0,0,2,137
"ATGCCTCAGATGTTGA",0,13,7,2,3,25,453
"ATGCCTCAGCGACCCT",4,14,4,0,7,29,823
"ATGCCTCAGTATAGGT",1,12,3,0,3,19,300
"ATGCCTCTCCACACCT",24,310,36,8,46,424,15310
"ATGCCTCTCCACGAAT",316,185,120,29,348,998,28107
"ATGCCTCTCCAGTACA",1,15,6,2,2,26,461
"ATGCCTCTCCATATGG",0,3,0,0,0,3,249
"ATGCCTCTCCCATAAG",1,9,5,0,5,20,485
"ATGCCTCTCGAGAACG",0,7,0,0,0,7,104
"ATGCCTCTCGGCACTG",2,27,4,0,4,37,1312
"ATGCCTCTCGTGGCGT",71,271,424,24,426,1216,41300
"ATGCGATAGCATGATA",1,5,3,2,3,14,122
"ATGCGATAGGATACCG",2,14,3,0,2,21,578
"ATGCGATCACGCCAGT",78,27,17,4,13,139,5153
"ATGCGATTCCATTTGT",1,7,2,0,0,10,131
"ATGCGATTCCGCAAAT",1,0,0,0,2,3,75
"ATGCGATTCCGTAGTA",1,12,5,0,5,23,108
"ATGCGATTCGAGAATA",0,15,2,0,3,20,61
"ATGCGATTCTCGCGTT",0,5,4,0,0,9,226
"ATGCGATTCTGTTCAT",0,68,10,0,17,95,3932
"ATGGAGGAGGAATCGC",0,13,5,0,4,22,515
"ATGGAGGAGTGCTCAT",0,22,2,0,6,30,470
"ATGGAGGCACGTACTA",0,4,0,0,2,6,122
"ATGGAGGCACTAGGCC",1,16,5,0,3,25,320
"ATGGAGGCAGAGCTAG",0,6,0,0,0,6,75
"ATGGAGGCAGAGTCTT",0,3,4,0,2,9,87
"ATGGAGGCAGGGATAC",0,10,2,0,4,16,241
"ATGGAGGGTCGATTTG",9,65,213,5,37,329,10293
"ATGGAGGGTGGGTATG",6,21,30,0,12,69,2662
"ATGGAGGGTTTAGACC",0,4,0,0,0,4,8
"ATGGAGGTCAGCGCAC",0,3,0,0,0,3,44
"ATGGATCCAAATTGGA",1,19,8,0,3,31,303
"ATGGATCCAGAAATTG",0,0,0,0,0,0,1
"ATGGATCGTACGTAGG",1,0,0,0,0,1,110
"ATGGATCTCACTAGCA",0,2,0,0,0,2,77
"ATGGGAGAGCAAGTCG",0,2,0,0,0,2,61
"ATGGGAGAGGACCCAA",16,57,182,6,29,290,9737
"ATGGGAGAGGATTCAA",1,3,2,0,0,6,154
"ATGGGAGAGGTTAGTA",0,5,0,0,3,8,100
"ATGGGAGCAACGTTAC",0,10,6,2,4,22,326
"ATGGGAGCAGTTAAAG",1,9,0,0,0,10,177
"ATGGGTTCAAGCTACT",0,8,0,0,4,12,354
"ATGGGTTCACCTGTCT",0,0,0,0,0,0,109
"ATGGGTTCAGCTAACT",0,0,0,0,2,2,98
"ATGGGTTCATCGTGGC",1,6,3,0,0,10,60
"ATGGGTTCATGTTACG",3,21,8,0,4,36,74
"ATGGGTTCATTGACAC",0,0,0,0,0,0,47
"ATGGGTTGTGTCTTGA",52,149,231,23,273,728,29316
"ATGGGTTTCCACGGAC",0,5,0,0,0,5,129
"ATGGGTTTCCCGAACG",0,7,4,0,0,11,329
"ATGGGTTTCCTAGCCT",1,4,0,0,2,7,245
"ATGGTTGAGACCATGG",0,6,0,0,0,6,124
"ATGGTTGAGCGATTCT",1,4,0,0,2,7,139
"ATGGTTGAGGCCCAAA",0,0,0,0,0,0,16
"ATGGTTGAGGGAGGGT",77,735,148,22,127,1109,38938
"ATGGTTGCAACCGCTG",178,1416,280,56,216,2146,65400
"ATGGTTGCAATGGGTG",0,0,0,0,0,0,156
"ATGGTTGCATACATCG",4,11,3,0,6,24,494
"ATGGTTGTCTGGACCG",1,3,0,0,0,4,75
"ATGTCCCAGACTTCAC",2,18,4,0,4,28,479
"ATGTCCCAGAGTCCGA",0,2,0,0,0,2,85
"ATGTCCCCAGGTAGTG",0,15,0,0,0,15,30
"ATGTCCCCATGTTTGG",2,13,5,0,3,23,431
"ATGTCCCTCATGTCTT",0,3,0,0,3,6,31
"ATGTCTTAGGATAATC",0,3,2,0,0,5,47
"ATGTCTTAGGTTCACT",0,5,0,0,0,5,154
"ATGTCTTAGTCCTGCG",0,10,3,0,4,17,341
"ATGTCTTGTACGTACT",0,9,0,0,3,12,273
"ATGTCTTGTCTTCATT",0,0,0,0,0,0,32
"ATGTCTTGTGACTCGC",0,0,0,0,0,0,39
"ATGTCTTTCCTATTGT",0,15,0,0,0,15,629
"ATTACCTAGCATCTTG",0,0,0,0,0,0,18
"ATTACCTAGCCAAGCA",2,37,6,0,5,50,1368
"ATTACCTAGGTCACAG",1,0,0,0,0,1,6
"ATTACCTCATGTTACG",115,960,239,42,160,1516,63499
"ATTACCTGTCCACGCA",11,38,100,4,18,171,6242
"ATTACCTTCAGACCTA",0,5,0,0,0,5,57
"ATTACCTTCAGACTGT",1,12,0,0,0,13,373
"ATTACCTTCTCTGAGA",28,91,133,11,163,426,12442
"ATTACTCAGGGCAATC",0,0,0,0,0,0,5
"ATTACTCCATAGACTC",3,13,7,0,3,26,479
"ATTACTCCATTCTCCG",2,15,4,0,9,30,557
"ATTACTCGTGTCCAAT",22,79,49,4,188,342,11735
"ATTACTCTCGAAGCCC",0,5,2,0,0,7,92
"ATTACTCTCGTCACCT",0,18,4,0,6,28,498
"ATTATCCCACCGTGGT",0,0,0,0,2,2,338
"ATTATCCCAGGTTCAT",18,190,37,7,34,286,10234
"ATTATCCCATCGGAGA",0,3,0,3,0,6,210
"ATTATCCCATTGAGCT",1,3,0,0,3,7,158
"ATTATCCGTAGTGCGA",0,2,0,0,0,2,45
"ATTATCCTCCATACTT",0,2,0,0,0,2,60
"ATTATCCTCCTTGGAA",9,33,43,7,18,110,3525
"ATTATCCTCTTGCGCT",1,5,2,0,7,15,231
"ATTCACTAGACATAGT",0,2,0,0,0,2,9
"ATTCACTGTACCCGCA",0,6,10,0,0,16,744
"ATTCACTGTTGAAGTA",0,2,2,0,2,6,115
"ATTCACTTCAGGACGA",7,67,15,0,8,97,2196
"ATTCACTTCCACAGGC",16,160,32,9,26,243,8672
"ATTCACTTCCCTTCCC",0,8,0,0,0,8,306
"ATTCACTTCTACGCGG",107,672,239,52,604,1674,58317
"ATTCAGGAGCAGCAGT",29,120,24,6,25,204,8353
"ATTCAGGCACGTACTA",28,205,40,12,46,331,11912
"ATTCAGGCAGATCCAT",0,6,0,0,0,6,89
"ATTCAGGGTAATGCTC",0,9,3,0,0,12,434
"ATTCAGGTCAACACCA",4,12,5,0,2,23,673
"ATTCAGGTCATTCGGA",1,8,0,0,0,9,85
"ATTCAGGTCTTCTGTA",2,8,3,0,2,15,111
"ATTCATCAGGTTGCCC",9,37,73,4,13,136,4780
"ATTCATCCACGCGCAT",0,0,0,0,0,0,142
"ATTCATCGTCTGATAC",1,5,0,0,0,6,165
"ATTCATCTCACGAACT",0,2,0,0,0,2,95
"ATTCATCTCATTACTC",3,9,4,0,6,22,534
"ATTCATCTCGCAGAGA",0,5,0,0,0,5,89
"ATTCCATAGAGGCTGT",2,8,0,0,0,10,156
"ATTCCATAGGACTGGT",2,6,2,0,2,12,108
"ATTCCATAGGGTGAAA",1,11,3,0,0,15,126
"ATTCCATAGGTGTGAC",1,2,0,0,0,3,48
"ATTCCATCATCTTCGC",0,0,0,0,0,0,128
"ATTCCATCATTAGGAA",1,18,3,0,5,27,435
"ATTCCATGTAGCCAGA",10,94,16,0,12,132,4060
"ATTCCATGTGAGCGAT",22,198,42,10,45,317,12608
"ATTCCATGTGTTACAC",0,7,0,0,0,7,95
"ATTCCCGAGCAACAGC",0,0,0,0,0,0,81
"ATTCCCGAGGCTGAAC",9,114,27,5,20,175,5363
"ATTCCCGCAACTCCAA",2,19,6,0,4,31,537
"ATTCCCGCACAAGCAG",0,0,2,0,0,2,66
"ATTCCCGCAGTGCCTG",0,0,0,0,0,0,33
"ATTCCCGGTGGTCTTA",0,20,2,0,2,24,575
"ATTCCCGTCTAGCCTC",32,136,311,15,124,618,24556
"ATTCCTAAGTATCTGC",3,27,2,0,3,35,388
"ATTCCTACAACCGATT",0,0,0,0,0,0,46
"ATTCCTACACTGGATT",1,15,3,0,0,19,658
"ATTCCTACATCTCAAG",0,3,0,0,0,3,15
"ATTCCTAGTACTTGTG",0,12,8,2,6,28,1106
"ATTCCTAGTCTCAAGT",4,16,5,0,6,31,330
"ATTCCTAGTTCAGTAC",2,9,3,0,0,14,145
"ATTCCTAGTTCGGACC",0,6,5,0,6,17,453
"ATTCCTAGTTTGGAGG",3,18,7,0,8,36,520
"ATTCCTATCAAGAATG",1,4,0,0,0,5,195
"ATTCCTATCCTCTAGC",0,12,4,0,3,19,65
"ATTCGTTAGAAGTCAT",5,32,3,2,7,49,482
"ATTCGTTAGCTTACGT",0,0,0,0,0,0,31
"ATTCGTTAGTGGACTG",2,16,5,0,4,27,306
"ATTCGTTAGTTCAACC",10,193,32,5,24,264,9496
"ATTCGTTCACATACGT",5,19,5,0,5,34,458
"ATTCGTTCAGACACCC",0,0,0,0,0,0,4
"ATTCGTTGTGCGCTCA",64,106,55,11,31,267,7716
"ATTCGTTTCTACTATC",0,2,0,0,0,2,39
"ATTCTACAGAGGGTAA",1,24,5,0,5,35,561
"ATTCTACAGCTGTTCA",1,10,0,0,2,13,53
"ATTCTACAGGAGCTGT",3,22,14,0,36,75,2268
"ATTCTACAGTTGTAGA",0,3,0,0,0,3,63
"ATTCTACCACACCAGC",2,18,6,2,5,33,459
"ATTCTACCAGCAGAAC",0,3,2,0,0,5,139
"ATTCTACGTAGCGCCT",1,2,0,0,3,6,138
"ATTCTACGTCAGTCCG",5,27,14,0,46,92,3047
"ATTCTACTCATGTCAG",24,165,37,10,42,278,9002
"ATTCTACTCTAATTCC",0,0,0,0,0,0,28
"ATTCTACTCTCTTCAA",1,2,6,0,0,9,332
"ATTCTTGAGACCGCCT",1,6,2,0,2,11,290
"ATTCTTGAGGATTCAA",0,2,0,0,0,2,21
"ATTCTTGAGGATTTAG",0,0,0,0,0,0,2
"ATTCTTGCACTTTATC",0,3,0,0,0,3,45
"ATTCTTGGTCCGTACG",7,18,11,0,21,57,1706
"ATTCTTGTCCCTTGGT",4,13,2,0,2,21,649
"ATTCTTGTCTCACGAA",0,5,0,0,0,5,78
"ATTGGGTAGCGTTCAT",0,0,0,0,4,4,127
"ATTGGGTAGGACTGGT",0,3,0,0,0,3,47
"ATTGGGTAGTAAGACT",10,35,71,5,17,138,4799
"ATTGGGTCAACCGCTG",16,122,29,2,23,192,6475
"ATTGGGTCAATAGAGT",0,13,0,0,2,15,65
"ATTGGGTCACAGAGAC",6,24,43,2,6,81,3271
"ATTGGGTCACTCGATA",1,9,3,0,3,16,115
"ATTGGGTCAGATAAAC",0,0,0,0,0,0,8
"ATTGGGTGTTAAGCAA",2,14,2,0,2,20,318
"ATTGGGTGTTTCGACA",6,25,29,5,17,82,2533
"ATTGTTCAGAATCCCT",0,2,2,0,0,4,79
"ATTGTTCAGACCAGAC",19,201,55,6,35,316,12979
"ATTGTTCAGCGGGTTA",0,5,0,0,0,5,81
"ATTGTTCAGTTAGAAC",1,23,5,0,5,34,848
"ATTGTTCGTCCGGTCA",0,0,0,0,0,0,6
"ATTGTTCGTGGACCAA",34,27,9,4,9,83,2034
"ATTGTTCTCCACACCT",1,2,0,0,2,5,120
"ATTGTTCTCGGTCACG",5,30,16,6,4,61,1671
"ATTTACCAGAGTTGTA",0,17,6,0,6,29,156
"ATTTACCCAGCATGCC",16,27,14,2,62,121,4025
"ATTTACCCATTGGGAG",0,2,0,0,0,2,34
"ATTTACCGTCTGATAC",4,15,3,0,8,30,313
"ATTTACCGTGGCTGAA",1,2,2,0,0,5,77
"ATTTACCTCCCTCTCC",4,22,5,3,7,41,557
"ATTTACCTCGGATAAA",1,2,0,0,2,5,82
"ATTTCACAGCGAGAAA",0,0,0,0,0,0,8
"ATTTCACAGTTACGGG",0,4,3,0,3,10,126
"ATTTCACCAAACTCTG",0,5,3,2,0,10,206
"ATTTCACGTCTACACA",0,4,3,0,0,7,121
"ATTTCACGTGACCTGC",0,0,0,0,2,2,47
"ATTTCACGTGCACAAG",6,65,14,2,10,97,2744
"ATTTCACGTGCGAGTA",0,0,0,0,0,0,3
"ATTTCACGTTCCGCAG",2,12,27,3,6,50,1818
"ATTTCACTCCACGTCT",3,33,8,0,3,47,789
"ATTTCACTCCATTCAT",3,8,5,0,8,24,478
"ATTTCACTCCCTCTCC",0,2,0,0,0,2,74
"ATTTCACTCGTAGTCA",1,14,5,0,0,20,401
"ATTTCACTCTTTCCAA",2,3,0,0,0,5,194
"ATTTCTGAGACTCAAA",10,45,39,0,18,112,2478
"ATTTCTGAGCATCCTA",0,3,0,0,0,3,41
"ATTTCTGAGCGAATGC",1,0,2,0,0,3,227
"ATTTCTGAGGGAGTTC",1,3,0,0,0,4,73
"ATTTCTGAGGTCCCTG",3,4,0,0,0,7,89
"ATTTCTGAGTAGTCTC",1,24,5,0,4,34,449
"ATTTCTGCACATAGCT",21,145,23,9,28,226,7298
"ATTTCTGTCCAGCTCT",1,4,0,0,2,7,97
"ATTTCTGTCGTTAGTG",3,33,16,4,50,106,2754
"CAAAGAAAGAGAGCAA",0,2,0,2,0,4,90
"CAAAGAAAGCCAAGGT",1,2,0,0,4,7,66
"CAAAGAAAGTAACGAT",0,11,7,0,0,18,311
"CAAAGAACACCCTCTA",0,0,0,0,0,0,17
"CAAAGAACAGACTCTA",0,2,0,0,2,4,38
"CAAAGAACATAAGATG",1,6,0,0,0,7,92
"CAACAACCAAACTAAG",1,8,0,0,0,9,90
"CAACAACCAACAAGAT",4,48,6,3,9,70,2609
"CAACAACCAATAGTCC",0,0,0,0,0,0,32
"CAACAACTCAGGAAAT",0,2,0,0,0,2,23
"CAACAGTAGATCCGAG",0,0,2,0,0,2,33
"CAACAGTAGCTAAACA",0,13,8,0,9,30,902
"CAACAGTAGTACAGAT",0,0,0,0,0,0,79
"CAACAGTAGTCAGAGC",11,62,63,5,128,269,8216
"CAACAGTCAACGGCTC",3,4,0,0,0,7,335
"CAACAGTCACGACAAG",0,6,0,0,0,6,81
"CAACAGTCAGCCCACA",13,49,39,46,8,155,5522
"CAACAGTGTAAGCGGT",5,19,7,0,54,85,2182
"CAACAGTGTCCTTTGC",0,18,4,0,4,26,402
"CAACAGTTCCTGGGTG",0,0,0,0,0,0,20
"CAACCAAAGCGATGAC",0,8,0,0,0,8,75
"CAACCAAAGTAGGCCA",2,13,6,0,2,23,499
"CAACCAAAGTCATGCT",0,5,0,0,2,7,102
"CAACCAAAGTCGAAGC",96,208,43,14,44,405,11048
"CAACCAACAAGCTACT",2,19,6,0,6,33,539
"CAACCAAGTAGGCAAC",0,0,2,0,2,4,64
"CAACCAAGTGAGGCAT",0,0,0,0,0,0,8
"CAACCAATCCTCATAT",1,14,0,0,2,17,338
"CAACCTCAGCTCAGAG",102,638,234,1241,220,2435,83507
"CAACCTCAGGTAAGAG",1,22,30,0,5,58,1604
"CAACCTCAGTCCCAAT",2,15,2,0,4,23,452
"CAACCTCAGTGTGTTC",15,45,9,4,12,85,3357
"CAACCTCCAACAGTGG",1,5,0,0,3,9,144
"CAACCTCCAATCTGCA",1,10,3,3,0,17,351
"CAACCTCCACATGACT",1,3,0,0,0,4,50
"CAACCTCGTCGACGCT",3,11,4,0,4,22,490
"CAACCTCTCCGTGGGT",0,0,2,0,0,2,27
"CAACCTCTCCTCTGCA",0,2,2,0,0,4,82
"CAACGATAGAACTCCT",1,3,0,0,2,6,101
"CAACGATAGCTTCTAG",11,49,47,4,56,167,5787
"CAACGATAGGGAGTGG",165,185,108,12,53,523,16317
"CAACGATCACAAAGTA",2,8,3,0,5,18,411
"CAACGATCACTGCGAC",13,113,23,7,57,213,8807
"CAACGATGTAGCGCTC",0,0,0,0,0,0,12
"CAACGATGTGAATGAT",0,0,0,0,0,0,4
"CAACGATGTGTCCCTT",1,6,0,0,0,7,447
"CAACGATTCGTGGACC",0,0,0,0,0,0,29
"CAACGATTCTCGGCTT",1,2,3,0,0,6,596
"CAACGGCAGAGTCGAC",0,6,3,0,0,9,335
"CAACGGCAGGACAGCT",1,6,3,0,5,15,141
"CAACGGCAGGGCAAGG",26,191,43,10,138,408,14553
"CAACGGCCAACCGTAT",2,19,2,0,4,27,699
"CAACGGCCAAGCACCC",0,3,0,0,0,3,49
"CAACGGCCACTAGGTT",0,0,0,0,0,0,46
"CAACGGCCAGGCATTT",1,11,3,0,2,17,28
"CAACGGCGTATGGAGC",0,4,0,0,0,4,82
"CAACGGCGTGTAAATG",1,3,0,0,3,7,252
"CAACGGCTCACCCTCA",1,0,0,0,2,3,175
"CAAGACTAGGTTAGTA",22,94,99,13,205,433,17853
"CAAGACTCAATGGCCC",13,67,13,3,17,113,3378
"CAAGACTGTATCCCAA",0,3,0,0,0,3,42
"CAAGACTGTCTAGGCC",0,2,0,0,0,2,68
"CAAGACTGTTTCGATG",50,211,102,21,542,926,38163
"CAAGACTTCGCCATAA",1,2,0,0,2,5,61
"CAAGACTTCTAGCCTC",0,3,0,0,0,3,122
"CAAGAGGAGTGAACAT",32,112,164,12,251,571,24689
"CAAGAGGAGTTCCGTA",0,3,2,0,3,8,42
"CAAGAGGCAACGCCCA",3,21,7,3,14,48,761
"CAAGAGGCAATAGTCC",3,18,4,0,6,31,159
"CAAGAGGCACTGCGTG",1,3,0,0,0,4,58
"CAAGAGGCATATTCGG",0,11,2,0,3,16,1043
"CAAGAGGTCAGGAGAC",2,17,3,0,8,30,399
"CAAGAGGTCGTAGTGT",0,4,0,0,0,4,27
"CAAGAGGTCTCTGCCA",46,149,92,17,487,791,27554
"CAAGCTAAGATGACAT",0,3,0,0,0,3,27
"CAAGCTACAGAATGTA",0,0,0,0,2,2,38
"CAAGCTAGTAAGCTCT",0,3,2,0,0,5,150
"CAAGCTAGTATTTCTC",5,29,10,4,33,81,2085
"CAAGCTAGTTTACTTC",3,17,3,0,7,30,479
"CAAGCTATCATGAGAA",0,0,0,0,0,0,24
"CAAGCTATCGCTGACG",6,47,7,0,11,71,2650
"CAAGCTATCTCCTGCA",0,0,2,0,0,2,16
"CAAGGGAAGCGCCTAC",0,3,0,0,0,3,50
"CAAGGGAAGTGGTTGG",0,0,0,0,0,0,45
"CAAGGGAGTCAATGGG",77,230,44,6,34,391,14698
"CAAGGGAGTCGTGCCA",1,10,5,0,0,16,25
"CAAGGGATCAACGCTA",0,13,2,0,3,18,447
"CAATACGAGCATGTTC",0,5,4,0,0,9,50
"CAATACGAGGATAATC",26,314,52,17,54,463,17416
"CAATACGCAGCTACTA",0,3,2,0,5,10,583
"CAATACGGTACGTTCA",0,10,5,0,6,21,351
"CAATACGGTGTCTCCT",2,16,4,0,6,28,51
"CAATACGGTTTGCAGT",2,4,2,0,0,8,240
"CAATACGTCGAAGCAG",0,3,0,0,0,3,67
"CAATACGTCGACATTG",1,2,0,0,0,3,39
"CAATACGTCGCAACAT",3,13,0,0,0,16,453
"CAATACGTCTCGAACA",0,3,0,0,4,7,96
"CAATCGAAGACCCGCT",0,2,2,0,0,4,80
"CAATCGACAAGCTGTT",13,18,11,0,8,50,1262
"CAATCGATCCCATTTA",1,9,2,3,0,15,311
"CAATCGATCTGTGCGG",10,43,96,6,17,172,6654
"CAATGACAGCCAGAGT",1,13,6,0,3,23,333
"CAATGACCAAACACCT",6,65,10,3,11,95,3971
"CAATGACCACCACATA",0,3,0,0,0,3,53
"CAATGACCACCGGAAA",3,18,7,0,19,47,1589
"CAATGACCACGTGAGA",1,9,2,0,2,14,224
"CAATGACCAGCAGACA",1,3,0,0,0,4,108
"CAATGACGTGTCCGTG",4,25,21,2,50,102,3928
"CAATGACTCTCTAGGA",0,19,5,0,0,24,422
"CAATTTCAGAGCAGCT",39,287,54,18,55,453,15233
"CAATTTCAGGTGCCAA",2,10,5,0,0,17,682
"CAATTTCAGTTGGGAC",78,52,23,4,18,175,4123
"CAATTTCCAAACGAGC",0,0,0,0,2,2,99
"CAATTTCCAATCGAAA",12,49,104,9,46,220,7957
"CAATTTCCAGGCTTGC",0,0,0,0,0,0,22
"CAATTTCGTTTCGACA",128,1271,243,64,242,1948,75895
"CAATTTCTCACCCTCA",0,0,0,0,0,0,38
"CAATTTCTCACGACTA",0,0,0,0,0,0,20
"CAATTTCTCATCCTGC",0,2,0,0,0,2,59
"CAATTTCTCCAACTGA",1,9,0,0,3,13,281
"CAATTTCTCGAGAGAC",1,4,0,0,0,5,142
"CACAACAAGAGGGTCT",0,8,0,0,2,10,138
"CACAACAAGCACTCAT",2,14,3,0,2,21,602
"CACAACAAGCTACTGT",0,0,0,0,0,0,23
"CACAACAAGGGTTAGC",3,11,31,0,4,49,1616
"CACAACACAACCCTAA",0,3,8,0,0,11,88
"CACAACACACCAGACC",1,8,0,0,2,11,518
"CACAACACAGATCACT",1,3,2,0,0,6,151
"CACAACACATCCCGTT",0,0,0,0,0,0,16
"CACAACACATGCCGAC",0,0,0,0,0,0,8
"CACAACAGTATCAGCT",4,17,7,0,19,47,638
"CACAACAGTTGCCGAC",0,0,0,0,0,0,7
"CACAACATCGTAGAGG",1,3,0,0,0,4,94
"CACACAAAGAAATTCG",0,0,0,0,0,0,57
"CACACAAAGTTGCATC",1,7,0,0,3,11,76
"CACACAAAGTTGGCGA",3,14,5,0,2,24,715
"CACACAACACTGTTCC",0,3,0,0,0,3,86
"CACACAACAGCGACCT",0,3,0,0,2,5,213
"CACACAAGTACGACAG",0,6,0,0,0,6,110
"CACACAAGTCCACTCT",5,74,39,4,11,133,4847
"CACACAAGTGAGTAGC",1,42,6,3,11,63,2108
"CACACAATCGTGCATA",3,25,13,0,24,65,1772
"CACACAATCTGCATGA",2,10,0,0,0,12,89
"CACAGATAGCTCCCTT",0,2,0,0,0,2,79
"CACAGATGTAGGCAGT",6,83,15,4,16,124,5001
"CACAGATGTTACCCAA",7,31,26,3,83,150,4329
"CACAGATGTTATCTGG",0,4,0,0,0,4,115
"CACAGATTCCACCTCA",0,13,2,0,2,17,258
"CACAGGCAGACCTTTG",0,2,0,0,0,2,57
"CACAGGCAGGACGGAG",3,15,2,0,2,22,182
"CACAGGCAGGACTAAT",3,11,0,3,4,21,283
"CACAGGCAGGGTCAAC",1,2,0,0,0,3,168
"CACAGGCCAAATCAAG",0,4,2,0,0,6,75
"CACAGGCCAACGATTC",2,3,4,0,0,9,150
"CACAGGCCACTTGTCC",0,0,0,0,0,0,8
"CACAGGCCATCGATCA",0,0,0,0,0,0,62
"CACAGGCGTAGAGGAA",24,232,46,12,46,360,8984
"CACAGGCGTGGATGAC",0,0,0,0,0,0,10
"CACAGGCGTTCAAACC",0,2,2,0,0,4,56
"CACAGGCTCACATACG",54,283,95,87,495,1014,35457
"CACAGGCTCCTTATGT",2,12,4,0,2,20,37
"CACAGGCTCTTGTGCC",0,0,0,0,0,0,78
"CACATGAAGCAGGGAG",0,3,0,0,0,3,23
"CACATGAAGCCTGAGA",1,9,0,0,4,14,395
"CACATGAAGCTGTACT",0,3,2,0,0,5,82
"CACATGAAGTCTTCGA",2,11,3,0,0,16,478
"CACATGACACCGTGGT",21,142,25,5,24,217,5628
"CACATGACACCTGCTT",1,11,0,0,0,12,438
"CACATGACAGCGTGAA",0,0,0,0,0,0,1
"CACATGAGTGTTATCG",1,5,3,0,3,12,259
"CACATGAGTTGCCGAC",0,5,2,0,2,9,214
"CACATGAGTTTACTTC",1,2,0,0,0,3,91
"CACATGATCGGTTCAA",23,282,48,14,49,416,17174
"CACATGATCTAAGCGT",0,6,0,0,0,6,85
"CACCAAAAGTCGAAGC",0,6,0,0,0,6,127
"CACCAAACACAGCTGC",3,14,2,0,0,19,473
"CACCAAACACGACGTC",12,46,73,3,17,151,4923
"CACCAAACATCACCAA",0,0,0,0,2,2,141
"CACCAAACATCATGAC",0,0,3,0,0,3,91
"CACCAAACATCCTGTC",3,7,0,0,2,12,384
"CACCAAAGTTGACGGA",0,2,0,0,0,2,59
"CACCAAAGTTGCGTAT",0,3,2,0,3,8,136
"CACCAAAGTTGTAAAG",3,18,21,2,10,54,1977
"CACCAAATCAAGTGTC",2,10,3,0,0,15,276
"CACCAAATCAGACATC",1,13,2,2,4,22,361
"CACCAAATCTGAGAAA",0,3,0,0,0,3,103
"CACCGTTAGCGACAGT",10,71,17,3,16,117,4661
"CACCGTTAGTCCGCCA",1,3,3,0,0,7,211
"CACCGTTCAACACAAA",8,35,19,6,78,146,4952
"CACCGTTCAAGCGGAT",2,3,2,0,0,7,127
"CACCGTTGTAGTCTTG",2,13,5,0,3,23,549
"CACCGTTGTGCGACAA",0,23,3,0,3,29,1004
"CACCGTTGTGGCCTCA",0,10,6,0,0,16,273
"CACCGTTGTTATTCTC",3,22,3,2,3,33,582
"CACCGTTGTTCGCGTG",3,10,4,0,4,21,436
"CACCGTTGTTTCACAG",6,44,75,2,19,146,3733
"CACCGTTTCACTACGA",0,6,0,0,0,6,75
"CACGAATAGACGACTG",44,550,87,23,74,778,28687
"CACGAATAGTAATACG",0,10,0,0,0,10,138
"CACGAATAGTCCCTAA",0,2,2,0,0,4,101
"CACGAATGTGCGAGTA",1,9,6,0,0,16,389
"CACGAATTCGTGGCTG",24,59,182,8,30,303,11139
"CACGGGTAGTTCCAGT",0,0,0,0,0,0,11
"CACGGGTAGTTGGCTT",0,10,2,0,0,12,248
"CACGGGTCACCTGTCT",0,0,0,0,0,0,8
"CACGGGTCACTAACCA",1,0,0,0,0,1,117
"CACGGGTGTATGCTTG",0,0,0,0,0,0,16
"CACGGGTGTCCTGGTG",3,33,36,2,29,103,3531
"CACGGGTTCACTCACC",1,5,0,0,0,6,76
"CACGGGTTCATGGCCG",0,4,3,0,2,9,118
"CACGGGTTCCTGTAGA",1,2,0,0,0,3,87
"CACGGGTTCGCAATTG",0,9,0,0,0,9,138
"CACGGGTTCTAGTCAG",3,29,15,3,39,89,3411
"CACGGGTTCTCTGCCA",3,24,8,2,0,37,998
"CACGGGTTCTTCGACC",25,78,135,9,178,425,11871
"CACGTGGAGGATACAT",0,3,0,0,0,3,112
"CACGTGGAGGCCTGCT",0,4,0,0,0,4,96
"CACGTGGCAATGGCAG",23,52,82,9,94,260,8057
"CACGTGGTCAACCTCC",211,892,148,40,141,1432,47554
"CACGTGGTCACCATCC",23,50,17,6,12,108,2802
"CACGTGGTCCAAGGGA",2,4,0,0,0,6,194
"CACGTTCAGACATAGT",0,0,0,0,0,0,11
"CACGTTCAGCACTCGC",17,62,185,6,28,298,13208
"CACGTTCAGGAACTAT",2,7,2,0,0,11,321
"CACGTTCGTACGATCT",0,4,2,0,0,6,101
"CACGTTCTCATCGGGC",0,0,0,0,0,0,19
"CACGTTCTCATTTACC",4,65,10,7,13,99,3481
"CACGTTCTCCTCAGGG",33,342,72,10,50,507,16823
"CACGTTCTCGGTCAGC",0,7,2,0,2,11,311
"CACTAAGAGTCCCTAA",3,9,8,0,3,23,399
"CACTAAGAGTGTAGAT",1,32,5,0,7,45,599
"CACTAAGCAACTGCTA",273,86,42,13,47,461,18387
"CACTAAGCACAACATC",1,8,2,0,0,11,125
"CACTAAGCAGTATTCG",2,8,3,0,5,18,428
"CACTAAGGTGGAATGC",18,46,27,2,127,220,9190
"CACTAAGTCTTCTCAA",0,4,2,0,0,6,54
"CACTGAAAGGCCTGAA",2,18,6,0,0,26,376
"CACTGAACACGGGTAA",0,2,2,0,0,4,59
"CACTGAAGTGAACGGT",0,2,0,0,0,2,5
"CACTGAATCGAACGGA",3,45,6,0,6,60,1985
"CACTGAATCGAACTCA",576,369,117,29,128,1219,40351
"CACTGGGCAACGGGTA",7,31,63,9,13,123,4892
"CACTGGGCAAGACGAC",16,49,147,7,52,271,10429
"CACTGGGCACATGAAA",3,9,5,0,0,17,458
"CACTGGGGTCTAACTG",1,3,0,0,0,4,190
"CACTGGGGTGGCTAGA",0,4,0,0,0,4,26
"CACTGGGTCGGTTAGT",63,282,489,32,623,1489,49098
"CACTGTCAGTACTGTC",0,0,0,0,0,0,42
"CACTGTCAGTAGCCAG",2,9,0,0,0,11,221
"CACTGTCCAACTGCTA",0,2,0,0,0,2,11
"CACTGTCCACATAACC",3,17,2,0,3,25,431
"CACTGTCCATCAGCTA",6,26,49,3,15,99,2809
"CACTGTCGTCTGTAAC",0,10,4,0,4,18,78
"CACTGTCTCCGCACGA",0,3,0,0,0,3,89
"CACTGTCTCCTCTAGC",120,41,18,0,16,195,7308
"CACTTCGAGCAATTAG",0,2,0,0,0,2,59
"CACTTCGCACATGTTG",0,3,0,0,0,3,96
"CACTTCGCACTATCGA",0,0,0,0,0,0,0
"CACTTCGTCATAGAGA",1,4,0,0,2,7,53
"CACTTCGTCGTCCTTG",1,4,0,0,0,5,27
"CACTTCGTCTCCGAGG",0,8,2,0,0,10,400
"CAGAGCCAGTAGCTCT",0,2,0,0,2,4,77
"CAGAGCCCAAATGGTA",4,5,0,0,0,9,87
"CAGAGCCCACAGAAGC",0,2,0,0,0,2,52
"CAGAGCCCACTTGTCC",0,3,0,0,0,3,111
"CAGAGCCCATGATGCT",0,2,0,0,0,2,93
"CAGAGCCGTCGTATGT",0,0,2,0,0,2,5
"CAGAGCCTCAGTAGGG",0,0,0,0,0,0,13
"CAGAGCCTCATACAGC",0,4,0,0,0,4,162
"CAGATACCAGAAACCG",1,15,8,0,4,28,35
"CAGATACGTATGGAAT",0,0,0,0,0,0,70
"CAGATACGTCTGTCCT",0,3,0,0,0,3,71
"CAGATACGTGCATTAC",0,4,0,0,0,4,41
"CAGATACTCGCCACTT",0,10,5,0,0,15,403
"CAGATCAAGCCGTTGC",0,4,0,0,2,6,62
"CAGATCAAGTCTGGTT",0,0,0,0,0,0,3
"CAGATCACACACAGAG",1,14,0,0,0,15,118
"CAGATCACACGTTCGG",0,0,0,0,0,0,13
"CAGATCACAGGCTTGC",0,2,3,0,0,5,110
"CAGATCAGTAGGACCA",1,2,0,0,0,3,43
"CAGATCAGTGAGCTCC",0,0,0,0,0,0,4
"CAGATCAGTTCATCGA",1,12,0,0,0,13,291
"CAGATCATCAGTCAGT",0,2,0,0,0,2,4
"CAGATCATCGGCACTG",0,8,7,0,6,21,379
"CAGATTGAGACTCTTG",8,30,6,2,5,51,117
"CAGATTGAGCGAACTG",2,26,3,2,15,48,2118
"CAGATTGAGGCTCAAG",0,0,0,0,0,0,18
"CAGATTGAGGTCATTC",1,6,3,0,0,10,365
"CAGATTGAGTGAGCCA",1,23,8,2,7,41,491
"CAGATTGCAATCACGT",1,4,0,0,0,5,44
"CAGATTGCAGCCGTTG",0,3,0,0,0,3,85
"CAGATTGCAGGCACTC",3,10,6,2,4,25,386
"CAGATTGCATCGCTCT",0,12,3,0,4,19,445
"CAGATTGTCTAAGCCA",0,14,0,0,3,17,339
"CAGATTGTCTCATGCC",0,6,3,0,0,9,321
"CAGCAATAGTGGAAAG",0,4,0,0,2,6,174
"CAGCAATCACACCGAC",0,4,0,0,0,4,94
"CAGCAATGTGCGGATA",2,2,0,2,0,6,58
"CAGCAATTCAACCCGG",0,12,2,0,3,17,568
"CAGCAATTCCGCAAAT",1,0,0,0,0,1,60
"CAGCAATTCCTACACC",1,5,0,0,0,6,53
"CAGCAATTCTCGGCTT",6,34,61,6,33,140,5484
"CAGCACGAGCTCGAAG",43,170,140,14,256,623,19788
"CAGCACGAGGTCGACA",11,44,28,111,19,213,7373
"CAGCACGAGTAAACAC",0,0,0,0,0,0,23
"CAGCACGAGTATTCCG",0,0,0,2,0,2,115
"CAGCACGAGTTATGGA",2,10,4,2,3,21,239
"CAGCACGCAAACTCGT",0,11,2,0,7,20,439
"CAGCACGCAACCTAAC",0,0,0,0,0,0,89
"CAGCACGCAAGGATGC",0,5,2,0,5,12,142
"CAGCACGCATCCGAGC",0,0,0,0,0,0,1
"CAGCACGGTATCCTTT",0,0,0,0,0,0,113
"CAGCACGGTCCTGTTC",1,3,0,0,0,4,112
"CAGCAGCAGCTCCATA",0,3,0,0,0,3,67
"CAGCAGCAGGCGAAGG",18,22,8,3,3,54,1584
"CAGCAGCCAGTTGTTG",8,53,13,13,15,102,3427
"CAGCAGCCATAAGCGG",0,5,0,0,2,7,126
"CAGCAGCCATATTCGG",5,12,0,0,5,22,724
"CAGCAGCTCGAAATCC",0,8,8,2,4,22,350
"CAGCCAGAGATGTTGA",0,0,0,0,0,0,77
"CAGCCAGAGCTGGCCT",0,2,0,0,0,2,125
"CAGCCAGAGTATGAGT",0,8,0,0,0,8,173
"CAGCCAGCAGAGTAAT",15,73,29,5,78,200,7863
"CAGCCAGCAGAGTCTT",2,11,6,0,0,19,377
"CAGCCAGCAGCATTGT",1,0,0,0,0,1,60
"CAGCCAGCATTCGGGC",0,4,0,0,2,6,238
"CAGCCAGGTCAGACGA",0,6,0,0,2,8,115
"CAGCCAGGTCATTCCC",0,4,0,0,0,4,7
"CAGCCAGGTGAATGTA",0,2,0,0,0,2,113
"CAGCCAGGTGGCTTGC",0,0,0,0,0,0,46
"CAGCCAGTCAGCTGTA",3,14,4,0,5,26,416
"CAGCGTGAGAGTCTTC",2,6,5,0,5,18,361
"CAGCGTGAGCCTGTGC",0,0,0,0,0,0,70
"CAGCGTGAGCGAATGC",0,4,3,0,0,7,107
"CAGCGTGCACAGTGAG",0,0,0,0,0,0,5
"CAGCGTGCACCCTAGG",0,0,0,0,0,0,2
"CAGCGTGCACTCCTTG",0,0,0,0,0,0,2
"CAGCGTGCACTGCATA",0,0,0,0,2,2,3
"CAGCGTGCAGCACGAA",1,7,0,0,2,10,158
"CAGCGTGGTCCTCCAT",0,8,2,0,0,10,130
"CAGCGTGGTTGGGCCT",1,10,2,2,6,21,146
"CAGGCCAAGATGATTG",0,4,2,0,0,6,136
"CAGGCCAAGCACTCGC",0,0,0,0,0,0,1
"CAGGCCAAGCATCTTG",0,0,0,0,0,0,49
"CAGGCCAAGTACGTCT",56,298,72,12,47,485,18003
"CAGGCCAAGTCACTAC",72,92,26,9,21,220,5995
"CAGGCCAAGTCAGAGC",0,13,4,0,3,20,313
"CAGGCCACAGTGACCC",1,4,0,0,0,5,112
"CAGGCCAGTATGCTAC",1,12,16,0,13,42,2064
"CAGGCCAGTGTGCTTA",0,6,0,0,4,10,281
"CAGGCCATCGAAGGAC",0,0,0,0,0,0,14
"CAGGGCTAGAGTTGTA",0,8,0,0,0,8,43
"CAGGGCTAGGCTCCCA",0,0,0,0,0,0,7
"CAGGGCTCAAATGAAC",0,3,2,0,0,5,77
"CAGGGCTCATGGCCCA",13,18,7,0,3,41,752
"CAGGGCTGTACTGTTG",0,0,0,0,0,0,147
"CAGGGCTTCATGAGGG",1,11,3,0,4,19,417
"CAGGGCTTCCATACAG",0,2,2,0,0,4,109
"CAGGGCTTCGTACACA",73,677,121,34,112,1017,39065
"CAGGTATAGCGAACTG",2,21,14,0,5,42,818
"CAGGTATAGGCCGCTT",0,3,0,0,0,3,177
"CAGGTATAGGGCTTCC",4,51,13,3,18,89,1706
"CAGGTATAGGTCGCCT",49,134,84,329,80,676,18506
"CAGGTATAGTTGGCTT",2,21,2,0,5,30,825
"CAGGTATCAAGACGAC",1,0,0,0,0,1,3
"CAGGTATCATTAGGAA",0,0,2,0,0,2,61
"CAGGTATGTCCCTGAG",4,80,34,0,9,127,5063
"CAGGTATGTTTGTTCT",0,4,2,0,0,6,199
"CAGGTATTCAGTCTTT",0,4,0,0,2,6,114
"CAGGTATTCGAGTCCG",0,0,0,0,0,0,8
"CAGGTATTCTAAGGAA",2,20,6,2,4,34,47
"CAGGTATTCTAGTGTG",0,3,0,0,2,5,111
"CAGGTATTCTTGAACG",6,65,13,4,10,98,3818
"CAGTGCGAGAGCTTTC",0,4,0,0,0,4,81
"CAGTGCGAGAGGTATT",1,3,0,0,4,8,105
"CAGTGCGAGCCTGAAG",211,78,61,11,45,406,13247
"CAGTGCGAGGTTTACC",0,0,0,0,0,0,36
"CAGTGCGCAACTCCCT",2,10,2,0,0,14,42
"CAGTGCGCACTGTTCC",69,808,116,21,125,1139,44006
"CAGTGCGCATGGCTGC",2,16,2,3,2,25,371
"CAGTGCGGTAATCAAG",0,2,0,0,0,2,41
"CAGTGCGGTATGGAAT",0,2,2,0,0,4,28
"CAGTGCGGTCCACTTC",0,0,0,0,0,0,47
"CAGTGCGTCTGTAAGC",2,2,0,0,0,4,66
"CAGTTAGAGGTCACAG",0,2,0,0,0,2,80
"CAGTTCCCAAGCCATT",4,20,7,0,4,35,668
"CAGTTCCCAGTCTCTC",3,41,51,0,14,109,3161
"CAGTTCCGTTGGTAGG",2,12,7,0,8,29,494
"CAGTTCCGTTGTAAAG",0,3,0,0,0,3,235
"CATAAGCAGAGAGGTA",1,17,2,0,2,22,299
"CATAAGCCAGTCTCTC",5,14,7,2,6,34,880
"CATAAGCGTATGCAAA",0,2,0,0,0,2,107
"CATAAGCGTCGCAGTC",0,0,0,0,0,0,13
"CATAAGCGTGAATGTA",3,7,2,0,2,14,181
"CATAAGCGTGACTAAA",0,4,0,0,0,4,130
"CATAAGCGTGTCCCTT",0,0,2,0,0,2,8
"CATAAGCTCTGCGATA",1,8,3,0,0,12,120
"CATACAGAGAATACAC",0,3,0,0,0,3,19
"CATACAGAGTAAACTG",1,12,7,2,7,29,655
"CATACAGAGTTTCGGT",0,2,0,0,0,2,45
"CATACAGCAAGCAATA",0,0,0,0,0,0,25
"CATACAGCAGGTTCAT",248,129,57,8,47,489,17715
"CATACAGTCTCATGGA",1,4,0,0,0,5,139
"CATACCCAGGTAGATT",0,0,0,0,0,0,1
"CATACCCCACAAACGG",0,2,0,0,0,2,22
"CATACCCCATCAGTCA",2,14,4,0,4,24,561
"CATACCCGTGTACAGG",0,3,0,0,0,3,39
"CATACCCTCGCGTTTC",1,9,2,0,2,14,351
"CATACCCTCTAGAACC",1,4,0,0,0,5,106
"CATACTTAGAAACACT",1,2,0,0,0,3,42
"CATACTTAGAAGTCCG",0,3,0,0,0,3,69
"CATACTTAGCCATGCC",1,3,0,0,0,4,18
"CATACTTAGCTCCATA",4,3,0,0,0,7,99
"CATACTTAGGTCCAGA",0,0,0,0,0,0,2
"CATACTTAGTCATGCT",0,2,0,0,0,2,73
"CATACTTAGTTATGGA",0,13,2,0,0,15,229
"CATACTTCAACGATCT",1,4,0,0,0,5,70
"CATACTTCACGTACAT",0,6,0,0,0,6,60
"CATACTTGTAAGATAC",1,3,0,0,3,7,268
"CATACTTTCACCTTAT",0,3,0,0,0,3,29
"CATAGACAGGAGCAAA",0,4,3,0,0,7,56
"CATAGACAGTATGAGT",0,4,0,0,0,4,36
"CATAGACGTACCTAAC",2,4,0,0,2,8,245
"CATAGACGTGAGCCAA",0,0,4,0,0,4,103
"CATAGACTCGTGTGAT",0,10,7,2,2,21,239
"CATCAAGAGACATCCT",1,4,0,0,4,9,216
"CATCAAGAGCAAGTGC",0,7,0,0,0,7,44
"CATCAAGAGCAGCCTC",13,37,85,6,24,165,4944
"CATCAAGAGCATCGAG",1,0,0,0,2,3,113
"CATCAAGGTCGTGGAA",2,18,4,0,4,28,322
"CATCAAGTCGGATTAC",0,2,0,0,2,4,30
"CATCCACAGCATTTCG",6,66,9,2,14,97,2319
"CATCCACAGGTTCCGC",62,195,53,14,36,360,11545
"CATCCACCAATCAAGA",0,0,0,0,0,0,11
"CATCCACCACTGTCCT",0,2,0,0,0,2,26
"CATCCACGTATGTCCA",6,65,13,0,8,92,3044
"CATCCACTCATGACAC",39,187,35,6,32,299,8880
"CATCCACTCGACACTA",5,33,12,0,5,55,1246
"CATCCACTCGGCTATA",0,12,4,2,3,21,532
"CATCCCAAGCCGATAG",0,0,0,0,0,0,72
"CATCCCAAGTAGGCCA",3,15,4,0,17,39,1212
"CATCCCACAAAGACTA",2,18,6,3,3,32,467
"CATCCCACAACTGGTT",9,30,13,0,80,132,5605
"CATCCCACATGGCTGC",8,42,13,3,3,69,2363
"CATCCCACATTGAAAG",12,28,45,6,21,112,3322
"CATCCCAGTTAAGTCC",6,43,14,93,21,177,4966
"CATCCCATCAGCCCAG",0,0,0,0,0,0,4
"CATCCCATCCACTAGA",0,0,0,0,0,0,6
"CATCCCATCGATGGAG",7,101,17,6,19,150,4752
"CATCCCATCTAGACAC",0,4,4,0,0,8,435
"CATCCGTAGAGGCGTT",0,4,0,0,0,4,34
"CATCCGTAGGGAGTTC",0,2,0,0,0,2,103
"CATCCGTGTGAGATCG",0,3,0,0,0,3,37
"CATCCGTTCAGTCAGT",21,266,50,18,53,408,13711
"CATCCGTTCGTTGTGA",0,6,0,0,0,6,103
"CATCCGTTCTCTAAGG",0,12,0,0,5,17,394
"CATCGCTAGCCAGACA",0,0,0,0,0,0,4
"CATCGCTCAATTCACG",0,0,0,0,0,0,109
"CATCGCTCACAAGTGG",0,0,2,0,0,2,92
"CATCGCTCAGTAGATA",0,8,0,0,0,8,132
"CATCGCTGTCAGTCTA",0,0,0,0,0,0,1
"CATCGCTGTTTAGAGA",16,54,133,6,31,240,7959
"CATCGGGAGCTAGCCC",78,828,213,36,103,1258,43328
"CATCGGGAGTCATGAA",5,34,13,6,51,109,3058
"CATCGGGGTACCACGC",0,3,0,0,0,3,136
"CATCGGGGTATCGGTT",5,11,4,2,17,39,1657
"CATCGGGGTGTATCCA",1,12,8,0,5,26,1130
"CATCGGGTCAAGGAGC",0,0,0,0,0,0,44
"CATCGGGTCCGACGGT",73,660,162,32,187,1114,44229
"CATCGGGTCTACGCAA",20,64,114,12,63,273,11167
"CATCGGGTCTCGCTCA",0,9,0,0,0,9,246
"CATCGTCAGGTGATCG",24,75,185,3,40,327,9826
"CATCGTCCAACCGGAA",0,0,0,0,0,0,59
"CATCGTCCATAGCACT",1,2,0,0,0,3,72
"CATCGTCCATAGGCGA",0,3,0,0,0,3,90
"CATCGTCCATCTCCCA",3,26,4,0,6,39,796
"CATCGTCTCAAGCCTA",0,0,0,0,0,0,5
"CATCGTCTCACCTGTC",3,5,3,0,0,11,37
"CATGAGTAGAGGGCGA",0,4,5,0,0,9,65
"CATGAGTAGGCTCAAG",0,6,0,0,0,6,48
"CATGAGTCAGATCACT",0,8,0,0,0,8,120
"CATGAGTGTAACGATA",282,180,77,23,56,618,18561
"CATGAGTGTCTGCGCA",2,12,0,2,0,16,414
"CATGAGTGTTGCTGAT",2,7,2,0,0,11,87
"CATGAGTTCCGCGGAT",0,0,0,0,0,0,13
"CATGCAAAGCAGCCCT",1,6,0,0,0,7,107
"CATGCAAAGGTTGCCC",0,7,0,0,3,10,336
"CATGCAAGTAATGTGA",4,15,4,0,3,26,655
"CATGCAAGTATACCTG",0,4,0,0,0,4,57
"CATGCAATCATTGGTG",0,2,0,0,0,2,40
"CATGCAATCTTTGATC",0,4,0,0,3,7,137
"CATGCCTCACGGCTAC",1,14,7,0,4,26,148
"CATGCCTCAGTTGCGC",1,0,0,0,0,1,162
"CATGCCTGTCTTACTT",14,138,27,5,28,212,8583
"CATGCCTGTGGCAACA",0,3,0,0,0,3,78
"CATGCCTGTGTTTACG",4,24,26,3,9,66,2017
"CATGCGGAGACATGCG",5,15,36,3,10,69,2830
"CATGCGGAGGTAGACC",0,0,0,0,0,0,6
"CATGCGGAGTGCAGCA",0,2,0,0,0,2,84
"CATGCGGAGTTTCAGC",0,2,2,0,0,4,187
"CATGCGGGTAGGGAGG",1,10,3,0,3,17,329
"CATGCGGGTCGCTCGA",2,4,0,0,0,6,97
"CATGCTCAGATTACCC",0,2,0,0,0,2,30
"CATGCTCAGGAAGTGA",2,2,0,0,0,4,75
"CATGCTCCATGGCTGC",0,0,0,0,0,0,13
"CATGCTCGTTAAGACA",0,0,0,0,2,2,108
"CATGCTCTCAGACTGT",0,2,2,0,0,4,148
"CATGCTCTCGCAATTG",0,0,3,0,0,3,139
"CATGCTCTCTAGATCG",0,0,0,0,0,0,74
"CATGCTCTCTCGTGAA",0,0,0,0,0,0,2
"CATGCTCTCTGGACCG",0,3,2,0,0,5,70
"CATGCTCTCTTTCCAA",0,4,0,0,0,4,67
"CATGGATCACATGTTG",0,3,0,0,0,3,125
"CATGGATCACCCAATA",0,0,0,0,0,0,85
"CATGGATCAGCTATTG",0,2,2,0,0,4,54
"CATGGATGTGTTCCTC",1,3,0,0,0,4,104
"CATGGTAAGATTGTGA",3,18,13,0,7,41,867
"CATGGTAAGCTTGTTG",2,2,0,0,2,6,30
"CATGGTACACACCGAC",2,8,6,0,3,19,474
"CATGGTAGTAGGTAGC",1,6,2,0,2,11,108
"CATGGTATCAGACCTA",17,69,178,7,32,303,10770
"CATGGTATCGGCTGAC",0,2,0,0,2,4,39
"CATTCATAGAGATGCC",0,0,0,0,0,0,39
"CATTCATAGCATACTC",7,110,17,4,21,159,5363
"CATTCATAGCGCCTTG",0,6,0,0,2,8,264
"CATTCATAGGTCGACA",3,20,11,0,11,45,1333
"CATTCATAGTGGATAT",3,9,3,0,0,15,328
"CATTCATCACACAGCC",1,0,0,0,0,1,18
"CATTCATCACTACACA",0,4,3,0,0,7,383
"CATTCATCAGGTATGG",2,2,0,0,3,7,239
"CATTCATGTAACCAGG",1,8,2,0,0,11,425
"CATTCATGTAGGTACG",0,2,0,0,0,2,86
"CATTCATGTTACGTAC",0,5,2,0,0,7,76
"CATTCATGTTGTAAAG",605,214,115,23,113,1070,35003
"CATTCATTCAACTCTT",27,200,59,21,39,346,13915
"CATTCCGAGTAAGGGA",0,2,0,0,0,2,76
"CATTCCGGTCCTGTTC",2,13,3,0,0,18,639
"CATTCCGGTCTACACA",6,56,11,4,8,85,2833
"CATTCCGGTGCTGCAC",1,3,0,0,0,4,49
"CATTCCGGTTGACGGA",14,42,111,8,19,194,7297
"CATTCCGGTTTGAAAG",4,29,14,4,46,97,3332
"CATTCCGTCAGACAAA",0,2,0,0,0,2,9
"CATTCCGTCGCAGTGC",3,9,0,0,4,16,394
"CATTCCGTCGGTCACG",1,3,0,0,2,6,84
"CATTCTAAGTTCACTG",1,11,2,0,5,19,291
"CATTCTACACTCAAGT",0,3,0,0,0,3,73
"CATTCTACACTTGAAC",0,0,0,0,0,0,11
"CATTCTACAGATTAAG",12,75,71,8,151,317,11869
"CATTCTACAGGTTCGC",4,12,0,0,3,19,653
"CATTCTAGTAGGTAGC",1,7,2,0,0,10,347
"CATTCTAGTGGGCTTC",0,0,0,0,0,0,50
"CATTCTAGTTCCATTT",0,5,0,0,0,5,34
"CATTCTATCATAAGGA",3,27,8,0,6,44,147
"CATTCTATCGTGGGTC",2,0,0,0,0,2,41
"CATTCTATCTACACAG",7,27,7,0,5,46,53
"CATTGAGAGACCAGCA",0,3,0,0,0,3,90
"CATTGAGAGAGCATAT",1,2,0,0,0,3,90
"CATTGAGAGCTACTAC",3,14,4,0,3,24,358
"CATTGAGAGGCACTAG",0,3,0,0,0,3,57
"CATTGAGCATAGAAAC",3,21,7,0,6,37,632
"CATTGAGTCACACCCT",2,3,2,0,2,9,181
"CATTGCCAGGGACACT",1,7,0,0,0,8,260
"CATTGCCAGTGCACTT",0,6,0,0,0,6,138
"CATTGCCCACCGTGGT",0,0,0,0,0,0,120
"CATTGCCCATGATCTG",0,3,0,0,0,3,127
"CATTGCCTCGCAGTTA",1,3,0,0,2,6,458
"CATTGCCTCGCGTAGC",0,0,0,0,0,0,11
"CATTGCCTCTAAGGAA",1,7,0,0,0,8,80
"CATTGTTAGCCTCAGC",36,267,68,13,69,453,17311
"CATTGTTCAAGCGAAC",3,9,3,0,3,18,356
"CATTGTTCACAGCGCT",0,2,0,0,0,2,47
"CATTGTTGTACAGAGC",0,4,0,0,0,4,91
"CATTGTTTCGAGTCTA",22,245,42,12,34,355,15617
"CATTGTTTCTGCGATA",8,81,24,7,14,134,4472
"CATTGTTTCTGCTGAA",2,6,5,0,0,13,364
"CATTGTTTCTGGGATT",1,13,0,0,3,17,54
"CATTTCACAGGGACTA",30,162,40,14,196,442,15555
"CATTTCACAGTGCGCT",0,0,0,0,0,0,9
"CATTTCAGTAGGTCAG",3,71,11,2,13,100,3603
"CATTTCATCGTAGGGA",0,2,0,0,0,2,82
"CCAAGCGAGACGGTCA",0,3,0,0,0,3,80
"CCAAGCGAGAGGACTC",5,20,5,0,5,35,1241
"CCAAGCGAGATCCAAA",1,21,2,0,8,32,730
"CCAAGCGAGTAAACTG",2,20,2,0,2,26,351
"CCAAGCGAGTCACGAG",0,0,0,0,0,0,80
"CCAAGCGCAGCGGATA",0,2,0,0,0,2,39
"CCAAGCGGTAGTGCGA",13,44,94,4,28,183,6922
"CCAAGCGTCGTCTACC",0,0,0,0,0,0,0
"CCAATGAAGCATGAAT",9,106,29,5,23,172,4888
"CCAATGAAGCGATGGT",8,73,24,5,20,130,4243
"CCAATGAAGGTTCATC",7,3,0,0,2,12,489
"CCAATGAAGGTTGACG",1,19,6,0,4,30,354
"CCAATGACAACTCGTA",0,2,0,0,0,2,118
"CCAATGACATCGGAAG",2,8,3,0,3,16,287
"CCAATGAGTACTGACT",0,7,0,0,2,9,226
"CCAATGAGTCGAGCTC",0,14,0,0,0,14,530
"CCAATGATCAGAGCAG",0,0,0,0,2,2,59
"CCAATGATCAGTCTTT",0,5,0,0,0,5,48
"CCAATGATCCTCTTTC",0,8,3,0,3,14,452
"CCAATGATCGTTGCCT",0,14,6,0,4,24,68
"CCAATGATCGTTTACT",1,4,2,0,0,7,66
"CCAATGATCTACGCAA",0,10,0,0,0,10,44
"CCAATTTCACAATGAA",3,17,5,0,4,29,608
"CCAATTTCACTTGACA",4,23,8,0,6,41,542
"CCAATTTCAGCATACT",0,3,0,0,0,3,11
"CCAATTTGTAGCTTTG",2,26,10,3,4,45,852
"CCAATTTTCAGCCTTC",9,96,18,4,16,143,5676
"CCAATTTTCAGTGATC",0,4,0,0,0,4,137
"CCAATTTTCCTTGGAA",5,18,3,2,6,34,151
"CCAATTTTCGATCCCT",2,6,3,2,3,16,259
"CCAATTTTCGCAAGAG",2,20,5,0,4,31,326
"CCACAAACAAGAGGCT",4,12,3,0,5,24,355
"CCACAAACACTCATAG",0,0,0,0,0,0,12
"CCACAAAGTCAATCTG",3,25,7,0,3,38,710
"CCACACTCACATTGTG",0,6,7,0,0,13,518
"CCACACTGTCAACATC",0,0,3,0,0,3,169
"CCACACTGTGCCTAAT",1,5,0,0,0,6,160
"CCACACTGTGTCCCTT",12,75,169,11,28,295,10253
"CCACCATAGCCTGTGC",0,2,3,0,0,5,180
"CCACCATAGTCGAATA",22,97,58,11,232,420,16985
"CCACCATCACAGTATC",1,5,3,0,0,9,390
"CCACCATGTAACACCT",3,13,2,4,0,22,349
"CCACCATGTCATAGTC",2,16,0,0,4,22,613
"CCACCATGTGATTCTG",7,72,16,6,7,108,3609
"CCACCATGTTCGTAAC",0,9,0,0,0,9,456
"CCACCATTCATCCCGT",73,750,146,41,136,1146,38142
"CCACCATTCGCTTGCT",1,9,3,3,3,19,564
"CCACCATTCTGTGCGG",0,4,2,0,0,6,92
"CCACGAGAGGGTTAAT",0,7,7,0,2,16,435
"CCACGAGCAAAGACGC",0,3,0,0,0,3,150
"CCACGAGCAGAAACCG",0,0,0,0,0,0,7
"CCACGAGGTCCGACGT",0,2,0,0,0,2,44
"CCACGAGTCATTGCGA",0,4,2,0,0,6,137
"CCACGAGTCTTAGCTT",1,5,2,0,0,8,257
"CCACGAGTCTTAGGAC",63,35,10,2,5,115,3118
"CCACGTTAGACCAAGC",1,7,2,3,3,16,125
"CCACGTTAGTTCAACC",7,16,3,0,0,26,683
"CCACGTTCACAATTCG",4,18,7,0,4,33,738
"CCACGTTGTACTCGAT",1,6,2,0,4,13,457
"CCACGTTGTCGATTTG",5,120,18,4,12,159,4987
"CCACGTTTCAAACCCA",0,2,3,0,0,5,78
"CCACGTTTCCACTGAA",0,0,0,0,0,0,173
"CCACGTTTCTATCCAT",85,693,159,36,140,1113,40651
"CCACTTGAGATGTTCC",0,0,0,0,0,0,30
"CCACTTGAGGAGTCTG",0,0,0,0,0,0,52
"CCACTTGCAGAGGCTA",0,5,0,0,0,5,57
"CCACTTGCAGTAGGAC",1,2,2,0,0,5,221
"CCACTTGCAGTGTGGA",0,7,3,0,0,10,284
"CCACTTGGTCCAATCA",2,10,3,0,0,15,407
"CCACTTGTCGGCACTG",0,2,0,0,0,2,80
"CCACTTGTCGTCACCT",0,3,0,0,0,3,68
"CCACTTGTCGTCTACC",5,70,9,3,11,98,3417
"CCACTTGTCTACTGAG",0,4,0,0,0,4,75
"CCACTTGTCTGGGCAC",66,642,180,44,123,1055,41315
"CCATAAGAGCTATCTG",2,2,0,0,3,7,59
"CCATAAGAGGATGCGT",35,123,133,10,225,526,23657
"CCATAAGCAATACAGA",0,3,0,0,0,3,54
"CCATAAGCAATGCAGG",0,0,0,0,0,0,21
"CCATAAGCACCATAAC",2,20,2,0,3,27,426
"CCATAAGCATCGTGCG",1,8,2,0,3,14,276
"CCATAAGCATTCTTCA",0,3,0,0,0,3,53
"CCATAAGGTTCGGCGT",0,3,0,0,2,5,117
"CCATAAGGTTGGGACA",1,9,4,0,4,18,383
"CCATAAGTCATGCCGG",0,0,0,0,0,0,84
"CCATAAGTCCAGTTCC",0,5,0,0,2,7,76
"CCATCACAGCTCCGAC",2,5,0,2,4,13,702
"CCATCACAGTTTAGGA",0,0,0,0,3,3,11
"CCATCACCAAGCAATA",0,0,0,0,0,0,74
"CCATCACCAAGCCTGC",0,0,0,0,0,0,29
"CCATCACCAGGTTCAT",2,14,0,0,5,21,594
"CCATCACCATCGCTCT",1,11,3,0,4,19,850
"CCATCACGTATGAGGC",0,4,0,0,0,4,18
"CCATCACGTCTTGAGT",0,4,0,0,0,4,123
"CCATCACGTTCGTAAC",1,9,3,0,2,15,587
"CCATCACTCAGGAAAT",34,413,110,15,77,649,24972
"CCATCACTCTGCCCTA",1,13,6,0,3,23,1378
"CCCAACTAGCAACCAG",0,10,2,0,3,15,193
"CCCAACTAGTCACTAC",5,82,21,5,16,129,4432
"CCCAACTCATCATGAC",659,398,163,39,138,1397,47672
"CCCAACTGTCAACCTA",0,4,0,0,0,4,159
"CCCAACTGTTAGGGAC",1,7,2,0,2,12,333
"CCCAACTGTTCTTCAT",3,45,12,0,8,68,2245
"CCCAACTTCAACTGAC",121,82,40,10,33,286,10232
"CCCAACTTCAAGAAAC",0,0,0,0,0,0,32
"CCCAACTTCCCTCAAC",0,4,0,0,0,4,59
"CCCATTGAGGAAAGAC",3,34,7,2,6,52,2226
"CCCATTGAGGCTCCCA",1,0,0,0,0,1,38
"CCCATTGAGGTAGGCT",0,8,2,0,0,10,83
"CCCATTGAGGTTACCT",4,17,8,0,8,37,883
"CCCATTGCAATTGAGA",0,0,0,0,0,0,10
"CCCATTGCACCGTCGA",0,8,0,0,0,8,317
"CCCATTGCACTGGATT",0,21,5,2,5,33,753
"CCCATTGGTACATACC",1,10,0,0,3,14,32
"CCCATTGGTACTGCCG",1,8,4,0,3,16,417
"CCCATTGGTCACCGAC",1,19,4,0,5,29,857
"CCCATTGGTGATAGTA",5,40,9,4,8,66,2637
"CCCATTGGTGCGTGCT",0,3,0,0,0,3,38
"CCCATTGGTTCTCGTC",1,5,0,0,2,8,73
"CCCATTGGTTGAAGTA",1,7,0,0,2,10,285
"CCCGAAGAGGGACCAT",0,0,0,0,0,0,5
"CCCGAAGCAAGACGGT",0,6,0,0,0,6,138
"CCCGAAGCACCGGTCA",0,0,0,0,0,0,34
"CCCGAAGGTTTCAGAC",1,15,3,0,3,22,220
"CCCGAAGTCAGTGTTG",6,25,28,4,8,71,2230
"CCCGAAGTCGCAGAGA",2,0,0,0,0,2,201
"CCCGGAAAGACTAAGT",0,5,0,0,0,5,101
"CCCGGAAAGCCGATAG",0,3,0,0,0,3,75
"CCCGGAAAGGATGGCT",5,13,6,0,2,26,722
"CCCGGAAAGGTCATTC",1,11,0,0,4,16,253
"CCCGGAAAGTATGTAG",1,12,0,0,2,15,31
"CCCGGAACAATTGGTC",2,3,3,0,0,8,182
"CCCGGAACACGGTGAA",0,0,0,0,0,0,9
"CCCGGAACACTAGGCC",1,9,3,0,8,21,717
"CCCGGAACAGTAGAAT",2,17,0,3,3,25,371
"CCCGGAAGTCATAGTC",42,247,60,33,56,438,12481
"CCCGGAATCAGGACAG",2,7,3,0,2,14,330
"CCCGGAATCCCGTGAG",3,11,26,2,8,50,1601
"CCCGGAATCTTCTGGC",0,0,0,0,0,0,75
"CCCTAACAGGTGCCTC",0,8,0,0,0,8,111
"CCCTAACCATCGCTGG",0,0,0,0,0,0,12
"CCCTAACGTAGATCGG",0,3,0,0,0,3,65
"CCCTAACGTATTCTCT",1,2,5,0,5,13,355
"CCCTAACTCAATCTTC",96,52,23,5,26,202,5373
"CCCTAACTCCTTATGT",0,4,0,0,0,4,199
"CCCTCAACAGAGCGTA",1,5,0,0,0,6,57
"CCCTCAACAGGACAGT",0,2,0,0,0,2,141
"CCCTCAACAGGCGATA",16,151,29,7,25,228,9810
"CCCTCAATCAACGCTA",2,12,0,0,4,18,523
"CCCTCAATCAAGTCTG",0,0,0,0,0,0,170
"CCCTCAATCCCACAGG",5,24,7,3,39,78,3406
"CCCTCAATCGCCAATA",3,12,25,5,4,49,1786
"CCCTCAATCTAGTGAC",0,7,2,0,0,9,148
"CCCTCAATCTGGCTGG",3,18,27,2,22,72,2680
"CCCTCTCAGCCTATTG",0,14,3,3,2,22,493
"CCCTCTCAGTTGCGCC",0,3,0,0,0,3,78
"CCCTCTCAGTTGGCGA",51,125,351,19,71,617,23687
"CCCTCTCCAATAGTCC",1,3,0,0,0,4,18
"CCCTCTCCAGCCTTCT",0,5,0,0,0,5,118
"CCCTCTCCAGGCTACC",2,14,11,2,4,33,629
"CCCTCTCCATATAGCC",2,13,2,0,2,19,603
"CCCTCTCGTCTGTGTA",0,2,0,0,0,2,30
"CCCTCTCGTGCTCTCT",0,0,0,0,0,0,134
"CCCTCTCGTGGTACAG",2,26,47,0,8,83,2740
"CCCTCTCTCGCATGAT",8,60,12,3,14,97,2995
"CCCTCTCTCTTCACGC",43,145,285,17,233,723,32259
"CCCTGATAGCATGTTC",0,0,0,0,0,0,92
"CCCTGATAGGCCACCT",0,14,3,0,3,20,46
"CCCTGATGTACTCGAT",2,3,0,0,0,5,177
"CCCTGATGTCGCATTA",0,4,2,0,0,6,8
"CCCTGATGTTGATGTC",1,9,0,0,2,12,268
"CCCTGATTCCTTCGAC",13,49,26,5,114,207,7707
"CCCTTAGAGATGAAGG",0,2,0,0,3,5,43
"CCCTTAGGTATCGAAA",18,64,139,11,35,267,11993
"CCCTTAGGTTAACAGA",3,25,28,0,4,60,2028
"CCCTTAGTCGGTTGTA",25,260,48,8,42,383,16793
"CCGAACGAGACTTAAG",7,26,42,3,10,88,3198
"CCGAACGCAAGACCTT",5,17,20,0,6,48,1610
"CCGAACGCACTGGATT",2,13,2,0,9,26,466
"CCGAACGCATAGACTC",2,12,2,0,0,16,450
"CCGAACGGTGAATGTA",15,17,7,0,5,44,1322
"CCGATCTCAAGCTGTT",30,76,212,4,36,358,15814
"CCGATGGAGCCACCGT",1,5,3,2,0,11,469
"CCGATGGAGCTCGGCT",0,2,0,0,0,2,100
"CCGATGGCACAGGATG",0,0,0,0,0,0,78
"CCGATGGCACCTGCTT",17,80,32,5,126,260,9878
"CCGATGGCACGCTTAA",2,9,0,0,0,11,251
"CCGATGGTCAACCTCC",0,0,0,0,0,0,7
"CCGATGGTCATGGAGG",37,413,76,17,79,622,24822
"CCGATGGTCCTTGAAG",0,0,0,0,0,0,0
"CCGCAAGAGGCAATGC",0,0,2,0,0,2,77
"CCGCAAGAGGCACCAA",2,3,0,0,2,7,150
"CCGCAAGAGTCATGCT",4,36,14,3,55,112,4132
"CCGCAAGCAGCCTACG",9,76,11,6,14,116,4076
"CCGCAAGCAGTAGTTC",0,8,2,0,4,14,68
"CCGCAAGGTCTTCCGT",0,0,0,0,0,0,62
"CCGCAAGTCATATGGC",0,3,0,0,0,3,50
"CCGCAAGTCGATTCCC",6,29,16,5,68,124,4607
"CCGGACAAGCACCCAC",4,49,9,0,11,73,2338
"CCGGACAAGTATAGAC",0,4,0,0,0,4,449
"CCGGACACAACAGTGG",70,771,145,34,120,1140,41342
"CCGGACACAGGGAATC",2,13,0,0,2,17,439
"CCGGACACAGTGAGCA",2,14,0,0,3,19,235
"CCGGACAGTAATGCGG",0,4,2,0,0,6,37
"CCGGACAGTCCGTACG",3,14,41,2,13,73,3160
"CCGGACAGTGACACAG",78,71,15,2,24,190,5924
"CCGGACAGTGGCAACA",0,0,0,0,0,0,74
"CCGGACATCACTTCTA",1,5,3,0,0,9,175
"CCGGACATCCGATCGG",1,6,2,0,2,11,256
"CCGGACATCTAGAACC",0,4,0,0,0,4,104
"CCGGGTAAGACAACTA",9,30,13,2,28,82,2457
"CCGGGTAAGACGTCGA",17,117,22,11,25,192,3901
"CCGGGTAAGAGGGCGA",0,0,0,0,0,0,31
"CCGGGTAAGCAGGCTA",30,359,70,14,59,532,19022
"CCGGGTAAGCCTGCCA",0,7,0,0,0,7,305
"CCGGGTAAGTAGGCCA",0,3,2,0,0,5,211
"CCGGGTACACAAGTGG",1,3,0,0,0,4,60
"CCGGGTACACCAGCTG",0,0,0,0,0,0,67
"CCGGGTAGTATCGCTA",0,0,0,0,0,0,4
"CCGGGTAGTTGGCCGT",0,0,0,0,0,0,47
"CCGGGTATCAAGTGTC",0,4,0,0,0,4,80
"CCGGGTATCGTTACCC",4,57,12,2,9,84,2929
"CCGGTAGAGCAGGGAG",1,10,6,0,4,21,489
"CCGGTAGAGCTTCTAG",0,0,0,0,0,0,19
"CCGGTAGAGGCGCTTC",1,4,0,0,2,7,62
"CCGGTAGCAAGTATAG",0,2,0,0,2,4,210
"CCGGTAGCACATAACC",0,0,0,0,0,0,91
"CCGGTAGCAGTAGTGG",1,0,0,0,0,1,48
"CCGGTAGGTACTTGTG",0,3,0,0,0,3,55
"CCGGTAGGTATCAGGG",1,9,2,0,0,12,436
"CCGGTAGGTTGGGTTT",0,0,0,0,0,0,21
"CCGGTAGGTTTGGAAA",1,0,3,0,0,4,101
"CCGGTAGTCCGAAATC",0,0,0,0,0,0,29
"CCGGTAGTCCTAACAG",24,180,34,8,35,281,7880
"CCGGTAGTCGTCGGGT",4,42,124,0,12,182,3607
"CCGGTAGTCTTCGACC",0,0,0,0,0,0,4
"CCGGTGAAGAAATGGG",0,2,0,0,0,2,15
"CCGGTGAAGAAGCGAA",40,183,153,19,198,593,24455
"CCGGTGAAGAGATTCA",1,2,0,0,5,8,141
"CCGGTGAAGAGGATGA",3,17,5,0,4,29,412
"CCGGTGAAGATGATTG",2,14,9,0,2,27,257
"CCGGTGACAAACGAGC",0,0,0,0,0,0,10
"CCGGTGACACATTACG",1,16,2,0,6,25,499
"CCGGTGACATGACTTG",1,0,0,0,0,1,79
"CCGGTGAGTACGTACT",0,0,0,0,2,2,8
"CCGGTGATCGCTGCGA",37,374,72,24,70,577,22399
"CCGTAGGAGCAACCAG",10,73,18,2,13,116,5057
"CCGTAGGAGCAGGCAT",0,2,0,0,0,2,153
"CCGTAGGCACTGATTG",0,10,3,0,0,13,303
"CCGTAGGGTGGAATGC",6,15,7,2,22,52,1414
"CCGTAGGTCCGTGGCA",0,2,2,0,2,6,161
"CCGTAGGTCGAATCCA",0,3,2,0,0,5,132
"CCGTGAGAGATGGTCG",2,12,5,15,6,40,878
"CCGTGAGAGTACAGCG",1,3,2,0,0,6,144
"CCGTGAGCAAACGGCA",1,0,0,0,0,1,42
"CCGTGAGCAGATTCGT",0,0,0,0,0,0,42
"CCGTGAGGTCTGTCCT",0,3,0,0,0,3,71
"CCGTGAGGTGCGAACA",0,4,5,0,2,11,343
"CCGTGAGTCCGAGATT",1,11,6,0,2,20,358
"CCGTGAGTCGGCCTTT",11,44,23,2,99,179,6512
"CCGTGAGTCTATTGTC",0,6,0,0,0,6,68
"CCGTTCAAGAATCGTA",0,15,7,0,5,27,98
"CCGTTCAAGGGACCAT",3,11,2,0,2,18,282
"CCGTTCAAGGGTCTTT",4,19,8,0,5,36,847
"CCGTTCAAGTAACGAT",0,6,0,0,0,6,65
"CCGTTCAAGTTGCCTA",15,125,48,3,26,217,8832
"CCGTTCACACGAGGAT",0,3,0,0,0,3,55
"CCGTTCACACGTACTA",1,2,0,0,0,3,115
"CCGTTCACAGGCAATG",8,4,3,0,0,15,433
"CCGTTCACATCGCTAA",0,0,0,0,0,0,128
"CCGTTCAGTAGTCCTA",14,51,30,7,130,232,8474
"CCGTTCAGTGGTTTGT",0,0,0,0,0,0,66
"CCGTTCATCATACAGC",79,69,16,6,17,187,6395
"CCGTTCATCCGTAATG",0,2,0,0,2,4,279
"CCGTTCATCGGAATGG",0,2,0,0,0,2,43
"CCGTTCATCGTCGATA",2,10,3,2,0,17,243
"CCGTTCATCGTGCAGC",1,10,0,0,0,11,207
"CCGTTCATCTAGTGTG",0,0,0,0,2,2,71
"CCTAACCTCCCATAAG",0,2,0,0,0,2,39
"CCTAACCTCCTCAGGG",0,4,0,0,0,4,133
"CCTAACCTCTACGCGG",13,145,62,5,30,255,8172
"CCTAAGAAGGATATGT",26,72,139,7,96,340,15952
"CCTAAGAAGTATAACG",4,43,11,2,7,67,1211
"CCTAAGAAGTTTCGAC",1,2,0,0,0,3,67
"CCTAAGACAAACCATC",6,14,8,3,4,35,734
"CCTAAGACAACTCGTA",0,0,0,0,0,0,26
"CCTAAGAGTGTCACAT",0,0,0,0,0,0,36
"CCTAAGAGTGTTGACT",0,0,0,0,0,0,57
"CCTAAGATCATGGTAC",52,453,112,32,78,727,23839
"CCTAAGATCGAATCCA",0,0,0,0,0,0,57
"CCTACGTAGACCTCCG",2,2,0,0,0,4,72
"CCTACGTAGCCTGCCA",271,86,48,11,46,462,13956
"CCTACGTAGGGTCACA",1,14,0,0,2,17,177
"CCTACGTAGTCGGCCT",0,0,0,0,0,0,11
"CCTACGTCAATCCTTT",0,0,0,0,0,0,7
"CCTACGTCAGTAGGAC",94,119,25,7,29,274,8870
"CCTACGTGTCACGCTG",1,10,5,0,0,16,489
"CCTACGTGTCGAGTGA",0,0,0,2,0,2,51
"CCTACGTGTGTGAGCA",1,10,0,0,0,11,37
"CCTACGTTCCTCATAT",0,5,0,0,4,9,61
"CCTACGTTCGGCATAT",0,3,0,0,0,3,62
"CCTATCGAGATACATG",0,0,0,0,0,0,41
"CCTATCGAGCCATTCA",0,0,0,0,0,0,36
"CCTATCGAGCTGGAGT",1,11,2,0,9,23,672
"CCTATCGAGGTGCCAA",1,4,2,0,0,7,149
"CCTATCGAGTGGTTCT",0,2,2,0,0,4,141
"CCTATCGCAGAACTTC",4,10,8,0,4,26,461
"CCTATCGCAGGCATGA",2,0,0,0,0,2,134
"CCTATCGCAGTAACGG",0,0,0,0,0,0,188
"CCTATCGCAGTGGCTC",1,4,0,0,2,7,439
"CCTATCGGTCGAATGG",2,10,5,0,4,21,581
"CCTATCGTCATTTCGT",1,5,0,0,2,8,221
"CCTCAACAGACGCAGT",0,5,0,0,0,5,86
"CCTCAACAGAGTGTGC",1,6,0,0,0,7,65
"CCTCAACCAAGTATCC",0,10,2,2,2,16,314
"CCTCAACCAGACGCTC",1,9,0,3,4,17,544
"CCTCAACGTATGCAAA",18,54,77,8,79,236,8717
"CCTCAACGTATGGAGC",0,4,0,0,2,6,179
"CCTCAACGTTCCGCAG",8,36,18,5,86,153,5769
"CCTCAACTCCTAGCGG",4,35,10,0,9,58,1500
"CCTCACACAAGGGCAT",0,0,0,0,2,2,91
"CCTCACACACACTGGC",0,3,0,0,0,3,154
"CCTCACACAGGCATTT",1,5,2,2,0,10,123
"CCTCACACATCGGAGA",1,0,3,0,0,4,64
"CCTCACAGTTCCTAGA",0,3,0,0,0,3,217
"CCTCACATCATACGAC",0,3,0,0,0,3,86
"CCTCACATCCTAGAGT",1,12,4,0,3,20,333
"CCTCACATCGTGAGAG",0,2,0,0,0,2,105
"CCTCACATCGTGTGGC",10,57,159,10,31,267,11288
"CCTCAGTCAACGCCCA",1,7,0,0,3,11,302
"CCTCAGTCACCCTCTA",1,6,0,0,2,9,240
"CCTCAGTCAGCTGTAT",1,0,0,0,0,1,92
"CCTCAGTTCCACGTCT",1,0,0,0,0,1,76
"CCTCAGTTCCTTGGAA",1,12,2,0,2,17,147
"CCTCAGTTCTGACGCG",11,26,48,4,12,101,3136
"CCTCAGTTCTGTAACG",0,2,2,0,0,4,96
"CCTCATGAGCAGCGAT",0,4,0,0,3,7,55
"CCTCATGAGTAATACG",0,4,0,0,0,4,17
"CCTCATGCATCCTCAC",0,2,0,0,0,2,89
"CCTCATGCATTGAAAG",1,19,5,0,8,33,575
"CCTCATGTCAAGGCTT",178,1402,393,71,304,2348,87390
"CCTCATGTCAGCTCTC",1,4,0,0,0,5,220
"CCTCATGTCATTTACC",27,104,94,8,122,355,12476
"CCTCATGTCCACACCT",0,3,0,0,0,3,131
"CCTCATGTCTTCTCAA",2,16,6,2,12,38,1323
"CCTCCAAAGAGGTCAC",1,0,2,0,0,3,29
"CCTCCAACATAACTCG",0,0,0,0,0,0,1
"CCTCCTCAGCCAAGCA",2,4,4,0,0,10,302
"CCTCCTCAGCCTGGAA",1,11,0,0,2,14,482
"CCTCCTCCATGTGCCG",3,71,12,2,10,98,2636
"CCTCCTCGTCGCAACC",0,0,0,0,2,2,48
"CCTCCTCGTTCGAAGG",27,132,28,10,29,226,6974
"CCTCCTCTCGTGCTCT",17,146,24,6,27,220,8625
"CCTCCTCTCTACTATC",7,83,18,5,17,130,4783
"CCTCTAGAGGACAAGA",36,113,82,11,135,377,14998
"CCTCTAGCAACCTATG",0,0,0,0,0,0,97
"CCTCTAGCAGTCTACA",65,99,49,212,42,467,16259
"CCTCTAGGTATGCGTT",0,0,0,0,0,0,9
"CCTCTAGGTCGAAGCA",0,2,0,0,0,2,54
"CCTCTAGGTGTTACAC",47,32,11,3,10,103,4096
"CCTCTAGTCCTCTTTC",0,4,0,0,0,4,87
"CCTCTAGTCGTGCTCT",0,7,0,0,0,7,20
"CCTCTCCAGATACATG",0,2,0,0,0,2,5
"CCTCTCCCACGAAGAC",22,59,29,147,22,279,8340
"CCTCTCCGTAACGGTG",1,5,5,0,3,14,307
"CCTCTCCGTACGATTC",2,5,0,0,0,7,114
"CCTCTCCGTATCGATC",0,5,0,0,0,5,215
"CCTCTCCGTGTTCATG",1,6,3,0,0,10,92
"CCTCTCCTCACTTTGT",2,7,4,0,2,15,723
"CCTCTCCTCCATCCGT",1,0,0,0,0,1,72
"CCTCTCCTCGAGCTGC",0,0,2,0,0,2,60
"CCTGCATAGAGGATCC",1,3,0,0,0,4,79
"CCTGCATCAAGACAAT",0,4,0,0,0,4,75
"CCTGCATTCTAGCATG",0,26,2,0,0,28,40
"CCTGTTGAGCGCATCC",0,6,3,0,2,11,303
"CCTGTTGCAAGTTGGG",1,3,0,0,0,4,59
"CCTGTTGCATCGCTCT",2,12,6,0,0,20,519
"CCTGTTGGTCGCCTAG",0,0,0,0,0,0,39
"CCTGTTGGTGAGACGT",26,222,51,11,44,354,12351
"CCTGTTGGTGCAGTGA",0,0,0,0,0,0,76
"CCTGTTGTCACACGAT",0,6,0,0,2,8,29
"CCTGTTGTCAGCGCAC",1,5,0,0,0,6,144
"CCTGTTGTCGATAACC",0,0,0,0,0,0,77
"CCTGTTGTCGTGCGAC",0,0,0,0,2,2,54
"CCTTCAGAGCTCCGAC",2,2,0,0,0,4,93
"CCTTCAGTCGACGAGA",0,3,0,0,2,5,84
"CCTTGTGAGCATGAAT",0,0,0,0,0,0,80
"CCTTGTGAGCGTTCCG",40,358,82,14,64,558,22281
"CCTTGTGAGGCCACTC",8,54,14,41,7,124,2903
"CCTTGTGAGGTAAGAG",0,3,0,0,0,3,61
"CCTTGTGAGTGGAAAG",0,2,0,0,0,2,9
"CCTTGTGCAGAACGCA",0,5,2,0,0,7,223
"CCTTGTGGTAGGCTGA",137,1043,288,81,247,1796,70157
"CCTTGTGGTGTAAACA",1,9,0,0,0,10,566
"CCTTGTGGTGTTCAGT",1,11,0,0,2,14,345
"CCTTGTGGTTTCTATC",1,5,8,0,3,17,320
"CCTTGTGTCCCGTGAG",2,3,2,0,0,7,146
"CCTTGTGTCCCTCAAC",0,0,0,0,0,0,27
"CCTTTGGAGCTAGATA",2,12,4,0,2,20,400
"CCTTTGGCACTAAACC",0,2,0,0,0,2,86
"CCTTTGGCAGACCGCT",3,22,34,2,13,74,2813
"CCTTTGGCAGCACAAG",52,548,127,28,98,853,35383
"CCTTTGGCATACCATG",1,6,0,0,3,10,649
"CCTTTGGGTTTAGAGA",0,21,2,0,4,27,554
"CCTTTGGTCCTACAAG",0,4,2,0,0,6,144
"CCTTTGGTCCTTTAGT",15,47,102,7,21,192,7948
"CGAAGGAAGGCCTGCT",2,13,2,2,3,22,405
"CGAAGGAAGTCACTAC",0,7,2,0,0,9,54
"CGAAGGACAAGCGAAC",0,11,0,0,0,11,271
"CGAAGGACAGCTCCTT",0,0,0,0,0,0,14
"CGAAGGACAGTTAGGG",1,11,0,0,5,17,152
"CGAAGGAGTGCGACAA",0,11,0,2,5,18,56
"CGAAGGAGTGGCTGCT",2,13,4,0,2,21,571
"CGAAGGAGTTGGGATG",0,0,0,0,0,0,107
"CGAAGGATCCCGTGTT",2,15,3,0,4,24,328
"CGAAGGATCGCACTCT",0,3,0,0,2,5,42
"CGAAGGATCGCAGTCG",0,5,3,0,0,8,242
"CGAAGGATCGGTGTTA",2,13,0,0,0,15,385
"CGAAGTTAGAATACAC",0,3,0,0,0,3,90
"CGAAGTTAGGAAGAAC",39,33,27,3,13,115,3382
"CGAAGTTCACGCAAAG",16,51,132,6,18,223,9888
"CGAAGTTGTCACAGAG",9,51,9,0,12,81,3114
"CGAAGTTTCGGCCTTT",0,4,0,0,0,4,66
"CGAAGTTTCGGTTAGT",0,13,2,3,0,18,351
"CGAAGTTTCGTTCGCT",1,14,2,0,2,19,595
"CGAATTGAGATAGTGT",9,43,78,4,14,148,5346
"CGAATTGCAATCGTCA",0,2,0,0,0,2,76
"CGAATTGCACCGTCTT",1,3,0,0,0,4,122
"CGAATTGCACTACACA",0,4,0,0,0,4,96
"CGAATTGCAGCTTTCC",1,0,0,0,0,1,179
"CGAATTGCATCCGAGC",52,198,450,33,343,1076,38950
"CGAATTGGTCAGGTAG",4,47,9,3,11,74,2977
"CGAATTGTCGTAGGGA",0,3,2,0,0,5,80
"CGAATTGTCGTCCTCA",4,47,8,0,8,67,2548
"CGACAGCAGAGCCTGA",2,13,2,0,4,21,355
"CGACAGCAGCTCACTA",0,0,0,0,0,0,57
"CGACAGCCAACACACT",47,496,131,20,76,770,28064
"CGACAGCCAAGGTCTT",0,0,0,0,0,0,61
"CGACAGCGTGGGACAT",2,24,10,0,29,65,1355
"CGACAGCTCATCACAG",1,0,0,0,0,1,115
"CGAGAAGAGGGTCAAC",5,42,5,0,6,58,2239
"CGAGAAGCAGACCAGA",1,4,2,0,0,7,183
"CGAGAAGGTAGCACAG",54,89,17,7,25,192,6008
"CGAGAAGGTAGTATAG",0,0,3,0,2,5,61
"CGAGAAGTCACACCCT",3,11,3,0,0,17,558
"CGAGAAGTCTCGTGGG",25,51,8,2,13,99,2476
"CGAGAAGTCTTGGTGA",0,0,0,0,0,0,7
"CGAGGAAAGCGAGTCA",0,0,2,0,0,2,38
"CGAGGAAAGTGACCTT",1,3,0,0,2,6,51
"CGAGGAACACTCTCGT",0,13,6,0,2,21,381
"CGAGGAACATGATAGA",44,427,82,19,70,642,24845
"CGAGGAAGTGAGTAAT",0,4,0,0,0,4,46
"CGAGGAAGTGCCTTTC",0,5,0,0,0,5,56
"CGAGGAATCATCGCAA",0,2,0,0,0,2,41
"CGAGGAATCATTCGGA",0,2,0,0,0,2,119
"CGAGGAATCCGTTTCG",1,12,0,0,3,16,457
"CGAGGAATCTGGGCAC",6,23,15,3,55,102,3929
"CGAGGCTAGCATCAAA",0,10,2,0,0,12,294
"CGAGGCTCAGAATTCC",1,8,3,0,3,15,366
"CGAGGCTCAGTATGAA",1,6,0,0,0,7,312
"CGAGGCTTCACTGTCC",0,0,0,0,0,0,9
"CGAGGCTTCATTTCCA",0,2,0,0,0,2,25
"CGAGTGCAGACCTCCG",0,2,0,0,0,2,18
"CGAGTGCAGAGCAAGA",0,0,0,0,0,0,5
"CGAGTGCAGAGTCTGG",20,72,170,8,40,310,11984
"CGAGTGCAGATGGCAC",2,16,6,2,2,28,423
"CGAGTGCAGGGCAGAG",32,41,8,2,10,93,2818
"CGAGTGCAGTGTTGTC",2,14,3,3,9,31,697
"CGAGTGCCAACGATTC",0,2,2,0,0,4,144
"CGAGTGCCAACGGCTC",1,4,0,0,2,7,221
"CGAGTGCGTAACACCT",1,14,5,0,0,20,308
"CGAGTGCGTGACTATC",0,0,0,0,0,0,42
"CGAGTGCGTTCCCACT",0,0,0,0,0,0,84
"CGAGTGCGTTCTAACG",1,9,6,0,3,19,418
"CGAGTGCGTTCTTGTT",107,1214,214,61,216,1812,71053
"CGAGTGCGTTTACTTC",0,0,6,0,0,6,204
"CGAGTGCGTTTCGGCG",1,9,0,2,5,17,46
"CGAGTGCTCAATGCAC",0,3,0,0,0,3,58
"CGAGTGCTCCAATGCA",1,3,0,0,0,4,150
"CGAGTGCTCCACGTGG",4,25,36,0,5,70,2710
"CGAGTGCTCTCTTCAA",24,105,217,7,112,465,17803
"CGAGTTAAGCAATTCC",0,2,3,0,0,5,50
"CGAGTTAAGCTTTCTT",0,0,0,0,0,0,0
"CGAGTTAAGTGTAGAT",2,2,0,0,0,4,114
"CGAGTTACAAAGGCAC",12,83,32,6,138,271,9794
"CGAGTTACAATCTAGC",0,4,0,0,0,4,216
"CGAGTTACAGAACTCT",0,5,0,0,0,5,41
"CGAGTTACAGCGTATT",0,2,0,0,0,2,57
"CGAGTTAGTCAGGCAA",28,100,134,11,143,416,14864
"CGAGTTAGTGGAACCA",0,0,0,0,0,0,72
"CGAGTTAGTGTTCCAA",2,16,3,0,3,24,380
"CGAGTTATCACCCATC",0,3,0,0,0,3,131
"CGAGTTATCATTGTGG",1,2,3,0,2,8,70
"CGAGTTATCGACATCA",0,2,0,0,0,2,341
"CGAGTTATCTCAGAAC",0,7,3,0,0,10,297
"CGATCGGAGTAGGTTA",1,16,12,0,7,36,1191
"CGATCGGCAATAACCC",106,49,25,4,20,204,5383
"CGATCGGCATGCGTGC",1,8,0,0,4,13,249
"CGATGCGAGCTCCCTT",18,68,158,6,89,339,12367
"CGATGCGCAACGATCT",0,2,0,0,0,2,89
"CGATGCGCATTGGGAG",0,0,0,0,0,0,14
"CGATGCGGTTCCACGG",3,12,2,0,3,20,933
"CGATGCGTCCGCTTAC",1,18,35,0,4,58,1361
"CGATGCGTCTAAGCCA",1,2,0,0,0,3,96
"CGATGCGTCTCCGAGG",0,0,0,0,0,0,25
"CGATGGCAGGAACGAA",0,3,0,0,0,3,14
"CGATGGCGTTCCTTGC",0,0,0,0,0,0,36
"CGATGGCTCAACGAGG",0,2,0,0,2,4,25
"CGATGGCTCACCCTTG",0,6,0,0,2,8,100
"CGATGGCTCTGGGCAC",83,142,33,10,28,296,6798
"CGCAGGTAGCCGCTTG",0,0,0,0,0,0,8
"CGCAGGTAGGGCGAGA",0,0,0,0,0,0,12
"CGCAGGTAGTACAGCG",352,518,138,28,113,1149,36671
"CGCAGGTAGTGCGCTC",221,1994,420,106,381,3122,100044
"CGCAGGTCAGGTAGTG",5,14,0,0,3,22,331
"CGCAGGTCATACCATG",0,6,0,0,2,8,20
"CGCAGGTGTGATCGTT",1,2,0,0,0,3,107
"CGCAGGTTCACTCTTA",0,4,0,0,0,4,8
"CGCAGGTTCTTCTAAC",4,18,6,0,18,46,1534
"CGCATAAAGGATATGT",3,11,3,0,0,17,146
"CGCATAACAAACACCT",12,6,5,0,2,25,168
"CGCATAACAAACCACT",24,276,56,12,38,406,14277
"CGCATAACACAATGTC",5,10,4,0,3,22,510
"CGCATAACATCCAATG",3,14,0,0,2,19,497
"CGCATAAGTAACGATA",13,148,22,6,24,213,7637
"CGCATAAGTCGCCACA",1,6,2,0,3,12,337
"CGCATAATCAAAGGTA",0,2,2,0,0,4,67
"CGCATAATCCACTGAA",2,15,11,0,4,32,397
"CGCATAATCTACACTT",0,11,0,0,2,13,26
"CGCATAATCTCAAAGC",0,0,0,0,0,0,25
"CGCATGGAGAGTCCGA",0,4,0,0,2,6,44
"CGCATGGAGGACATCG",0,0,0,0,0,0,1
"CGCATGGAGGCTTCCG",0,2,0,0,0,2,56
"CGCATGGCAATATCCG",21,104,288,10,32,455,14023
"CGCATGGGTACAGGTG",0,0,0,0,0,0,12
"CGCATGGGTAGGCAAC",0,0,2,0,0,2,62
"CGCATGGTCCGGCTTT",1,11,2,0,2,16,194
"CGCATGGTCGAATGCT",0,8,0,2,2,12,528
"CGCATGGTCTGGCCAG",0,11,3,0,4,18,191
"CGCCAGAAGAAACTGT",0,4,0,0,2,6,96
"CGCCAGAAGCTCGCAC",71,612,156,31,145,1015,32538
"CGCCAGAAGGGAGGAC",0,3,0,0,0,3,25
"CGCCAGAAGGGCGAGA",0,3,0,0,2,5,89
"CGCCAGAGTATCTTCT",0,0,0,0,0,0,42
"CGCCAGAGTCTTGCGG",2,23,3,0,9,37,1030
"CGCCAGAGTGGGACAT",3,13,3,0,3,22,402
"CGCCAGAGTGGTCTAT",0,0,0,0,3,3,49
"CGCCAGAGTTAGGGTG",0,0,0,0,0,0,53
"CGCCAGATCGCTATTT",1,6,2,0,2,11,458
"CGCCATTCACGGCGTT",2,3,0,0,0,5,231
"CGCCATTGTACCGCGT",2,62,6,3,8,81,2557
"CGCCATTGTATCTCGA",0,9,0,0,0,9,433
"CGCCATTGTCAACACT",0,2,0,0,0,2,30
"CGCCATTTCCACTTCG",0,0,0,0,0,0,48
"CGCGTGAAGAAATCCA",1,0,0,0,0,1,27
"CGCGTGAAGCTTGTTG",4,18,4,2,4,32,535
"CGCGTGATCGCCAGTG",0,0,0,0,0,0,24
"CGGAACCAGATCCAAA",1,0,0,0,0,1,48
"CGGAACCCAAAGGCTG",0,0,0,0,0,0,0
"CGGAACCGTACGACAG",3,17,2,0,12,34,1109
"CGGAACCGTAGGGAGG",22,88,44,9,233,396,16086
"CGGAACCGTCACGCTG",7,44,42,4,10,107,2790
"CGGAACCGTCACTACA",2,18,7,0,5,32,744
"CGGAACCGTGCATTAC",0,4,0,0,0,4,31
"CGGAACCGTTCAAGTC",0,0,0,0,0,0,13
"CGGAACCTCACAACCA",1,13,4,0,2,20,253
"CGGAACCTCCTTCAGC",127,616,448,70,803,2064,77381
"CGGAACCTCGCCTATC",0,6,3,0,2,11,347
"CGGAATTAGACTACGG",1,23,4,2,3,33,708
"CGGAATTCAAGCGCTC",0,2,0,0,3,5,76
"CGGAATTCACACCGAC",1,4,2,0,2,9,244
"CGGAATTGTCAGATTC",1,2,2,0,0,5,216
"CGGAATTGTCCTTGTC",0,4,2,0,0,6,69
"CGGAATTGTGCGGATA",1,15,2,0,2,20,259
"CGGACACAGGTTCTAC",142,1427,248,56,237,2110,70383
"CGGACACCAGCGGTCT",0,5,2,0,0,7,211
"CGGACACCAGCTGCCA",0,5,0,0,0,5,189
"CGGACACGTCATAGTC",1,19,5,2,3,30,493
"CGGACACTCACACCGG",17,82,37,9,141,286,10681
"CGGAGAAAGGAGGCAG",2,6,3,0,5,16,362
"CGGAGAACAACGACAG",3,19,6,0,8,36,800
"CGGAGAACACCCTTGT",0,6,0,0,0,6,148
"CGGAGAACATGAGATA",0,0,0,0,0,0,30
"CGGAGAAGTACGGTTT",2,21,4,0,6,33,525
"CGGAGAAGTCTGCCTT",1,7,0,0,0,8,125
"CGGAGAAGTTAATGAG",41,31,11,0,16,99,2588
"CGGAGAAGTTTCCATT",2,22,7,0,6,37,1038
"CGGAGAATCGCTACGG",1,4,0,0,0,5,104
"CGGAGAATCTCTAGGA",4,10,0,0,0,14,223
"CGGCAGTAGCACTCCG",0,3,0,0,0,3,21
"CGGCAGTAGCTCCCTT",111,45,19,3,24,202,5940
"CGGCAGTAGGTGAGCT",0,2,0,0,0,2,6
"CGGCAGTCACGTAGAG",0,0,0,0,0,0,20
"CGGCAGTCAGGCGTTC",0,0,0,0,0,0,72
"CGGCAGTCATGAATCC",0,7,0,0,3,10,269
"CGGCAGTGTGATACTC",1,11,3,0,0,15,259
"CGGCAGTGTTGGCCGT",0,5,0,0,0,5,113
"CGGCAGTTCACGATAC",0,3,2,0,0,5,184
"CGGCAGTTCATCAGTG",3,8,0,0,4,15,212
"CGGCAGTTCGTTCTAT",2,23,14,0,43,82,2866
"CGGCAGTTCTAGACAC",0,11,3,0,3,17,284
"CGGGACTAGCACTAAA",5,36,10,0,9,60,1403
"CGGGACTAGGCGAAGG",28,77,227,8,31,371,14188
"CGGGACTAGTGCACCC",19,78,235,20,53,405,15322
"CGGGACTCATGGAAGC",38,379,100,17,77,611,19110
"CGGGACTCATGGCACC",0,22,7,0,0,29,419
"CGGGACTTCTCAAAGC",10,102,21,0,16,149,5040
"CGGGCATAGAAGTCAT",4,16,2,0,3,25,347
"CGGGCATAGACCGTTT",0,0,0,0,4,4,19
"CGGGCATAGACCTCCG",0,0,0,0,0,0,78
"CGGGCATAGACTCAAA",1,0,2,0,0,3,125
"CGGGCATAGACTTAAG",0,3,3,0,3,9,188
"CGGGCATAGGTCGTCC",19,130,29,172,39,389,11791
"CGGGCATCAACTGATC",0,4,3,0,2,9,158
"CGGGCATTCGGTGTAT",1,3,0,0,0,4,99
"CGGGTCACAAACTAAG",1,2,0,0,0,3,21
"CGGGTCACAAATGGAT",1,2,0,0,0,3,58
"CGGGTCACAACCTATG",1,10,0,0,3,14,298
"CGGGTCACACGCAAAG",47,146,81,51,475,800,24580
"CGGGTCAGTATGATCC",0,0,0,0,0,0,12
"CGGGTCAGTCCGAAGA",0,0,0,0,0,0,74
"CGGGTCAGTGGATACG",0,5,2,0,0,7,137
"CGGGTCAGTGTCCTAA",0,2,0,0,0,2,41
"CGGGTCAGTTTAGAGA",0,8,0,0,5,13,302
"CGGGTCATCAGCTCTC",0,5,4,0,0,9,176
"CGGGTCATCCAGCCTT",1,5,0,0,2,8,74
"CGGGTCATCGCCAGTG",12,213,42,13,32,312,11725
"CGGGTCATCTTCGTAT",0,2,2,3,0,7,69
"CGGGTGTAGAAACTAC",0,4,0,0,0,4,62
"CGGGTGTAGGTTGAGC",1,12,2,0,0,15,284
"CGGGTGTAGTCTCCTC",1,2,0,0,0,3,39
"CGGGTGTCAAGAGAGA",8,38,95,5,12,158,6016
"CGGGTGTGTACAACGG",0,4,0,0,0,4,27
"CGGGTGTGTCAGTTTG",0,2,0,0,0,2,28
"CGGGTGTGTCTAATCG",0,5,0,0,0,5,123
"CGGGTGTGTTTCGTTT",3,24,3,0,4,34,1450
"CGGGTGTTCCGTATGA",4,14,22,2,6,48,1402
"CGGGTGTTCCTGTTAT",1,6,0,0,0,7,27
"CGGGTGTTCTCCGAAA",1,14,0,0,0,15,228
"CGGTCAGAGCATACTC",1,4,0,0,0,5,62
"CGGTCAGAGCTCCACG",1,2,0,0,0,3,98
"CGGTCAGGTAAGGCTG",1,2,0,0,0,3,40
"CGGTCAGGTCTTGTCC",0,4,0,0,0,4,97
"CGGTCAGGTGGCTGCT",0,3,0,0,0,3,122
"CGGTCAGGTTTCAGAC",0,10,3,0,4,17,65
"CGGTCAGTCGCTGACG",55,187,338,26,416,1022,38556
"CGTAAGTAGAAACACT",7,30,19,0,6,62,1475
"CGTAAGTAGACCAACG",0,5,2,0,0,7,220
"CGTAAGTAGAGCAGAA",10,58,139,4,63,274,11110
"CGTAAGTAGATCCTAC",31,56,15,4,16,122,2335
"CGTAAGTCAATCACGT",225,2862,497,104,396,4084,147762
"CGTAAGTCAGCATGCC",0,7,2,0,2,11,416
"CGTAAGTTCCACTAGA",1,4,2,0,0,7,38
"CGTAAGTTCCTTCACG",0,9,0,0,0,9,197
"CGTAAGTTCTACGCAA",1,2,2,0,0,5,130
"CGTAATGAGAAGTCTA",1,4,0,0,0,5,72
"CGTAATGAGGATAATC",1,3,0,0,0,4,110
"CGTAATGGTACCATAC",2,6,0,0,0,8,195
"CGTAATGTCCCAGTGG",2,5,0,0,0,7,403
"CGTAATGTCTGTCTCG",0,12,0,0,0,12,67
"CGTAGTACAGAGATTA",8,33,45,0,10,96,3282
"CGTAGTACAGAGGCAT",0,5,0,0,0,5,93
"CGTAGTACATCGCTCT",4,30,4,0,7,45,1497
"CGTAGTAGTATTTCCT",0,3,2,0,0,5,85
"CGTAGTAGTCATCGCG",2,40,12,2,11,67,1976
"CGTAGTAGTTGCCGCA",0,2,0,0,2,4,184
"CGTAGTAGTTGTTGTG",1,7,2,0,0,10,80
"CGTAGTATCATAGCAC",1,8,2,2,3,16,247
"CGTCAAAAGAAGGCTC",0,2,0,0,0,2,87
"CGTCAAAAGCACACAG",1,49,8,0,7,65,1838
"CGTCAAAAGGGATCAC",0,11,2,0,2,15,110
"CGTCAAAGTGGGTTGA",0,2,2,0,0,4,41
"CGTCAAAGTTCGTTCC",0,0,0,0,0,0,21
"CGTCAAATCACCTTGC",2,0,0,0,0,2,88
"CGTCAAATCACTTCTA",1,11,7,0,2,21,166
"CGTCCATAGGCGATAC",1,0,0,0,0,1,10
"CGTCCATAGGTAGCCA",1,3,0,0,2,6,134
"CGTCCATAGGTATCTC",0,5,0,0,0,5,97
"CGTCCATGTGAAGCGT",1,5,3,0,2,11,183
"CGTCCATTCACCATGA",1,11,5,9,0,26,948
"CGTCCATTCAGTAGGG",0,6,0,0,0,6,210
"CGTGAATAGAGAATCT",1,10,0,0,0,11,197
"CGTGAATAGGCTCCCA",2,9,0,0,0,11,151
"CGTGAATAGGTGGGTT",0,0,0,0,0,0,57
"CGTGAATCAAGAGGCT",2,23,4,2,6,37,1189
"CGTGAATGTAGGCTGA",2,3,2,0,0,7,271
"CGTGAATGTATAGCTC",5,59,11,2,8,85,2626
"CGTGAATGTGCTGTCG",0,0,0,0,0,0,19
"CGTGAATTCACTCACC",0,0,0,0,0,0,64
"CGTGATAAGGAGGTTC",0,8,0,0,2,10,205
"CGTGATACAATGAGCG",0,0,0,0,0,0,15
"CGTGATACACTACACA",6,27,53,0,25,111,3765
"CGTGATATCAGGAACG",0,2,0,0,0,2,137
"CGTGATATCTATCACT",2,15,3,0,3,23,249
"CGTGATATCTGGACTA",1,3,2,0,2,8,30
"CGTGCTTAGACTACCT",0,0,0,0,0,0,35
"CGTGCTTAGGAATGTT",81,441,177,42,503,1244,34968
"CGTGCTTAGGACAGCT",1,0,0,0,0,1,30
"CGTGCTTCAACAAAGT",1,16,4,0,2,23,243
"CGTGCTTCAACAAGAT",0,4,0,0,2,6,47
"CGTGCTTCAACACGAG",0,5,0,0,0,5,114
"CGTGCTTCAACAGCTT",0,2,0,0,0,2,53
"CGTGCTTCAGCTTCCT",0,2,0,0,0,2,8
"CGTGCTTCATGGGAAC",0,5,2,0,2,9,124
"CGTGCTTGTACTGCGC",0,6,0,0,0,6,50
"CGTGCTTGTGGAACCA",0,3,0,0,0,3,75
"CGTGTCTAGAGGTTAT",0,4,0,0,0,4,35
"CGTGTCTAGGAGAGTA",2,41,4,4,8,59,1659
"CGTGTCTCACTCCACT",12,168,31,4,30,245,5057
"CGTGTCTCAGTGCCTG",27,172,82,10,248,539,14556
"CGTGTCTGTGCCGTAC",1,0,0,0,0,1,69
"CGTGTCTGTTCTTCAT",2,2,0,0,2,6,46
"CGTGTCTTCAGCTAGT",2,14,0,0,0,16,434
"CGTGTCTTCCATCTCG",1,0,0,0,0,1,69
"CGTGTCTTCGGTCATA",0,0,0,0,0,0,12
"CGTGTCTTCGTGGTAT",58,61,45,3,24,191,4840
"CGTGTCTTCTAGGAAA",0,5,0,0,2,7,76
"CGTGTCTTCTTTGCAT",1,3,0,0,0,4,50
"CGTTAGAAGTAGCATA",0,0,2,0,2,4,18
"CGTTAGAAGTGTTCCA",2,19,13,0,7,41,1109
"CGTTAGACAACTGAAA",292,365,83,16,78,834,28543
"CGTTAGACATCCAACA",1,2,0,0,2,5,81
"CGTTAGACATGCCGGT",1,6,0,0,3,10,123
"CGTTAGAGTAGATCGG",2,4,0,0,2,8,44
"CGTTAGAGTCCGCAGT",0,0,0,0,0,0,34
"CGTTAGAGTCGCGGTT",0,2,0,0,0,2,31
"CGTTAGATCATCCCGT",5,7,0,0,2,14,645
"CGTTAGATCGAGCTGC",0,14,3,0,4,21,476
"CGTTCTGAGACCACGA",1,17,6,0,6,30,378
"CGTTCTGAGCCTCACG",1,11,0,0,0,12,52
"CGTTCTGAGCCTTGAT",4,29,40,2,10,85,2609
"CGTTCTGCAAGCGATG",0,5,0,0,2,7,335
"CGTTCTGGTCGAAGCA",0,3,12,0,0,15,522
"CGTTCTGTCACATTGG",0,0,0,0,0,0,1
"CGTTCTGTCCAACACA",2,13,4,0,4,23,434
"CGTTGGGAGCACACCC",0,0,0,0,0,0,47
"CGTTGGGAGCGTTAGG",4,28,7,0,4,43,1374
"CGTTGGGAGTCCTGCG",2,8,5,0,0,15,319
"CGTTGGGAGTGTACAA",0,3,0,0,0,3,47
"CGTTGGGAGTTGCATC",3,10,2,0,7,22,392
"CGTTGGGCAACTCCAA",31,231,42,13,46,363,11702
"CGTTGGGCATCCTTCG",37,397,128,17,72,651,24302
"CGTTGGGGTCCATCTC",0,3,3,0,0,6,67
"CGTTGGGGTGAGTTGG",4,58,14,5,13,94,4382
"CGTTGGGGTTCTATCT",0,0,0,0,2,2,43
"CGTTGGGTCCGAGAAG",0,0,0,0,0,0,54
"CGTTGGGTCTCAATCT",1,12,0,0,2,15,343
"CGTTGGGTCTCGACGG",51,376,99,33,144,703,25038
"CTAACCCAGGAGCTGT",1,14,3,0,10,28,494
"CTAACCCAGTGTACAA",1,0,0,0,0,1,66
"CTAACCCCAACAAAGT",0,7,2,0,3,12,183
"CTAACCCCACCTATCC",1,7,0,0,3,11,236
"CTAACCCCACGTAGAG",9,50,125,3,21,208,8721
"CTAACCCGTATGTCCA",14,54,30,6,123,227,9796
"CTAACCCGTGTCTAAC",1,11,4,0,0,16,476
"CTAACCCTCCTTCGAC",1,2,0,0,0,3,74
"CTAACCCTCGTAGGGA",0,2,2,0,12,16,662
"CTAACTTAGCCTCATA",1,4,0,0,0,5,41
"CTAACTTAGTCGCCAC",0,0,0,0,0,0,40
"CTAACTTCACACCGAC",0,3,0,0,0,3,36
"CTAACTTTCTATTCGT",1,4,0,0,2,7,89
"CTAACTTTCTCAGTCC",0,3,0,0,2,5,314
"CTAACTTTCTCGAGTA",1,3,2,0,0,6,61
"CTAAGTGAGGACAGCT",1,3,3,0,0,7,56
"CTAAGTGAGGGAGGTG",2,7,4,4,0,17,285
"CTAAGTGAGGTTCATC",0,6,2,0,2,10,87
"CTAAGTGCAACGGCTC",2,13,6,0,3,24,395
"CTAAGTGGTTTCGTGA",0,5,0,0,2,7,128
"CTAAGTGTCACGGGCT",63,627,124,31,110,955,33607
"CTAAGTGTCATCACAG",0,6,0,0,0,6,56
"CTAAGTGTCTCCCTAG",0,5,0,0,2,7,164
"CTACAGAAGAGAAGGT",0,0,0,0,0,0,8
"CTACAGAAGGGTTGCA",4,70,26,4,121,225,8777
"CTACAGAAGTCCGTCG",0,2,0,0,0,2,5
"CTACAGACAAAGGAGA",2,15,5,0,4,26,287
"CTACAGACAACAGTGG",1,6,0,0,0,7,50
"CTACAGAGTTAACCTG",0,2,0,0,0,2,61
"CTACAGATCCTAGAGT",1,21,6,0,3,31,187
"CTACAGATCGCATTAG",0,4,0,0,0,4,113
"CTACAGATCGCGTGCA",75,836,190,46,128,1275,54162
"CTACAGATCGGAAGGT",1,3,2,0,0,6,51
"CTACATTAGACAACTA",81,582,177,43,147,1030,36943
"CTACATTCAGACCAAG",2,15,4,0,8,29,460
"CTACATTGTATCGATC",0,3,2,0,0,5,174
"CTACATTGTCGTGGAA",0,15,0,0,4,19,398
"CTACATTGTGTGCCTG",26,116,114,12,191,459,18148
"CTACATTTCCAAGCAT",2,13,6,0,2,23,452
"CTACATTTCCCGAACG",3,6,0,0,0,9,94
"CTACATTTCGCTAAAC",0,0,2,0,0,2,52
"CTACCCAAGAGGCCAT",3,10,2,0,4,19,391
"CTACCCAAGTACAACA",20,41,6,2,7,76,2229
"CTACCCACACTTGTCC",0,2,0,0,0,2,6
"CTACCCACAGTAACAA",0,7,3,0,3,13,139
"CTACCCAGTATGTCCA",0,10,8,0,5,23,645
"CTACCCAGTCACTCGG",0,0,0,0,0,0,22
"CTACCCAGTTGCATGT",3,8,2,0,7,20,482
"CTACCCATCACATACG",0,2,0,0,3,5,110
"CTACCCATCACGTAGT",0,8,0,0,0,8,28
"CTACCCATCATGGCCG",3,16,5,0,9,33,815
"CTACCCATCCCTCTCC",0,0,0,0,0,0,1
"CTACCCATCCGACAGC",0,0,0,0,0,0,30
"CTACCCATCGAGAAAT",12,126,23,2,20,183,7350
"CTACCCATCTCCAATT",3,2,3,0,3,11,182
"CTACCTGAGAGCAGAA",5,20,10,3,39,77,2176
"CTACCTGAGGGCTTCC",1,12,9,3,39,64,1925
"CTACCTGAGGTAGTCG",3,9,2,0,3,17,365
"CTACCTGCATTCCTCG",1,3,0,0,0,4,19
"CTACCTGTCCAGTACA",0,3,2,0,0,5,198
"CTACGGGAGCCATTGT",0,0,0,0,0,0,26
"CTACGGGAGCCTCTGG",24,219,33,11,35,322,12408
"CTACGGGAGTCATGAA",0,4,0,0,0,4,93
"CTACGGGCAACCTAAC",1,11,2,0,2,16,502
"CTACGGGGTCATATGC",1,8,2,0,3,14,401
"CTACGGGGTCTGTGTA",0,2,0,0,0,2,69
"CTACGGGTCAAGGAGC",1,12,4,0,3,20,252
"CTACGGGTCGGCCTTT",0,0,0,0,0,0,49
"CTACTATAGACGTCCC",0,0,0,0,0,0,96
"CTACTATAGCGCACAA",1,2,0,0,0,3,88
"CTACTATAGGGTTTCT",0,5,0,0,0,5,97
"CTACTATAGTAGACCG",0,0,0,0,0,0,70
"CTACTATCAATCCTTT",17,203,43,11,28,302,12199
"CTACTATGTCACCGCA",1,14,4,0,4,23,532
"CTACTATGTCGCCTAG",10,43,89,10,50,202,8425
"CTACTATGTGACCGAA",68,595,112,36,110,921,33728
"CTACTATGTGAGCCAA",115,1193,238,67,201,1814,74096
"CTACTATTCGCTATTT",0,0,0,0,0,0,0
"CTAGACAAGAATCGCG",0,0,0,0,0,0,100
"CTAGACAAGATGACCG",0,0,0,0,0,0,237
"CTAGACAAGCAGCAGT",6,28,35,2,22,93,3817
"CTAGACAAGTTGCGAG",4,11,19,0,4,38,1360
"CTAGACACAGAGTAAT",1,6,3,0,0,10,226
"CTAGACACAGCGTATT",96,579,181,78,126,1060,38724
"CTAGACAGTACTAACC",14,52,99,5,19,189,7246
"CTAGACAGTATACCTG",2,5,0,0,3,10,195
"CTAGACAGTTTCCAAG",1,8,3,0,3,15,256
"CTAGACATCACGGTCG",0,0,0,0,0,0,32
"CTAGGTAAGATTACCC",1,2,0,0,0,3,69
"CTAGGTAAGCCTGGAA",0,4,2,0,3,9,163
"CTAGGTAAGCGAGGAG",2,4,0,0,0,6,158
"CTAGGTAAGGTAAACT",10,43,9,3,5,70,2310
"CTAGGTAAGTCTTGGT",3,7,3,0,2,15,265
"CTAGGTACAAAGCTAA",3,17,5,0,7,32,377
"CTAGGTACACACAGAG",0,3,0,0,0,3,91
"CTAGGTACAGCTCTGG",2,18,3,6,3,32,1201
"CTAGGTAGTCTGCATA",0,0,0,0,0,0,0
"CTAGGTATCCGATGTA",1,2,2,0,0,5,55
"CTAGGTATCTCTGGTC",3,13,3,5,4,28,476
"CTAGGTATCTGTGCTC",0,19,2,0,2,23,341
"CTATAGGCAGATTTCG",0,6,0,0,0,6,149
"CTATAGGGTCTATGAC",0,15,2,0,2,19,319
"CTATAGGTCCCATTTA",1,4,0,0,0,5,87
"CTATAGGTCCGACGGT",0,0,0,0,0,0,1
"CTATAGGTCGAATGCT",0,9,3,0,0,12,412
"CTATCCGAGCTAAATG",0,0,0,0,0,0,20
"CTATCCGAGTTAGTGA",0,2,0,0,0,2,37
"CTATCCGCAAATTGGA",0,3,0,0,0,3,70
"CTATCCGGTAGGGTAC",3,7,4,0,5,19,508
"CTATCCGGTCTACAGT",0,0,0,0,0,0,28
"CTATCCGGTTGCTCCT",0,4,2,0,0,6,117
"CTATCCGTCAACACGT",3,15,2,0,6,26,404
"CTATCCGTCATCCTAT",1,9,3,0,0,13,309
"CTATCCGTCATTCTTG",2,9,4,0,5,20,534
"CTATCCGTCGTGACTA",0,5,0,0,0,5,48
"CTATCCGTCTCTTGCG",1,5,0,0,3,9,215
"CTATCTAAGGTTCTTG",0,9,4,0,3,16,232
"CTATCTAGTGACTAAA",1,7,0,0,0,8,160
"CTCAACCAGCATCCTA",1,6,0,0,3,10,211
"CTCAACCAGCGTGAAC",0,0,0,0,0,0,1
"CTCAACCAGGCCTAGA",19,107,78,5,37,246,8662
"CTCAACCAGGTCATTC",0,2,0,0,0,2,45
"CTCAACCAGTCGAAAT",2,14,2,0,0,18,433
"CTCAACCCACAGTGAG",1,17,4,0,3,25,335
"CTCAACCCACGATTCA",74,31,12,2,15,134,4376
"CTCAACCCACTCTGCT",1,13,5,0,8,27,715
"CTCAACCCAGTCTGGC",15,15,2,3,2,37,1139
"CTCAACCGTCGTGGAA",0,2,0,0,0,2,71
"CTCAACCGTCTTTCAT",3,17,39,2,7,68,2877
"CTCAACCTCGAGTACT",2,6,6,0,6,20,300
"CTCAAGAAGAGTGGCT",0,0,0,0,0,0,66
"CTCAAGAAGGGCTGAT",1,0,0,0,2,3,90
"CTCAAGAAGTATGAAC",0,4,0,0,0,4,128
"CTCAAGAAGTCATTGC",4,23,27,3,5,62,2341
"CTCAAGACAACGGGTA",293,1042,875,143,2217,4570,153897
"CTCAAGAGTCTTCATT",2,19,0,0,4,25,351
"CTCAAGAGTTCACCGG",0,0,0,0,0,0,43
"CTCAAGATCACCTCAC",0,7,0,0,0,7,118
"CTCAAGATCATTGCCC",0,0,0,0,0,0,21
"CTCAATTAGTCAACAA",0,2,0,0,0,2,31
"CTCAATTAGTGTCATC",9,30,43,3,31,116,4884
"CTCAATTAGTTCCGTA",6,26,63,4,16,115,4386
"CTCAATTCACGACGTC",0,4,0,0,2,6,104
"CTCAATTCAGAGGAAA",0,0,0,0,0,0,17
"CTCAATTGTCGATGCC",1,12,8,0,2,23,649
"CTCAATTTCAGCTTCC",6,48,7,2,9,72,2300
"CTCAATTTCGTCGCTT",1,4,0,0,2,7,99
"CTCAATTTCGTGGGAA",0,6,0,0,0,6,114
"CTCAATTTCTCATAGG",1,0,0,0,0,1,87
"CTCACTGAGAACGTGC",0,0,0,0,0,0,41
"CTCACTGAGAGTTCGG",0,0,0,0,0,0,116
"CTCACTGAGTCAGAGC",0,0,2,0,0,2,77
"CTCACTGAGTCCCTAA",228,297,77,24,63,689,21072
"CTCACTGCAACCGCTG",0,2,0,0,0,2,6
"CTCACTGTCCTTCAGC",2,10,2,0,4,18,232
"CTCAGAAAGACAAGCC",1,4,0,0,0,5,48
"CTCAGAAAGGGCAACT",33,142,52,8,43,278,8490
"CTCAGAACACCAGCGT",1,3,0,0,0,4,138
"CTCAGAAGTACCGTGC",0,9,5,2,5,21,88
"CTCAGAAGTATGGGAC",4,18,6,2,6,36,403
"CTCAGAAGTCGAGCTC",0,8,3,0,0,11,201
"CTCAGAAGTGGTCAAG",0,0,0,0,0,0,77
"CTCAGAAGTTCTATCT",0,0,0,0,0,0,40
"CTCAGAATCAATCTCT",1,2,0,0,0,3,80
"CTCAGAATCCACATAG",1,0,0,0,0,1,73
"CTCAGGGAGGTTGAGC",2,4,3,0,0,9,13
"CTCAGGGCAACAGATA",0,0,0,0,2,2,48
"CTCAGGGCAAGCGCTC",0,9,2,0,0,11,12
"CTCAGGGCATCCTTGC",3,33,5,0,4,45,1865
"CTCAGGGGTTAGAAGT",9,76,12,4,17,118,4063
"CTCAGGGTCTTTCCAA",0,4,0,0,0,4,11
"CTCAGTCAGAAATGGG",1,7,0,0,0,8,230
"CTCAGTCAGTCTAGCT",0,3,0,0,0,3,156
"CTCAGTCAGTTGCCTA",0,0,0,0,0,0,168
"CTCAGTCCACCGTCGA",2,31,5,4,6,48,1297
"CTCAGTCGTACCTAGT",3,33,8,4,7,55,1757
"CTCAGTCGTGAATTAG",6,27,12,0,48,93,2581
"CTCAGTCGTTTGACAC",0,3,0,0,2,5,53
"CTCAGTCTCAGCGCAC",0,3,0,0,0,3,104
"CTCAGTCTCCATTCAT",0,10,2,0,2,14,74
"CTCAGTCTCGAGTACT",0,0,0,0,2,2,34
"CTCAGTCTCGGCATAT",1,5,2,0,2,10,193
"CTCATCGAGAATTGTG",0,20,2,2,3,27,400
"CTCATCGAGCACTCGC",0,6,4,0,5,15,364
"CTCATCGAGGTTTACC",0,4,0,0,0,4,109
"CTCATCGAGTAATTGG",0,0,0,0,0,0,29
"CTCATCGCAAGTAGTA",1,2,0,0,0,3,72
"CTCATCGGTAACGATA",2,19,10,0,2,33,538
"CTCATCGGTCGATGCC",1,0,0,0,0,1,114
"CTCATCGGTTCCTAAG",1,4,3,0,0,8,73
"CTCATCGTCGACATAC",0,5,2,0,0,7,342
"CTCATGCAGACAAGCC",2,0,0,0,0,2,45
"CTCATGCAGGAGCAAA",2,3,0,0,0,5,39
"CTCATGCCAACTTGCA",0,0,0,0,0,0,54
"CTCATGCCACCTGCTT",2,23,12,0,31,68,2860
"CTCATGCGTGACCGAA",0,0,0,0,0,0,97
"CTCATGCGTGGACAGT",1,0,2,0,0,3,12
"CTCATGCGTTATTCTC",1,10,0,0,0,11,146
"CTCATGCTCGTAACTG",0,0,0,0,0,0,119
"CTCATTAAGACTCTTG",0,18,2,0,2,22,408
"CTCATTAAGTGCCCGT",0,0,2,0,0,2,72
"CTCATTACAGTAACCT",1,2,0,0,0,3,58
"CTCATTACATCCGGCA",0,6,0,0,2,8,404
"CTCATTAGTACTGAGG",0,0,0,0,0,0,8
"CTCATTAGTCGCATGC",5,20,3,3,27,58,1314
"CTCATTAGTTGTCAGT",3,37,4,15,6,65,1606
"CTCATTATCTTTGCAT",1,5,2,0,3,11,102
"CTCCAACCAAATGCTC",0,7,0,0,3,10,118
"CTCCAACCAATAACCC",0,0,0,0,0,0,18
"CTCCAACGTACTGCGC",0,8,0,0,4,12,416
"CTCCAACGTATACGGG",1,0,0,0,0,1,33
"CTCCAACGTCGCATTA",0,4,0,0,0,4,186
"CTCCAACTCAAACTGC",0,0,0,0,2,2,5
"CTCCAACTCATACGAC",1,0,0,0,0,1,20
"CTCCAACTCGGTGTTA",1,11,5,0,3,20,460
"CTCCAACTCTAGGCCG",0,2,2,0,0,4,85
"CTCCACAAGAGGGTCT",1,3,0,0,2,6,139
"CTCCACAAGCCGAACA",2,4,2,0,0,8,128
"CTCCACAAGGACACTG",72,689,119,27,190,1097,45813
"CTCCACAGTACAGGTG",0,2,0,0,0,2,131
"CTCCACATCAAAGCCT",0,2,0,0,2,4,91
"CTCCACATCCTCACCA",1,2,0,0,0,3,134
"CTCCACATCCTTGACC",0,0,0,0,0,0,50
"CTCCATGAGCAAATGT",0,2,0,0,2,4,20
"CTCCATGAGCACTCCG",1,18,0,0,0,19,341
"CTCCATGAGCCATCCG",18,62,151,9,37,277,11250
"CTCCATGAGGTTGACG",0,0,0,0,0,0,123
"CTCCATGAGTACAACA",3,21,19,2,9,54,1197
"CTCCATGAGTATCCTG",4,22,5,2,8,41,641
"CTCCATGCACGGAAGT",1,0,0,0,0,1,60
"CTCCATGGTGTATTGC",1,0,0,0,0,1,50
"CTCCATGTCAAAGCCT",0,0,0,0,3,3,41
"CTCCATGTCATTGGTG",0,0,0,0,0,0,14
"CTCCATGTCCCAGTGG",0,6,3,0,3,12,88
"CTCCATGTCGATGGAG",2,4,0,0,0,6,76
"CTCCATGTCGCTACGG",3,17,17,3,6,46,1096
"CTCCATGTCGTGCACG",2,20,2,0,2,26,481
"CTCCCAAAGGTAGCAC",0,0,0,0,0,0,2
"CTCCCAAAGTGTAGAT",1,3,0,0,2,6,104
"CTCCCAACACCGTCTT",2,6,0,0,2,10,314
"CTCCCAACACTCCCTA",3,42,6,0,10,61,2366
"CTCCCAACACTGCTTC",1,3,0,0,0,4,81
"CTCCCAACATACATCG",11,142,25,5,29,212,6402
"CTCCCAAGTCCAAAGG",0,2,4,0,0,6,249
"CTCCCAAGTGGAACAC",13,62,64,5,69,213,6717
"CTCCCAAGTTCAGGTT",39,129,251,21,164,604,23461
"CTCCCTCAGATTGACA",1,4,0,0,0,5,117
"CTCCCTCAGGAGGGTG",0,0,0,0,0,0,32
"CTCCCTCCACTAGAGG",0,3,0,0,0,3,128
"CTCCCTCCAGTTGTTG",1,12,4,0,6,23,409
"CTCCCTCGTCCCGTGA",3,39,16,2,7,67,1308
"CTCCCTCGTCTGTGGC",0,7,0,3,3,13,257
"CTCCCTCGTGAATTAG",1,0,3,0,0,4,79
"CTCCCTCGTGTCATGT",63,709,162,27,125,1086,40555
"CTCCCTCGTGTTAACC",1,15,2,0,4,22,516
"CTCCCTCGTGTTGAGG",0,0,0,0,0,0,31
"CTCCCTCGTTGCATTG",29,149,40,38,47,303,9725
"CTCCCTCTCCCAATAG",2,20,22,4,14,62,1754
"CTCCCTCTCTCTCAAT",1,20,8,5,23,57,1697
"CTCCGATCAACTGTGT",10,100,19,3,17,149,5785
"CTCCGATCACACCGAC",8,3,2,0,0,13,513
"CTCCGATGTCGAACAG",0,2,3,0,0,5,64
"CTCCGATGTGCTGTCG",2,5,0,0,0,7,64
"CTCCGATGTGTCCATA",1,3,0,0,0,4,19
"CTCCGATGTGTGTTTG",0,2,0,0,0,2,136
"CTCCGATTCCGCAGTG",0,12,5,0,3,20,490
"CTCCGATTCCTTCTGG",7,40,9,4,12,72,2629
"CTCCTCCAGCTCCACG",0,0,0,0,0,0,69
"CTCCTCCAGGTTAAAC",1,10,4,2,5,22,60
"CTCCTCCCAGTAGTTC",0,0,0,0,0,0,9
"CTCCTCCCAGTCAGTT",39,407,88,90,66,690,21603
"CTCCTCCGTAGGACCA",0,2,0,0,0,2,76
"CTCCTCCGTATCACCA",0,0,2,0,0,2,112
"CTCCTCCGTATGGAAT",1,15,4,0,6,26,470
"CTCCTCCGTCCGAAAG",0,2,2,0,2,6,25
"CTCCTCCGTGTCTTAG",3,15,2,0,3,23,772
"CTCCTCCGTGTGACCC",362,163,50,15,54,644,17202
"CTCCTTTAGAGTGAAG",1,9,0,0,0,10,87
"CTCCTTTCAAGTGCAG",9,131,28,9,29,206,7998
"CTCCTTTCAGTGCCTG",0,6,0,0,0,6,341
"CTCCTTTGTCAGGAGT",0,0,3,0,0,3,78
"CTCCTTTTCGGTGCAC",0,3,0,0,0,3,33
"CTCCTTTTCTCCATAT",3,18,0,0,9,30,661
"CTCGAGGAGACGAAGA",1,0,0,0,0,1,9
"CTCGAGGGTAACATCC",0,2,0,0,0,2,101
"CTCGAGGGTGGCAACA",1,3,0,0,0,4,83
"CTCGAGGTCTATCGGA",0,0,0,0,0,0,27
"CTCTCAGAGGTACATA",1,5,2,0,2,10,87
"CTCTCAGGTTTAGTCG",1,10,0,0,0,11,187
"CTCTCAGGTTTCAGAC",0,12,0,0,0,12,650
"CTCTCAGTCACCCTCA",0,5,0,0,3,8,204
"CTCTCGAAGTACCATC",1,10,3,0,6,20,375
"CTCTCGACACGACGTC",3,6,2,0,2,13,387
"CTCTCGACATAGGTAA",0,0,0,0,0,0,7
"CTCTCGAGTACGATCT",0,6,0,0,2,8,92
"CTCTCGATCCAACTGA",0,0,0,0,0,0,17
"CTCTCGATCGCGGACT",11,42,125,5,24,207,9333
"CTCTCGATCTTGAACG",0,0,0,0,0,0,10
"CTCTGGTCATTGCAAC",17,60,34,9,131,251,8613
"CTCTGGTTCAAGCTTG",4,47,6,2,6,65,1963
"CTCTGGTTCGAACACT",0,4,0,0,0,4,115
"CTCTGGTTCGGACAAG",3,21,3,0,3,30,370
"CTCTGGTTCTTACTGT",0,7,0,0,0,7,132
"CTGAATGAGAATTGCA",3,5,0,0,2,10,67
"CTGAATGAGATTGATG",0,4,0,0,0,4,123
"CTGAATGAGTGAGCCA",1,6,0,0,0,7,86
"CTGAATGCAAACCACT",0,4,0,0,0,4,70
"CTGAATGCAACAAGAT",0,0,0,0,0,0,48
"CTGAATGCAAGTTCGT",0,4,0,0,16,20,816
"CTGAATGCAGTCAACT",0,4,0,0,0,4,77
"CTGAATGCATTGAAGA",6,24,50,4,14,98,3232
"CTGAATGGTATGTCTG",0,5,0,0,0,5,69
"CTGAATGTCAGGTGTT",0,0,0,0,0,0,4
"CTGAATGTCATTTGCT",1,2,0,0,0,3,40
"CTGAATGTCCACTGAA",45,491,89,16,89,730,27251
"CTGAATGTCCCTGGTT",0,0,0,0,0,0,7
"CTGAATGTCGCGTGAC",0,0,0,0,0,0,13
"CTGAATGTCGCGTTTC",0,8,5,0,5,18,596
"CTGAATGTCGGTTCAA",0,3,0,0,2,5,67
"CTGAGCGAGAGAGCCT",0,0,0,0,0,0,44
"CTGAGCGAGCGCTGAA",5,7,4,0,5,21,135
"CTGAGCGAGGACAAGA",0,12,3,0,0,15,400
"CTGAGCGAGGTCGAGT",1,0,0,0,0,1,119
"CTGAGCGAGTGCTCAT",0,3,0,0,0,3,71
"CTGAGCGCACCACATA",0,17,3,0,2,22,365
"CTGAGCGCAGGGCTTC",0,0,0,0,0,0,34
"CTGAGCGGTCGAGCTC",0,4,0,0,0,4,51
"CTGAGCGGTGTCTCCT",0,6,3,0,3,12,81
"CTGAGCGTCCGAGATT",0,0,0,0,0,0,19
"CTGAGGCAGCCTTCTC",1,4,4,0,4,13,438
"CTGAGGCAGCGCCTCA",3,11,2,0,3,19,575
"CTGAGGCAGTGGCGAT",0,0,0,0,0,0,33
"CTGAGGCCACTCTCGT",0,0,0,0,0,0,7
"CTGAGGCGTCCAAGAG",0,2,0,0,0,2,75
"CTGAGGCGTTTCGTGA",1,3,3,0,0,7,20
"CTGAGGCTCCACCTGT",0,0,0,0,0,0,20
"CTGAGGCTCGCCAATA",1,2,0,0,0,3,62
"CTGAGGCTCTAGACAC",1,2,0,0,0,3,167
"CTGATCCAGTTCCAGT",1,3,0,0,2,6,126
"CTGATCCCAGCTGTCG",1,10,2,0,3,16,358
"CTGATCCCAGTTAGAA",12,56,84,4,21,177,6278
"CTGATCCCATACAGAA",2,18,6,0,6,32,415
"CTGATCCGTGACAGCA",1,9,0,0,0,10,105
"CTGCAGGAGCGACCCT",0,4,2,0,0,6,176
"CTGCAGGAGCTTTGTG",10,90,33,4,15,152,5171
"CTGCAGGGTGAACGGT",0,3,0,0,0,3,110
"CTGCAGGGTGCTCTTC",3,9,2,0,2,16,646
"CTGCAGGGTGTGAGCA",1,0,0,0,0,1,10
"CTGCAGGTCAAATGAG",0,3,0,0,0,3,8
"CTGCAGGTCCATTGGA",13,23,50,5,22,113,3466
"CTGCAGGTCCGTACGG",0,4,0,0,0,4,139
"CTGCAGGTCTTTCCAA",1,13,6,0,2,22,338
"CTGCATCAGAGTCTTC",6,19,29,2,7,63,1448
"CTGCATCCAAGCACCC",0,0,0,0,0,0,102
"CTGCATCCAGCACCCA",0,0,0,0,0,0,18
"CTGCATCGTCGTGGTC",0,0,0,0,0,0,14
"CTGCATCTCGCATTAG",3,18,5,0,2,28,884
"CTGCATCTCTAAGGAA",0,2,0,0,0,2,35
"CTGCCATAGCCAGAGT",134,1386,234,65,222,2041,61578
"CTGCCATAGCTGAGCA",0,0,0,0,2,2,5
"CTGCCATAGGGACAGG",0,2,2,0,0,4,301
"CTGCCATAGTAGAATC",0,0,0,0,0,0,9
"CTGCCATAGTGCTCGC",5,30,8,6,11,60,1255
"CTGCCATGTTGTGTAC",0,3,0,0,0,3,65
"CTGCCATTCACCTCAC",2,10,2,0,14,28,950
"CTGCCATTCTAGTCAG",1,0,0,0,2,3,55
"CTGCCTAAGATTCGCT",0,2,0,0,0,2,92
"CTGCCTAAGCGTGAAC",2,14,0,0,0,16,321
"CTGCCTAAGGGAGATA",2,18,5,0,7,32,589
"CTGCCTACACCCTGTT",10,29,38,0,8,85,2522
"CTGCCTACATCCTTGC",103,1284,185,43,161,1776,64636
"CTGCCTAGTCTTCGAA",0,0,0,0,0,0,2
"CTGCCTAGTGTTAACC",2,4,0,0,0,6,21
"CTGCCTAGTTATTCCT",4,9,0,0,0,13,169
"CTGCCTAGTTCATCTT",5,29,55,5,14,108,3286
"CTGCCTATCCTCTCGA",0,11,5,0,0,16,459
"CTGCGAGAGCTCACTA",14,64,166,5,32,281,12882
"CTGCGAGAGTAAAGCT",0,0,0,0,2,2,28
"CTGCGAGGTGCAAGAC",0,0,0,0,0,0,14
"CTGCGAGGTGTCCAAT",48,44,13,6,20,131,4203
"CTGCGAGTCAGATGCT",2,4,2,0,0,8,82
"CTGCTCAAGAATAACC",6,66,15,4,14,105,3250
"CTGCTCAAGCGATTCT",0,6,0,0,0,6,88
"CTGCTCAAGCGTATGG",88,198,54,9,35,384,14061
"CTGCTCAAGGCATGGT",0,0,0,0,0,0,36
"CTGCTCAAGTAGGAAG",0,3,0,0,0,3,19
"CTGCTCACACGTAACT",4,16,15,0,9,44,1184
"CTGCTCACAGTTTCAG",0,2,0,0,0,2,47
"CTGCTCAGTAGCGTCC",0,9,0,0,0,9,243
"CTGCTCAGTGCACATT",2,5,2,0,2,11,269
"CTGCTCATCCTAGCGG",1,0,0,0,0,1,83
"CTGCTCATCGTTGCCT",1,0,3,0,0,4,120
"CTGCTCATCTCAGTCC",4,4,0,0,0,8,78
"CTGCTCATCTTACCGC",0,0,0,0,0,0,48
"CTGGACGAGACTGTTC",1,5,0,0,0,6,67
"CTGGACGAGCCGGAAT",0,4,3,0,6,13,282
"CTGGACGGTACCCGCA",107,539,111,32,114,903,29116
"CTGGACGGTGGCAGAT",0,7,0,0,0,7,150
"CTGGACGTCATTTGGG",225,151,77,13,55,521,19908
"CTGGACGTCCCGAACG",0,3,0,0,0,3,25
"CTGGACGTCTAGTGAC",0,2,0,0,0,2,71
"CTGGCAGAGATGAAGG",0,4,0,0,0,4,58
"CTGGCAGAGATGCAGC",0,0,0,0,0,0,37
"CTGGCAGAGCTCCGAC",0,3,0,0,0,3,50
"CTGGCAGCAAGGTTGG",3,10,3,0,0,16,274
"CTGGCAGCAGAGATTA",0,3,2,2,0,7,86
"CTGGCAGGTACAGAAT",1,8,2,0,3,14,175
"CTGGCAGGTCAGTCCG",0,3,0,0,0,3,51
"CTGGCAGGTCTCAGAT",0,0,0,0,0,0,117
"CTGGCAGGTGCGGATA",0,23,7,0,3,33,658
"CTGGCAGTCAAATAGG",2,8,0,0,0,10,53
"CTGGCAGTCAGCTCTC",1,3,0,0,0,4,125
"CTGGCAGTCCCTCTCC",0,0,0,0,0,0,30
"CTGGCAGTCGATCCAA",0,3,3,0,0,6,149
"CTGGTCTAGACATAAC",3,37,7,0,6,53,1539
"CTGGTCTAGACCATGG",65,136,38,12,34,285,9747
"CTGGTCTAGGCAGGTT",5,7,4,2,4,22,397
"CTGGTCTAGGCTCAAG",3,11,0,0,3,17,399
"CTGGTCTCAAGTGCTT",2,35,6,0,4,47,1595
"CTGGTCTCAGACCATT",0,12,2,0,2,16,31
"CTGGTCTGTCCTCCAT",1,13,0,0,0,14,630
"CTGGTCTGTCGTCAGC",2,3,0,0,0,5,123
"CTGGTCTGTTCGGGTC",0,0,0,0,0,0,0
"CTGGTCTTCCGATTAG",0,3,0,0,0,3,113
"CTGGTCTTCCGTGTGG",6,14,4,0,3,27,958
"CTGTACCAGATAACAC",2,25,5,2,7,41,716
"CTGTACCCAACAGTGG",1,22,6,0,8,37,1351
"CTGTACCCAAGTGGGT",2,12,14,2,7,37,944
"CTGTACCGTCTGTTAG",7,25,42,5,11,90,3769
"CTGTACCGTGCAGATG",0,2,0,0,0,2,74
"CTGTACCTCAATGTCG",0,4,0,0,0,4,134
"CTGTACCTCGAGAAGC",0,2,2,0,0,4,65
"CTGTACCTCGTAGTCA",1,9,2,0,0,12,146
"CTGTAGAAGAGAGGGC",15,144,29,6,31,225,7728
"CTGTAGAAGCATGTTC",2,3,0,0,0,5,131
"CTGTAGAAGTAAGACT",4,23,5,3,6,41,63
"CTGTAGACAGCGCGTT",0,8,4,0,3,15,235
"CTGTAGAGTCCACGCA",0,2,0,0,0,2,53
"CTGTAGAGTCTTTCAT",0,3,0,0,2,5,96
"CTGTAGAGTGGATGAC",6,21,35,2,8,72,2345
"CTGTAGATCCAGCCTT",1,13,4,0,8,26,506
"CTGTAGATCGACACTA",30,309,44,14,59,456,18239
"CTGTATTAGAAGGGAT",0,2,0,0,0,2,54
"CTGTATTAGACACACG",0,0,0,0,0,0,5
"CTGTATTAGCTAGAGC",0,5,0,4,0,9,387
"CTGTATTAGGGTACAC",0,0,0,0,0,0,3
"CTGTATTAGGTGATAT",0,2,2,0,0,4,26
"CTGTCGTAGTCATACC",0,0,0,0,0,0,2
"CTGTCGTAGTTGCTCA",1,17,23,0,2,43,1785
"CTGTCGTCAAAGGAGA",9,32,84,2,13,140,4906
"CTGTCGTCACTAGGCC",1,2,0,0,0,3,54
"CTGTCGTCAGGCAATG",0,2,0,0,4,6,65
"CTGTCGTCAGGCACAA",3,14,21,3,8,49,1740
"CTGTCGTCATGGAGAC",49,184,140,511,80,964,28746
"CTGTCGTGTCAAGCCC",0,0,0,0,0,0,11
"CTGTCGTGTGTAGCAG",0,2,0,0,0,2,11
"CTGTCGTTCATTTGTC",0,2,0,0,0,2,32
"CTGTGAAAGCACTCCG",0,0,0,0,0,0,64
"CTGTGAAAGTGGCGAT",1,20,4,2,2,29,1151
"CTGTGAACACGCCACA",0,0,3,0,2,5,113
"CTGTGAACATGGTACT",4,16,4,2,5,31,392
"CTGTGAAGTGCACATT",4,8,9,0,4,25,318
"CTGTGAAGTGTTGACT",0,2,2,0,0,4,230
"CTGTGAATCCCATACC",0,0,0,0,3,3,118
"CTGTGAATCTTACACT",0,6,4,0,2,12,76
"CTGTGGGCAAGGCGTA",0,2,0,0,0,2,53
"CTGTGGGGTCCTGTCT",1,24,7,0,10,42,1407
"CTGTGGGGTGGACCAA",0,3,0,0,0,3,86
"CTGTGGGTCAGGTGTT",0,7,0,0,0,7,50
"CTGTGGGTCGTGGGTC",4,11,4,0,0,19,330
"CTTACCGAGAGATTCA",0,0,0,0,4,4,48
"CTTACCGAGCAAACAT",60,468,153,32,101,814,27320
"CTTACCGAGTTCTACG",1,14,5,0,3,23,577
"CTTACCGCAAATCGGG",1,0,0,0,2,3,67
"CTTACCGCAAGCGCAA",0,0,0,0,0,0,179
"CTTACCGCATAGATCC",1,0,0,0,0,1,20
"CTTACCGCATGGGCAA",2,15,6,0,22,45,2164
"CTTACCGGTATTGCCA",0,4,0,0,0,4,67
"CTTACCGGTCTTTCAT",3,24,8,0,7,42,2028
"CTTACCGGTGATGTAA",0,0,0,0,0,0,49
"CTTACCGGTTCTCGTC",0,2,0,0,0,2,86
"CTTAGGAAGATGGCGT",75,269,146,34,712,1236,36826
"CTTAGGAAGGATGCGT",20,78,185,7,29,319,14653
"CTTAGGAAGGGATCAC",13,55,122,4,22,216,8648
"CTTAGGACACTGTGAT",2,2,2,0,0,6,72
"CTTAGGAGTATTCCTT",2,11,0,0,0,13,208
"CTTAGGAGTCTACTGA",50,491,126,20,82,769,27585
"CTTAGGAGTGAGATCG",1,4,0,0,0,5,56
"CTTCAATAGATGCGAC",24,194,37,10,32,297,8481
"CTTCAATAGCACACCC",3,10,5,0,2,20,442
"CTTCAATCAAATCGGG",28,187,40,8,36,299,11710
"CTTCAATGTAGTATAG",1,9,0,0,0,10,175
"CTTCAATGTCCTCAGG",0,2,0,0,0,2,41
"CTTCAATGTCTACAGT",2,37,28,4,10,81,2981
"CTTCAATGTCTTGCTC",0,5,0,0,0,5,50
"CTTCAATGTTCCAAAC",2,21,4,0,6,33,476
"CTTCCGAAGGAACGTC",63,689,121,49,120,1042,34228
"CTTCCGAAGTTGGCGA",0,2,0,0,0,2,39
"CTTCCGACAACACACT",0,0,0,0,0,0,25
"CTTCCGACAAGCTCTA",6,27,53,0,10,96,3919
"CTTCCGACAGAATCGG",0,2,0,0,0,2,298
"CTTCCGAGTATCCCTC",2,13,7,0,5,27,670
"CTTCCGATCATGAAAG",0,4,0,0,3,7,79
"CTTCCGATCATTTGCT",2,10,0,5,4,21,945
"CTTCCGATCGGTGTAT",4,26,0,0,6,36,1118
"CTTCCGATCTCAACGA",73,203,42,6,33,357,11433
"CTTCCTTAGATGCTGG",2,0,0,0,0,2,8
"CTTCCTTCACAACCGC",2,12,7,0,4,25,586
"CTTCCTTCACAAGGTG",3,12,5,0,3,23,373
"CTTCCTTCATCTAGAC",1,4,0,0,3,8,128
"CTTCCTTGTGCTAGCC",0,0,0,0,0,0,72
"CTTCGGTAGACATATG",3,10,3,0,0,16,144
"CTTCGGTAGACGCAGT",2,5,0,0,2,9,75
"CTTCGGTAGAGCAGTC",7,14,27,0,4,52,1042
"CTTCGGTAGATCACTC",0,3,3,0,2,8,48
"CTTCGGTCACACTGGC",2,11,5,0,0,18,74
"CTTCGGTCACGCAGTC",1,3,0,0,0,4,108
"CTTCGGTGTCAACGCC",0,0,0,0,0,0,28
"CTTCGGTGTTAGGAGC",0,6,0,0,0,6,676
"CTTCGGTTCACGGGAA",21,183,36,12,36,288,10188
"CTTCTAAAGAGAGTTT",1,5,0,0,2,8,119
"CTTCTAAAGAGGCTGT",1,13,5,2,3,24,434
"CTTCTAAAGTAACAGT",211,254,59,17,59,600,21248
"CTTCTAAAGTGCAGGT",1,6,0,0,2,9,43
"CTTCTAACAAGCGCAA",3,22,3,0,5,33,1253
"CTTCTAACACCCGTAG",0,0,0,0,0,0,16
"CTTCTAACAGAGAGGG",38,165,35,9,30,277,11019
"CTTCTAATCAACCCGG",0,2,0,0,0,2,141
"CTTCTAATCAAGAGGC",7,32,15,4,56,114,3350
"CTTCTAATCTATTCGT",1,4,0,0,0,5,45
"CTTCTCTCAGTCGGTC",2,23,8,0,4,37,885
"CTTCTCTGTTAAGCAA",4,47,6,0,8,65,2088
"CTTCTCTTCATTTCCA",7,27,37,0,6,77,2557
"CTTCTCTTCCACGGAC",25,320,66,10,49,470,20141
"CTTCTCTTCGTTCAGA",0,0,0,0,0,0,24
"CTTGAGAAGACTCGAG",28,185,33,9,27,282,9853
"CTTGAGAAGGAGAGTA",0,6,0,0,4,10,224
"CTTGAGAAGTCCGTCG",0,0,4,0,0,4,143
"CTTGAGAAGTGATCGG",7,45,11,3,11,77,2696
"CTTGAGACACTAGAGG",0,5,0,2,2,9,103
"CTTGAGAGTTTAGAGA",1,2,0,0,2,5,76
"CTTGAGATCAGGGATG",5,62,11,3,9,90,3687
"CTTGAGATCATTGCCC",1,11,2,0,0,14,337
"CTTGAGATCCATCCGT",1,16,0,0,2,19,491
"CTTGAGATCTAATTCC",55,31,14,3,15,118,4253
"CTTGAGATCTATCCAT",2,4,0,0,0,6,76
"CTTGAGATCTGTCCCA",0,0,0,0,0,0,91
"CTTGATTAGACATAGT",5,20,4,0,6,35,572
"CTTGATTAGTTTAGGA",1,2,0,0,0,3,35
"CTTGATTCACACGTGC",1,9,0,0,4,14,518
"CTTGATTCATGGAGAC",0,14,0,2,4,20,583
"CTTGATTCATTCCTCG",0,2,0,0,0,2,80
"CTTGATTGTACCTATG",0,3,0,0,0,3,77
"CTTGATTGTCGCCACA",2,11,8,0,5,26,474
"CTTGATTTCGAGCCAC",0,0,0,0,0,0,123
"CTTGATTTCGGCATTA",0,3,0,0,0,3,92
"CTTTCAACACCCTAGG",155,534,1010,63,871,2633,110673
"CTTTCAACACGCTGTG",1,0,0,0,0,1,22
"CTTTCAACAGAAATTG",0,2,0,0,0,2,18
"CTTTCAACAGGCCTGT",2,3,0,0,0,5,124
"CTTTCAACATGGTGGA",0,0,0,0,0,0,7
"CTTTCAAGTTGCTCCT",4,26,62,3,16,111,4834
"CTTTCAAGTTTCGTGA",0,2,0,0,0,2,42
"CTTTCAATCCGAGGCT",0,0,0,0,0,0,1
"CTTTCAATCGATGCAT",2,20,3,0,9,34,591
"CTTTCAATCGCAGTTA",35,458,120,24,75,712,26548
"CTTTCAATCGTCACCT",35,405,72,17,71,600,19156
"CTTTCGGAGGCATGCA",3,41,6,3,5,58,1865
"CTTTCGGCATCCGAAT",22,53,94,4,24,197,7188
"CTTTCGGGTGATGTAA",14,56,28,8,111,217,11385
"CTTTCGGTCCCAGCGA",0,5,2,0,4,11,45
"GAAACCTAGAAGCTGC",1,3,0,0,0,4,73
"GAAACCTAGAGGCTGT",3,12,9,0,6,30,419
"GAAACCTCAACTCGTA",6,34,11,3,70,124,4610
"GAAACCTCAGCCTTCT",0,0,0,0,0,0,12
"GAAACCTCAGGGATAC",0,2,0,0,0,2,48
"GAAACCTGTCTCCTGT",2,25,4,0,5,36,1252
"GAAACCTGTGGCAGAT",0,2,2,0,0,4,151
"GAAACCTTCAGGGATG",1,10,2,0,3,16,294
"GAAACCTTCCTACTGC",1,2,0,0,0,3,120
"GAAACCTTCGGACAAG",0,5,0,0,2,7,251
"GAAACCTTCTCGGGAC",1,3,2,0,0,6,122
"GAAACCTTCTGGAAGG",1,3,0,0,0,4,39
"GAAATGAAGCTCATAC",5,16,5,4,55,85,3209
"GAAATGAAGGAACGAA",1,17,4,0,3,25,295
"GAAATGACACAAGGTG",1,11,3,0,0,15,354
"GAAATGACAGAGTTCT",1,6,0,0,0,7,143
"GAAATGAGTGATAGAT",0,4,2,0,0,6,76
"GAAATGATCGAGTGGA",1,0,0,0,0,1,22
"GAACACTAGTCATCCA",3,11,0,0,4,18,876
"GAACACTAGTGAGGTC",1,3,0,0,2,6,36
"GAACACTCACCCTATC",0,6,0,0,2,8,67
"GAACACTCACGGTGTC",49,447,94,17,149,756,27527
"GAACACTGTAACGATA",0,10,3,0,5,18,210
"GAACACTGTAGTAAGT",0,11,0,0,4,15,78
"GAACACTTCATTTGGG",0,0,0,0,0,0,38
"GAACACTTCTATTTCG",0,0,0,0,0,0,12
"GAACACTTCTTGGGCG",0,0,0,0,0,0,59
"GAACGTTAGAGGCTGT",0,2,0,0,0,2,57
"GAACGTTAGATTAGCA",2,13,2,0,7,24,401
"GAACGTTCAAGCGCTC",0,0,0,0,0,0,7
"GAACGTTCACAACCGC",32,330,46,12,63,483,18514
"GAACGTTCACTTCAAG",1,9,2,0,6,18,438
"GAACGTTCATCTCGTC",1,13,6,0,4,24,448
"GAACGTTGTAGCACAG",2,5,4,0,4,15,402
"GAACGTTGTCACGCTG",0,18,5,0,3,26,484
"GAACGTTGTCTTTCAT",0,0,0,0,0,0,2
"GAACGTTTCAGCGGAA",1,3,2,0,2,8,102
"GAACGTTTCCATCTAT",0,4,0,0,0,4,43
"GAACGTTTCGGACCAC",2,14,4,0,0,20,410
"GAACGTTTCTAATTCC",1,9,3,0,5,18,402
"GAACTGTAGACTCGAG",1,2,3,0,0,6,72
"GAACTGTAGCCTGGAA",2,7,4,0,3,16,46
"GAACTGTAGGAGGCAG",1,12,3,0,5,21,197
"GAACTGTGTCTGTGCG",32,93,22,6,26,179,5694
"GAACTGTTCAAGAAAC",6,67,11,6,10,100,3063
"GAACTGTTCCGCAAAT",0,10,0,0,5,15,47
"GAACTGTTCCTTTGAT",1,4,0,0,0,5,138
"GAACTGTTCGCTTTAT",0,3,0,0,0,3,42
"GAACTGTTCTAGTCAG",5,35,7,0,5,52,1561
"GAAGAATAGAGCAGTC",40,110,26,6,23,205,5334
"GAAGAATCAAAGCTAA",0,0,0,0,0,0,1
"GAAGAATCAAGGAGTC",8,51,18,5,39,121,2263
"GAAGAATCACTGTGAT",0,2,2,0,0,4,63
"GAAGAATCAGACCTAT",1,14,3,0,3,21,297
"GAAGAATGTACCGTCG",9,34,103,4,10,160,3477
"GAAGAATTCCATAAGC",85,221,70,188,57,621,18428
"GAAGAATTCGATCCAA",9,36,33,3,71,152,5618
"GAAGAATTCTGAGGTT",3,3,3,0,0,9,160
"GAAGCCCCAAGTTGGG",0,0,0,0,0,0,11
"GAAGCCCCAAGTTTGC",1,3,0,0,0,4,114
"GAAGCCCCAATGAAAC",1,3,0,0,3,7,157
"GAAGCCCCATCCTATT",0,0,0,0,0,0,69
"GAAGCCCCATGGCACC",0,0,0,0,0,0,14
"GAAGCCCGTCCTACAA",4,12,32,0,5,53,1137
"GAAGCCCGTGGACTGA",4,57,13,0,9,83,2464
"GAAGCCCGTGGCTGCT",2,4,2,0,0,8,112
"GAAGCCCGTTAATCGC",1,0,4,0,2,7,241
"GAAGCCCTCTATCACT",86,303,87,16,64,556,16888
"GAAGCGAAGCTTACGT",2,11,4,3,3,23,470
"GAAGCGAAGGGCAAGG",0,0,0,0,0,0,36
"GAAGCGACAGCGGTCT",1,0,0,0,0,1,39
"GAAGCGACATGAGGGT",19,168,26,9,26,248,9586
"GAAGCGAGTCATCTAG",2,6,0,0,5,13,347
"GAAGCGAGTTTACTTC",1,3,8,0,0,12,412
"GAAGCGATCAGCTCTC",1,11,6,0,0,18,323
"GAAGCGATCATCCTGC",11,52,21,81,10,175,6258
"GAAGCGATCCGTGTGG",0,0,0,0,0,0,21
"GAAGCGATCTCAGTCC",0,5,3,0,0,8,221
"GAAGGACAGGCTGGAT",61,212,423,37,395,1128,37924
"GAAGGACCAATGTCAC",0,3,0,0,0,3,83
"GAAGGACCACAATGTC",11,105,16,4,16,152,5549
"GAAGGACCAGAATTCC",4,34,13,0,4,55,2108
"GAAGGACGTCTGTAAC",1,4,0,0,3,8,24
"GAAGGACGTGATACTC",24,66,100,7,137,334,10530
"GAAGGACGTGATGGCA",46,398,78,12,57,591,20704
"GAAGGACGTGGTCTAT",0,2,2,0,0,4,94
"GAAGGACTCCACCTGT",0,0,0,0,0,0,91
"GAAGGACTCTTACACT",0,3,0,0,0,3,13
"GAAGGACTCTTGGTCC",1,10,0,0,5,16,68
"GAAGGGTAGAGCATCG",1,0,0,0,0,1,43
"GAAGGGTAGCAACTCT",0,6,4,0,2,12,175
"GAAGGGTAGTTTCAGC",1,13,0,0,3,17,329
"GAAGGGTCAAAGGCTG",0,18,3,0,3,24,311
"GAAGGGTGTCCAAAGG",1,11,2,0,0,14,430
"GAAGGGTTCACTACGA",2,8,0,0,0,10,216
"GAAGGGTTCACTGGTA",2,4,3,0,0,9,100
"GAAGTAAAGTCGGGAT",0,0,0,0,2,2,42
"GAAGTAAGTAGGATAT",0,5,0,0,0,5,64
"GAAGTAAGTGTAGTGG",1,4,0,0,0,5,9
"GAAGTAATCACCGCTT",1,20,10,0,6,37,484
"GAAGTAATCGATGCTA",1,4,0,0,0,5,172
"GAATAGAAGCGTGAGT",73,307,59,8,69,516,18372
"GAATAGAAGTCAATCC",0,4,2,0,0,6,39
"GAATAGAAGTGCAAAT",2,18,3,0,6,29,279
"GAATAGACAACGACTT",0,3,3,0,0,6,67
"GAATAGAGTCATCCCT",0,4,0,0,0,4,324
"GAATAGAGTCGTTATG",0,3,0,0,0,3,19
"GAATAGAGTGACTATC",3,0,0,0,0,3,29
"GAATAGAGTGGATCGA",0,0,2,0,0,2,78
"GAATAGAGTTATAGCC",2,22,2,0,3,29,475
"GAATAGAGTTGTTGCA",0,0,0,0,0,0,15
"GAATAGATCTCTGACC",14,41,61,6,93,215,6137
"GAATCACAGCCTAACT",1,11,3,0,5,20,361
"GAATCACAGCGCATCC",0,18,0,3,4,25,427
"GAATCACAGGAAAGTG",0,3,0,0,0,3,40
"GAATCACCAATCTCTT",4,51,15,2,16,88,2804
"GAATCACCAATTGCGT",8,32,11,57,14,122,3308
"GAATCACCAATTGGTC",13,50,115,5,49,232,8905
"GAATCACCACCGCTGA",3,3,0,0,0,6,327
"GAATCACCAGCTCTGG",0,0,0,0,0,0,61
"GAATCACGTCGGTAAG",0,2,0,0,0,2,48
"GAATCACGTTGCCATA",2,18,0,0,2,22,661
"GAATCACTCGCAGATT",19,83,269,6,49,426,17062
"GAATCACTCGTGAGAG",1,7,0,0,0,8,82
"GAATCACTCTGTAACG",20,260,46,6,38,370,13145
"GAATCGTCAAATGGTA",1,10,3,0,4,18,778
"GAATCGTCACCGTACG",8,139,41,3,18,209,8074
"GAATCGTCACGTACTA",0,0,0,0,0,0,19
"GAATCGTCAGAGGGTT",5,18,42,5,8,78,2746
"GAATCGTCATGGATCT",1,2,0,0,0,3,70
"GAATCGTGTCCCTGAG",2,10,2,0,6,20,309
"GAATCGTGTTAAGCAA",0,0,0,0,0,0,6
"GAATCGTGTTTGCAGT",45,19,10,0,4,78,3088
"GAATCGTTCATCGCCT",0,3,2,0,0,5,139
"GAATCGTTCCAACACA",0,6,0,0,0,6,86
"GAATCGTTCGCAGTCG",4,19,38,3,52,116,2805
"GAATCGTTCTACGCGG",0,2,0,0,0,2,118
"GACACGCAGATCCGAG",2,3,0,0,0,5,110
"GACACGCAGATGCAGC",2,3,8,2,2,17,569
"GACACGCAGATGTTCC",1,3,2,0,4,10,186
"GACACGCAGCGTGCCT",0,0,0,0,0,0,16
"GACACGCAGTCGAAAT",2,14,2,0,4,22,465
"GACACGCCAGTCCGTG",1,0,0,0,0,1,77
"GACACGCGTAACATCC",0,2,0,0,0,2,12
"GACACGCGTTGTACGT",0,0,0,0,0,0,37
"GACACGCGTTTGATCG",1,9,0,0,3,13,41
"GACACGCTCCTGTAAG",1,0,0,0,2,3,30
"GACACGCTCGGTTAGT",0,0,0,0,0,0,7
"GACACGCTCTGTAAGC",1,0,0,0,0,1,66
"GACAGCCAGAGCAGTC",7,19,7,0,54,87,2186
"GACAGCCAGCCAACCC",1,3,0,0,2,6,63
"GACAGCCCAACAGCCC",1,0,0,0,0,1,72
"GACAGCCCAATCCTAG",42,45,14,2,10,113,3417
"GACAGCCCACCAGACC",2,7,0,0,4,13,330
"GACAGCCCACGGTAGA",0,6,0,0,0,6,323
"GACAGCCCATATCTGG",7,114,16,10,20,167,6001
"GACAGCCCATGTTACG",1,5,0,0,2,8,333
"GACAGCCGTGGGATTG",10,38,101,11,27,187,5858
"GACAGCCGTTGCATTG",0,4,0,0,0,4,99
"GACAGCCGTTTCGACA",0,2,0,0,0,2,165
"GACAGCCTCGAGATGG",0,0,0,0,0,0,1
"GACAGCCTCGTAGCTA",0,0,0,0,0,0,15
"GACATCACAACGGGTA",2,13,3,0,0,18,671
"GACATCACAAGCCCAC",1,3,0,0,2,6,157
"GACATCACACAAGCCC",0,2,0,0,0,2,125
"GACATCACACATTGTG",0,0,0,0,0,0,14
"GACATCACAGTAGATA",36,103,158,17,289,603,19683
"GACATCAGTCCCGTGA",0,5,0,0,0,5,107
"GACATCAGTCGACTGC",2,8,0,0,0,10,643
"GACATCAGTGGTGATG",10,39,15,45,16,125,2983
"GACATCATCGAGCCAC",8,30,107,3,17,165,4449
"GACATCATCGAGCTGC",72,23,14,8,11,128,3442
"GACCAATAGGATGGCT",0,0,0,0,3,3,92
"GACCAATAGTGATAGT",2,9,4,0,2,17,195
"GACCAATCAAGTGCAG",1,15,4,0,5,25,281
"GACCAATCAATGAGCG",2,13,0,0,4,19,315
"GACCAATCACTACCCT",0,0,0,0,0,0,44
"GACCAATCAGAGCGTA",3,20,42,0,3,68,2675
"GACCAATGTGAGATTA",0,5,0,0,0,5,91
"GACCAATGTGTTAAAG",6,14,10,0,4,34,708
"GACCAATTCACTGAAC",1,0,0,0,2,3,19
"GACCAATTCCAAGCCG",0,3,0,0,0,3,53
"GACCAATTCCCGATCT",223,86,46,11,41,407,10743
"GACCAATTCGAGCACC",23,124,25,6,85,263,7432
"GACCAATTCGGCACTG",1,0,2,0,0,3,41
"GACCCAGAGGTCCTGC",1,3,0,0,0,4,44
"GACCCAGCATAGAAAC",0,0,0,0,0,0,8
"GACCCAGGTCGAGCTC",0,0,0,0,0,0,2
"GACCCTTAGGTCTACT",1,4,0,0,0,5,74
"GACCCTTCAAACGTGG",1,15,3,0,0,19,609
"GACCCTTCAAGAGGCT",0,2,0,0,0,2,140
"GACCCTTGTATCGCGC",0,0,0,0,0,0,7
"GACCCTTGTTGCTCCT",1,10,3,0,0,14,446
"GACCGTGAGGATACCG",0,3,0,0,0,3,79
"GACCGTGCATACATCG",1,5,2,0,0,8,27
"GACCGTGCATCAGCTA",0,2,0,0,0,2,66
"GACCGTGCATTCAGCA",0,4,0,0,0,4,86
"GACCGTGGTAGCCAGA",18,69,176,4,34,301,11023
"GACCGTGGTGTTCGAT",0,0,0,0,0,0,5
"GACCTTCAGACATATG",14,161,29,3,28,235,8255
"GACCTTCAGTTAGAAC",2,14,5,0,2,23,308
"GACCTTCCAAAGACGC",114,1186,236,55,180,1771,49135
"GACCTTCCACACCGCA",13,49,102,6,20,190,6100
"GACCTTCCATGGGATG",0,11,2,0,0,13,319
"GACCTTCGTACAACGG",115,1246,211,43,168,1783,58357
"GACCTTCGTTGTGCCG",27,62,208,13,41,351,10968
"GACCTTCTCCTCACTG",0,5,2,0,0,7,146
"GACCTTCTCTCCTACG",11,21,4,4,4,44,1109
"GACGCTGCAAATCGGG",0,0,2,0,0,2,69
"GACGCTGCACAGTACT",0,4,0,0,0,4,91
"GACGCTGGTGGAACAC",357,665,280,35,127,1464,45216
"GACGCTGGTTCAGCGC",0,4,6,0,8,18,671
"GACGCTGTCAGCAATC",1,9,0,3,0,13,251
"GACGCTGTCGAGAGCA",1,3,0,0,0,4,70
"GACGCTGTCGCAGTGC",0,0,0,0,0,0,37
"GACGCTGTCTTCACAT",1,2,0,0,0,3,142
"GACGTTAAGGATTACA",18,20,8,3,5,54,993
"GACGTTAAGTAGGATT",3,8,4,0,5,20,54
"GACGTTACACTCCCTA",15,122,22,5,22,186,6371
"GACGTTAGTCAGCTTA",2,5,0,0,0,7,174
"GACTATGAGGTAAAGG",2,5,0,0,0,7,79
"GACTATGCACCGTCTT",1,2,0,0,0,3,97
"GACTATGGTACTCAAC",73,888,154,43,145,1303,44451
"GACTATGGTTCCTTGC",11,133,20,4,17,185,6302
"GACTATGTCCAACTGA",1,5,0,0,0,6,222
"GACTATGTCCATTTAC",0,0,0,0,0,0,53
"GACTATGTCGTAGTGT",21,73,187,8,34,323,11256
"GACTATGTCTCCGATC",7,42,79,5,11,144,5372
"GACTCAAAGTTGGAGC",0,0,0,0,0,0,42
"GACTCAACAGGAACCA",0,7,2,0,0,9,203
"GACTCAACATCCCACT",0,3,0,0,0,3,116
"GACTCAAGTCTGATCA",0,0,2,0,0,2,10
"GACTCAAGTGTGACCC",0,0,2,0,0,2,28
"GACTCAATCGAAATCC",2,4,0,0,0,6,71
"GACTCTCAGATGCTGG",0,0,0,0,0,0,29
"GACTCTCAGCGTACAG",1,11,2,0,2,16,542
"GACTCTCAGGGTAATT",0,0,0,0,0,0,65
"GACTCTCAGTAGCCAG",0,0,0,0,0,0,10
"GACTCTCCAAACACCT",1,4,2,8,0,15,200
"GACTCTCGTGATAGTA",1,10,0,0,2,13,222
"GACTCTCTCACCTGGG",1,16,6,0,8,31,590
"GACTCTCTCGAAGGAC",0,5,0,0,0,5,49
"GACTGATAGACATCCT",2,10,2,0,2,16,228
"GACTGATAGATTGATG",24,32,16,66,11,149,5821
"GACTGATAGTAACCTC",1,7,0,2,5,15,167
"GACTGATCATAGTCGT",0,2,2,0,2,6,152
"GACTGATCATTGTAGC",0,0,0,0,0,0,50
"GACTGATGTAGCCCTG",2,6,2,0,2,12,130
"GACTGATGTCGGCTAC",0,10,4,0,3,17,420
"GACTGATTCCTCTGCA",0,4,0,0,2,6,55
"GACTGATTCGCTCTCA",4,0,0,0,0,4,206
"GACTTCCAGAATTGCA",3,16,0,0,0,19,278
"GACTTCCAGACTCAAA",0,0,0,0,2,2,191
"GACTTCCAGGCAGGTT",1,8,6,0,11,26,838
"GACTTCCCACCTGCAG",2,5,0,0,2,9,182
"GACTTCCCACGTCATA",0,4,0,0,0,4,120
"GACTTCCGTCAACCTA",1,3,0,0,2,6,112
"GACTTCCGTCGCGTCA",0,0,0,0,0,0,22
"GACTTCCTCCATCTGC",23,296,59,9,51,438,16149
"GACTTCCTCCGTTGAA",0,0,0,0,0,0,40
"GAGAAATAGACCAACG",2,41,13,3,92,151,5715
"GAGAAATAGGCCCGTT",0,0,0,0,0,0,54
"GAGAAATCAAAGCGTG",0,0,0,0,0,0,12
"GAGAAATCACAAATAG",0,3,0,0,0,3,25
"GAGAAATCACTACCCT",6,31,46,4,18,105,3359
"GAGAAATCAGATCCTA",0,3,0,0,0,3,85
"GAGAAATGTAGTCGGA",1,14,4,0,5,24,264
"GAGAAATGTCGCGTCA",0,0,0,0,0,0,5
"GAGAAATGTGCTTATG",31,113,53,14,281,492,16496
"GAGAAATTCCTCTAGC",1,7,3,0,0,11,329
"GAGAAATTCCTGGGAC",0,2,2,0,0,4,234
"GAGAAATTCGAGTGAG",4,21,16,0,10,51,1015
"GAGAAATTCTCCCAAC",2,6,2,0,0,10,164
"GAGAAATTCTGCGAGC",4,37,8,0,8,57,1534
"GAGACCCAGATAACGT",0,4,0,0,0,4,67
"GAGACCCAGGTCATTC",0,0,0,0,0,0,176
"GAGACCCCAGTTAGGG",0,8,0,0,0,8,59
"GAGACCCGTAGACGTG",0,3,0,0,0,3,36
"GAGACCCTCGTCCTCA",0,0,0,0,0,0,21
"GAGACCCTCTCGTCGT",11,37,124,4,21,197,4352
"GAGACCCTCTGTGCGG",7,23,40,3,8,81,2640
"GAGACTTAGGTTCTAC",0,0,2,0,0,2,154
"GAGACTTCACCTCAGG",0,5,0,0,0,5,90
"GAGACTTCAGAGCGTA",3,3,0,0,0,6,48
"GAGACTTCAGTCGGTC",5,20,7,0,6,38,957
"GAGACTTGTCGCAACC",2,3,4,0,0,9,137
"GAGACTTTCAGGACAG",1,3,2,0,2,8,176
"GAGACTTTCCCGTGTT",1,8,2,0,0,11,101
"GAGACTTTCGGTAGAG",0,2,0,0,0,2,47
"GAGAGGTAGCCTATTG",1,6,0,0,2,9,158
"GAGAGGTCAAAGGGCT",112,49,20,6,20,207,6866
"GAGAGGTGTCCTGTTC",0,4,0,0,2,6,19
"GAGAGGTGTGGTTTGT",0,5,0,0,2,7,84
"GAGAGGTTCAGTCATG",1,2,0,0,0,3,106
"GAGAGGTTCGAAGAAT",2,14,4,2,6,28,409
"GAGATGGAGCATCAAA",0,0,0,0,0,0,43
"GAGATGGAGCGAAACC",1,3,0,0,4,8,202
"GAGATGGAGTGTCATC",128,400,1303,53,255,2139,79776
"GAGATGGCAAGCCTGC",29,264,78,11,47,429,14001
"GAGATGGCATAGTCGT",0,4,0,0,0,4,47
"GAGATGGCATCCGTGG",0,3,0,0,0,3,56
"GAGATGGGTCGCGGTT",0,4,2,0,5,11,96
"GAGATGGTCCTAGCCT",2,8,6,2,6,24,360
"GAGATGGTCGTCACCT",0,4,0,0,0,4,41
"GAGATGGTCTTGGAAC",0,3,0,0,0,3,41
"GAGCCTGAGGCCACTC",0,2,0,0,0,2,141
"GAGCCTGAGTGGGAAA",1,7,4,0,0,12,312
"GAGCCTGCAAAGGAGA",0,9,0,0,0,9,351
"GAGCCTGCAGATTCGT",0,2,0,0,0,2,6
"GAGCCTGGTATGAAAC",1,0,2,0,0,3,6
"GAGCCTGGTCCTCAGG",1,3,0,0,0,4,114
"GAGCCTGGTCTGTAGT",1,5,5,0,2,13,181
"GAGCCTGTCTACGGTA",2,2,0,0,0,4,50
"GAGCTGCAGAAGTGTT",6,82,19,3,14,124,4307
"GAGCTGCAGTCCTACA",0,7,0,0,0,7,58
"GAGCTGCCAAGCCCAC",0,9,0,0,0,9,160
"GAGCTGCCAGCTGTAT",0,5,0,0,2,7,18
"GAGCTGCGTACTCGCG",0,5,0,0,0,5,43
"GAGCTGCGTCACATTG",2,2,0,0,0,4,59
"GAGCTGCGTCCAATCA",0,7,0,0,2,9,97
"GAGCTGCGTCCGACGT",9,98,14,2,19,142,4410
"GAGCTGCTCAGCTGAT",0,20,18,0,7,45,1572
"GAGCTGCTCAGTCCGG",0,0,0,0,0,0,34
"GAGCTGCTCCCAAGTA",0,9,0,0,4,13,92
"GAGCTGCTCCCTTGTG",9,38,53,2,11,113,3633
"GAGCTGCTCGAACGGA",9,83,14,39,13,158,5706
"GAGGCAACAATTTCTC",4,12,4,3,3,26,470
"GAGGCAACAGGTTACT",0,0,0,0,0,0,4
"GAGGCAACATACCAGT",0,12,5,0,4,21,585
"GAGGCAAGTCTTCCGT",5,11,0,0,3,19,588
"GAGGCAAGTGTCTTCC",0,0,0,0,0,0,46
"GAGGCAAGTTAACAGA",0,5,0,0,0,5,74
"GAGGCAATCGAAGAAT",1,2,2,0,0,5,87
"GAGGCCTAGAGAGGGC",43,103,70,18,298,532,19605
"GAGGCCTAGCGTCTCG",0,3,0,0,0,3,44
"GAGGCCTAGGCTGTAG",1,7,4,0,2,14,323
"GAGGCCTCAGTGGCTC",4,10,5,0,2,21,458
"GAGGCCTCATCAGTGT",1,5,2,0,3,11,110
"GAGGCCTGTCAGCGTC",0,4,0,0,0,4,330
"GAGGCCTGTGCTCTCT",0,5,2,0,4,11,255
"GAGGCCTGTTCTAACG",0,8,0,0,0,8,38
"GAGGCCTTCACCTGGG",2,14,10,2,5,33,1016
"GAGGCCTTCGCAATTG",1,7,2,10,3,23,985
"GAGGCCTTCGCGAAGA",11,110,20,6,21,168,5789
"GAGGCCTTCGTTCTGC",2,11,4,0,5,22,332
"GAGGCCTTCTGGGCCA",2,10,2,0,0,14,518
"GAGGGATAGAACTCCT",0,14,9,4,2,29,728
"GAGGGATAGCAGGTCA",1,19,7,0,5,32,549
"GAGGGATAGGTGTGAC",2,14,5,0,0,21,386
"GAGGGATCAATCCAGT",1,10,4,0,2,17,319
"GAGGGATCATCCTATT",1,8,7,0,4,20,421
"GAGGGATCATCGGATT",1,5,3,0,0,9,144
"GAGGGATGTCCAGGTC",0,8,4,2,0,14,101
"GAGGGATTCACCTTGC",1,0,0,0,0,1,56
"GAGGGATTCCCAGTGG",27,283,43,13,39,405,13119
"GAGGGATTCTGGAGAG",3,4,5,0,4,16,271
"GAGGGATTCTGTGTGA",2,9,0,0,0,11,133
"GAGGGTAAGACGCTCC",0,3,0,0,0,3,117
"GAGGGTAAGAGAGCAA",1,5,0,0,0,6,41
"GAGGGTAAGCGTTGTT",2,19,18,0,8,47,1317
"GAGGGTAAGGTAGCCA",6,23,38,0,5,72,3307
"GAGGGTAAGTCATCCA",0,6,2,0,0,8,16
"GAGGGTACAGACCAAG",0,13,3,0,6,22,448
"GAGGGTAGTACTGCGC",24,182,53,15,185,459,14701
"GAGGGTAGTCTGGTTA",3,13,4,0,5,25,200
"GAGGGTATCAGCTTCC",1,2,0,0,0,3,41
"GAGGGTATCTTTGGAG",1,7,4,0,3,15,53
"GAGTCATAGAGTGAAG",5,3,0,0,0,8,81
"GAGTCATAGTATTGCC",7,14,34,3,9,67,1899
"GAGTCATAGTGTACCT",0,0,0,0,0,0,52
"GAGTCATCAGCTACCG",0,3,0,0,0,3,104
"GAGTCATGTACCTGTA",2,13,0,0,2,17,398
"GAGTCATGTGTCCGTG",26,43,6,0,9,84,2648
"GAGTCATGTTGCTCAA",0,0,0,0,0,0,161
"GAGTCATTCGCCAACG",0,2,0,0,0,2,51
"GAGTCATTCGTTCCCA",0,2,3,0,2,7,120
"GAGTCTAAGCCACAAG",0,0,0,0,0,0,47
"GAGTCTAAGCTGACAG",0,2,0,0,0,2,50
"GAGTCTAAGGGCTTCC",0,9,2,0,0,11,64
"GAGTCTACAGAACGCA",0,0,0,0,2,2,44
"GAGTCTACAGTTGTTG",0,4,0,0,2,6,103
"GAGTCTACATAAGCGG",0,2,0,0,0,2,90
"GAGTCTATCGAAGCCC",3,10,2,0,2,17,449
"GAGTCTATCTCCATAT",0,0,0,0,0,0,35
"GAGTCTATCTTAATCC",0,5,0,0,0,5,39
"GAGTCTATCTTGGGCG",0,0,0,0,0,0,4
"GAGTGAGAGATTGCGG",4,37,9,0,5,55,1205
"GAGTGAGGTAAGCAAT",0,2,0,0,0,2,47
"GAGTGAGGTGGCCTCA",83,212,35,20,35,385,14645
"GAGTGAGGTGTGTCCG",0,5,0,0,4,9,259
"GAGTGAGTCCACAGCG",1,3,0,0,0,4,84
"GAGTGAGTCCGAACGC",0,4,0,0,0,4,119
"GAGTGAGTCTTCTGTA",87,215,61,9,49,421,12368
"GAGTGTTAGCTTCGTA",1,6,6,0,0,13,175
"GAGTGTTAGGATGCGT",0,10,3,3,4,20,181
"GAGTGTTAGTTGGCGA",0,2,0,0,0,2,13
"GAGTGTTGTGACTATC",6,34,46,4,17,107,2636
"GAGTGTTGTTGCCGAC",0,2,0,0,0,2,44
"GAGTGTTTCGCCTTTG",1,0,0,0,0,1,16
"GAGTGTTTCTAGCAAC",1,12,4,2,4,23,282
"GAGTGTTTCTGCGAGC",0,3,0,0,2,5,117
"GAGTTACAGACTACCT",177,108,34,8,23,350,11453
"GAGTTACAGCTGTCCG",1,9,5,0,0,15,200
"GAGTTACCAAGCAATA",4,20,6,2,4,36,1084
"GAGTTACCACTGTGAT",2,9,2,0,0,13,147
"GAGTTACGTATTTCCT",0,0,0,0,0,0,30
"GAGTTACGTGTCCACG",0,3,0,0,0,3,102
"GAGTTACTCATTCATC",3,3,4,0,3,13,250
"GAGTTACTCGTCACCT",0,2,4,0,2,8,65
"GAGTTACTCTATTGTC",0,0,0,0,3,3,24
"GAGTTGTAGATGACCG",0,3,0,0,3,6,121
"GAGTTGTAGGTGCCTC",2,16,4,0,6,28,452
"GAGTTGTCACAAAGCG",0,3,0,0,0,3,56
"GAGTTGTCATTGAAAG",4,14,14,2,2,36,751
"GAGTTGTGTGTTGATC",0,2,0,0,0,2,66
"GAGTTGTTCGGCTTCT",0,0,0,0,0,0,60
"GAGTTGTTCTCCAATT",0,0,0,0,0,0,106
"GAGTTTGAGGGAGGAC",5,28,58,2,14,107,3959
"GAGTTTGCACACCTTC",0,0,0,0,0,0,39
"GAGTTTGTCCAGCACG",1,0,0,0,0,1,59
"GAGTTTGTCCTAGAGT",2,12,3,0,3,20,331
"GAGTTTGTCCTTCTTC",1,2,3,0,2,8,81
"GATAGAAAGCTTAAGA",2,18,2,0,0,22,315
"GATAGAAAGGGATCGT",15,67,18,4,11,115,3037
"GATAGAACATCAGCTA",0,3,2,0,0,5,119
"GATAGAAGTATCGCTA",4,14,5,0,3,26,440
"GATAGAAGTCGAATTC",45,133,368,16,76,638,23110
"GATAGAAGTCGTGGTC",5,23,5,3,6,42,1424
"GATAGAAGTGATTCTG",43,436,124,25,84,712,22843
"GATAGAAGTGCAATAA",1,3,3,0,3,10,165
"GATAGAATCTTGAGCA",0,0,0,0,0,0,0
"GATAGCTAGGCCTGCT",0,3,0,0,0,3,128
"GATAGCTCAACAAAGT",0,4,0,0,0,4,106
"GATAGCTCAGCTACTA",6,31,63,5,20,125,2741
"GATAGCTCATTGCTTT",2,37,8,0,6,53,1391
"GATAGCTGTTCGTTCC",1,5,0,0,0,6,36
"GATAGCTTCAACCCGG",1,12,3,0,5,21,458
"GATAGCTTCGAGAACG",1,12,5,0,5,23,368
"GATAGCTTCGGTCATA",0,3,0,0,0,3,51
"GATAGCTTCTCTCTTC",1,3,0,0,0,4,64
"GATCACAAGAGCAAGA",2,16,9,0,24,51,1606
"GATCACACACCACTGG",0,8,3,0,0,11,104
"GATCACAGTTGCCTAA",0,0,0,0,0,0,52
"GATCAGTCAATTCTTC",0,9,2,0,0,11,328
"GATCAGTCACGCGCTA",1,4,0,0,0,5,285
"GATCAGTGTCGTTCAA",2,10,3,0,4,19,199
"GATCAGTGTTCGAAGG",5,4,2,0,0,11,173
"GATCAGTTCCACATAG",0,3,0,0,0,3,59
"GATCAGTTCTCGGGAC",2,22,5,0,0,29,695
"GATCATGAGCTTAGTC",50,32,20,5,14,121,3440
"GATCATGCAACACAAA",0,0,0,0,0,0,6
"GATCATGCAACCAACT",0,8,2,0,4,14,390
"GATCATGCACCTAAAC",1,6,0,0,0,7,63
"GATCATGCAGCCTATA",0,2,0,0,0,2,76
"GATCATGCATATCGGT",0,4,0,0,0,4,121
"GATCATGCATGACGAG",0,3,2,0,0,5,144
"GATCATGCATTCTTCA",0,0,0,0,0,0,34
"GATCATGGTAGCTCGC",3,24,52,2,8,89,2568
"GATCATGGTCAGACTT",3,6,4,2,0,15,351
"GATCATGGTCCTGTCT",6,49,29,10,136,230,7503
"GATCATGGTTCAAGTC",453,265,145,374,130,1367,37635
"GATCATGTCGCCATAA",1,0,0,0,0,1,113
"GATCATGTCTCGTGAA",0,0,2,0,0,2,36
"GATCCCTAGACTCATC",1,14,3,0,10,28,961
"GATCCCTAGCATTGAA",4,3,3,0,0,10,101
"GATCCCTAGCTAAATG",6,29,3,0,7,45,637
"GATCCCTCAAGCTACT",13,39,37,0,58,147,5710
"GATCCCTCAGGCATTT",1,5,2,0,0,8,271
"GATCCCTCATCTCGTC",5,29,59,2,12,107,4234
"GATCCCTTCGAGTCTA",1,15,0,0,3,19,384
"GATCCCTTCTGACAGT",1,5,3,0,0,9,94
"GATCCCTTCTTGGATG",0,7,0,0,2,9,124
"GATCGTAAGGACGCAT",1,13,3,0,5,22,507
"GATCGTACACAAGCCC",77,785,166,40,142,1210,40847
"GATCGTACAGAACGCA",28,100,110,14,248,500,17525
"GATCGTACATGAATCC",0,4,0,0,0,4,31
"GATCGTAGTAATCAGA",0,4,0,0,0,4,11
"GATCGTAGTTCGTAAC",5,30,16,3,59,113,2643
"GATGACTAGATTCGAA",2,11,2,0,0,15,212
"GATGACTAGGCAATGC",0,5,2,0,4,11,71
"GATGACTCAAATGAAC",2,7,0,0,2,11,243
"GATGACTGTGGGAGAG",4,48,9,5,3,69,3174
"GATGACTTCAGACAAA",0,4,0,0,2,6,67
"GATGACTTCCATTGCC",3,35,5,0,6,49,1500
"GATGACTTCCTGGCTT",4,5,5,0,4,18,100
"GATGACTTCGAGTCTA",0,2,0,0,2,4,85
"GATGACTTCGTTGTAG",0,2,0,0,0,2,30
"GATGACTTCTCGGTAA",2,3,0,0,3,8,361
"GATGACTTCTTGGTCC",0,8,3,0,3,14,369
"GATGAGGAGAGACAAG",0,3,0,0,0,3,59
"GATGAGGAGCTGTCCG",1,2,0,0,2,5,73
"GATGAGGGTGATCGTT",0,0,0,0,0,0,48
"GATGAGGGTGCCGTAC",0,15,0,0,3,18,553
"GATGAGGTCTCCATAT",0,2,0,0,0,2,20
"GATGATCAGACTTCGT",1,18,4,0,5,28,542
"GATGATCAGCGTGTCC",0,17,0,0,0,17,200
"GATGATCAGCTGTGCC",16,55,31,13,187,302,10953
"GATGATCAGGCCTAAG",0,0,5,0,0,5,57
"GATGATCAGGCTTCCG",2,15,12,0,4,33,1083
"GATGATCCACAACATC",0,8,2,2,7,19,470
"GATGATCCATAACAGA",8,31,31,3,8,81,2129
"GATGATCGTCTACAGT",1,10,0,0,2,13,249
"GATGATCGTGTGCCTG",1,7,6,3,17,34,1157
"GATGATCTCAAGGTGG",1,21,2,0,2,26,274
"GATGATCTCACGGACC",15,44,112,8,17,196,7853
"GATGATCTCAGTGTGT",1,21,4,0,2,28,317
"GATGATCTCGCCTAGG",0,3,0,0,0,3,16
"GATGATCTCTAACGGT",0,3,0,0,3,6,146
"GATGATCTCTAAGCGT",0,3,2,0,0,5,59
"GATGATCTCTTACTGT",0,0,3,0,0,3,68
"GATGCTAAGACGCAGT",2,6,0,0,2,10,235
"GATGCTAAGCGCTTCG",0,0,0,0,0,0,58
"GATGCTACAACCGTGC",2,6,6,0,3,17,676
"GATGCTACAATCTCTT",12,55,97,4,19,187,5694
"GATGCTACACGACGCT",2,13,2,0,9,26,592
"GATGCTAGTAAGATAC",1,3,0,0,2,6,119
"GATGCTATCAGGAGAC",2,16,5,0,6,29,488
"GATGGAGCAAACTAAG",0,4,0,0,0,4,50
"GATGGAGGTTGGCCTG",13,13,6,0,4,36,1160
"GATGGAGTCAGTGGGA",0,5,3,0,0,8,74
"GATGGAGTCCATTGCC",0,16,3,2,2,23,419
"GATGTTGCAATGGGTG",1,3,0,0,0,4,78
"GATGTTGCACGGTGAA",1,6,0,0,3,10,259
"GATGTTGCAGAGAATT",18,157,31,9,29,244,8260
"GATGTTGCATCAGCTA",0,0,0,0,0,0,73
"GATGTTGCATCTTAGG",2,15,3,0,2,22,367
"GATGTTGGTCGACTGC",0,11,4,0,0,15,204
"GATGTTGTCGAGATAA",120,52,22,10,18,222,8031
"GATTCGAAGCGATCGA",1,0,0,0,0,1,73
"GATTCGAAGCGCAATG",1,16,21,0,14,52,2094
"GATTCGAAGCTCGAAG",1,6,0,0,0,7,42
"GATTCGACACGTAGAG",0,0,0,0,0,0,93
"GATTCGACACTAACGT",6,32,16,2,54,110,4309
"GATTCGACATGACAGG",0,2,0,0,0,2,96
"GATTCGAGTAACGTTC",0,6,0,0,0,6,68
"GATTCGAGTCGATTCA",43,1162,180,13,73,1471,17548
"GATTCGAGTCGTTCAA",1,0,0,0,2,3,327
"GATTCGAGTGTTAGCT",1,14,2,0,2,19,253
"GATTCGATCAAATGCC",0,0,0,0,0,0,27
"GATTCTTAGAACGCGT",0,0,3,0,4,7,159
"GATTCTTCAGCGCGTT",1,3,2,0,2,8,101
"GATTCTTGTAGCGCTC",0,0,0,0,0,0,105
"GATTCTTGTCTGCGCA",0,8,4,0,6,18,73
"GATTCTTTCCGTTGGG",213,438,66,16,70,803,24466
"GATTCTTTCGTGTCAA",0,0,0,0,0,0,7
"GATTCTTTCTACTATC",0,24,3,0,3,30,470
"GATTGGTAGGGATCTG",3,11,5,0,5,24,555
"GATTGGTAGTGATGGC",1,2,0,0,0,3,5
"GATTGGTCAAAGGGTC",47,139,228,22,185,621,21116
"GATTGGTGTAGGAGGG",0,4,0,0,0,4,136
"GATTGGTTCCGCACTT",0,3,0,0,0,3,103
"GATTGGTTCGAGCACC",15,96,77,9,136,333,12043
"GATTGGTTCTCCCATG",32,95,49,14,223,413,12884
"GATTTCTAGACATCAA",0,10,0,0,3,13,87
"GATTTCTAGATACTGA",1,0,0,0,0,1,48
"GATTTCTAGCACTCGC",9,31,80,0,19,139,5026
"GATTTCTGTCCTACAA",2,11,2,0,4,19,111
"GATTTCTTCAAAGGAT",1,27,19,0,9,56,1474
"GATTTCTTCAACTCTT",3,14,10,0,5,32,361
"GATTTCTTCCGCGGAT",0,3,0,0,0,3,44
"GATTTCTTCGATAACC",3,19,8,0,4,34,500
"GATTTCTTCTCACCCA",16,147,16,5,21,205,6156
"GCAACATAGATAGCTA",0,4,0,0,0,4,77
"GCAACATAGCACCGTC",1,0,0,0,0,1,54
"GCAACATAGCTAGAGC",0,3,2,0,0,5,159
"GCAACATAGGGCTAAC",0,6,0,0,0,6,89
"GCAACATCACGAAAGC",0,6,2,0,0,8,161
"GCAACATCAGTGGCTC",0,0,0,0,0,0,146
"GCAACATCATCTAACG",0,11,2,0,2,15,255
"GCAACATCATGGCTGC",2,24,25,3,5,59,1441
"GCAACATGTTGCAAGG",0,4,0,0,2,6,78
"GCAACCGAGATCCAAA",1,2,0,0,0,3,48
"GCAACCGAGGTCATTC",0,0,0,0,0,0,11
"GCAACCGCAACCGCCA",1,2,0,0,7,10,426
"GCAACCGCAATTTCCT",0,0,0,0,0,0,0
"GCAACCGCAGATCATC",3,15,3,0,4,25,857
"GCAACCGCATCGATAC",1,20,3,0,4,28,338
"GCAACCGGTAGTGTGG",40,347,70,39,64,560,19119
"GCAACCGGTCATCCGG",0,3,0,0,0,3,3
"GCAACCGGTGACACGA",1,4,0,0,0,5,46
"GCAACCGGTGACAGCA",1,6,0,0,2,9,242
"GCAACCGGTGCCCTTT",104,329,537,61,658,1689,73721
"GCAACCGGTGTTAACC",0,6,2,0,0,8,74
"GCAACCGTCTAACACG",4,11,5,0,0,20,426
"GCAACCGTCTGAGCAT",1,8,0,0,3,12,249
"GCACATAAGGAAGTAG",0,0,0,0,0,0,1
"GCACATACAAAGGGTC",1,0,0,0,0,1,19
"GCACATACACATGAAA",4,22,3,0,0,29,545
"GCACATATCACATTGG",0,4,0,2,0,6,38
"GCACATATCCCTTCCC",5,40,14,4,9,72,2187
"GCACATATCCTGTAAG",0,0,0,0,2,2,15
"GCACATATCGGAGATG",1,0,0,0,0,1,46
"GCACATATCGTGCATA",1,2,0,0,0,3,90
"GCACGGTAGGGAGGAC",0,2,0,0,0,2,38
"GCACGGTAGTCGCCAC",10,30,16,5,90,151,5355
"GCACGGTCAAAGACGC",0,3,0,0,0,3,46
"GCACGGTGTACTCGAT",0,14,3,0,0,17,307
"GCACGGTGTAGTATAG",3,8,4,0,2,17,280
"GCACGGTGTATTCCGA",1,7,4,0,2,14,305
"GCACGGTGTTGAAGTA",4,27,69,0,13,113,4705
"GCACGTGAGTTGGAAT",0,0,0,0,0,0,25
"GCACGTGGTCAACCTA",12,96,20,6,18,152,5832
"GCACGTGGTGACATCT",20,88,19,4,25,156,3925
"GCACGTGTCATGGCCG",44,475,174,20,74,787,27090
"GCACGTGTCCTGTACC",1,4,0,0,0,5,78
"GCACGTGTCTATCGTT",0,5,2,0,0,7,87
"GCACTAAAGCTCTTCC",0,2,0,0,0,2,80
"GCACTAAAGTCGCGAA",0,2,2,0,0,4,64
"GCACTAACAAATCGTC",1,0,0,0,0,1,80
"GCACTAACAAGATGTA",2,8,2,0,0,12,198
"GCACTAACACAAGCCC",26,83,180,11,82,382,12918
"GCACTAAGTCAATCTG",1,5,0,0,0,6,128
"GCACTAAGTCATCGCG",1,0,0,0,0,1,17
"GCACTAAGTTGCACGC",0,0,0,0,0,0,78
"GCACTAATCCCTTGTG",2,22,8,0,0,32,461
"GCACTAATCGACGCTG",0,4,3,2,0,9,99
"GCACTAATCTAACGGT",1,17,3,0,8,29,486
"GCAGCCAAGATGGGCT",2,64,9,2,15,92,2518
"GCAGCCAAGCAGCAGT",0,2,0,0,0,2,11
"GCAGCCAAGGAGATAG",0,5,0,0,3,8,145
"GCAGCCAAGGAGGCAG",10,58,84,4,21,177,5574
"GCAGCCAAGTAAACAC",716,201,100,22,98,1137,37406
"GCAGCCACACGACAGA",70,98,16,9,26,219,6546
"GCAGCCACAGCTACCG",1,12,6,2,8,29,952
"GCAGCCACATAGCACT",0,5,3,0,0,8,131
"GCAGCCACATGTGGTT",1,0,0,2,0,3,71
"GCAGCCAGTCACAGAG",0,2,0,0,0,2,5
"GCAGCCAGTTCCCAAA",9,44,62,2,18,135,4736
"GCAGCCAGTTCGGGTC",1,4,0,0,0,5,88
"GCAGCCATCTTCTTCC",0,0,0,0,0,0,67
"GCAGCTGAGCAATAAC",6,16,34,5,17,78,1996
"GCAGCTGAGCCTCACG",0,10,0,0,3,13,459
"GCAGCTGAGGTAGACC",6,53,14,2,9,84,3025
"GCAGCTGAGTACAGAT",1,14,8,2,4,29,615
"GCAGCTGCAAATTGCC",0,4,3,0,0,7,246
"GCAGCTGCACGCCAGT",1,3,2,0,4,10,92
"GCAGCTGGTCACATTG",19,170,26,9,28,252,7463
"GCAGCTGGTCTGGTTA",0,12,3,0,4,19,265
"GCAGCTGGTGGTCCGT",0,0,0,0,0,0,73
"GCAGCTGGTTAGAGTA",107,1226,224,66,177,1800,58568
"GCAGCTGTCATCTATC",0,4,0,0,0,4,58
"GCAGCTGTCATGAGTC",2,10,2,0,0,14,146
"GCAGCTGTCCCAAGCG",0,0,0,0,0,0,83
"GCAGCTGTCGGACTTA",0,3,0,0,0,3,7
"GCAGGCTAGAGTCACG",1,17,3,0,5,26,505
"GCAGGCTAGCAGATAT",0,0,0,0,0,0,83
"GCAGGCTAGCGACCCT",1,15,4,0,9,29,488
"GCAGGCTAGGCCCAAA",0,5,0,0,0,5,175
"GCAGGCTAGGGCAACT",1,11,6,0,0,18,280
"GCAGGCTAGTATGACA",1,12,5,0,3,21,247
"GCAGGCTCACCAATTG",6,26,47,4,9,92,3738
"GCAGGCTGTACAGTAA",0,3,0,0,0,3,19
"GCAGGCTGTCGGTGTC",0,2,0,0,2,4,74
"GCAGGCTGTTATAGAG",0,2,0,0,0,2,99
"GCAGGCTTCAGCACCG",36,116,212,18,224,606,20398
"GCAGTTAAGCGTGTTT",0,8,0,0,2,10,39
"GCAGTTAAGTAGGGTC",9,34,15,5,83,146,4785
"GCAGTTAAGTGCAACG",79,286,145,34,1000,1544,54984
"GCAGTTATCACGGGAA",4,8,2,0,2,16,170
"GCAGTTATCACTACGA",153,462,126,34,109,884,27001
"GCAGTTATCCAGTGTA",14,125,89,9,68,305,11284
"GCAGTTATCCGCTGTT",1,0,0,0,0,1,47
"GCAGTTATCCTGATAG",0,4,0,0,2,6,24
"GCAGTTATCTCTCGAC",1,2,0,0,0,3,118
"GCATCGGCAACTCATG",1,0,2,0,0,3,83
"GCATCGGCACCTATCC",6,25,70,3,15,119,4255
"GCATCGGCATATGCGT",0,0,0,0,0,0,39
"GCATCGGGTTAAACAG",26,194,38,7,31,296,11713
"GCATCGGTCGCACGAC",0,0,0,0,0,0,19
"GCATCTCAGCATCAGG",1,40,5,0,5,51,2478
"GCATCTCAGCGGGTAT",2,18,4,0,4,28,871
"GCATCTCGTAGGAGTC",0,0,0,0,2,2,19
"GCATCTCGTGGCTGAA",4,17,3,0,5,29,746
"GCATCTCGTTCGCGTG",0,0,0,0,0,0,7
"GCATCTCTCCATTGCC",0,3,0,0,0,3,158
"GCATCTCTCGTTACCC",1,3,0,0,2,6,100
"GCATCTCTCTTGGAAC",1,9,2,0,7,19,324
"GCATGATAGCTCCATA",0,6,4,0,2,12,320
"GCATGATCACGAAGAC",2,7,2,0,2,13,30
"GCATGATCAGCGTACC",1,18,4,0,6,29,517
"GCATGATGTACAGTTC",0,3,6,0,2,11,548
"GCATGATGTCACAGAG",0,3,0,0,0,3,19
"GCATGATGTGCATGAG",0,2,0,0,0,2,33
"GCATGATTCATATGGC",0,2,2,0,0,4,65
"GCATGATTCGAACTCA",1,5,0,0,0,6,130
"GCATGATTCGCAAGAG",0,2,0,0,0,2,6
"GCATTAGAGGTCGCCT",2,0,0,0,0,2,98
"GCATTAGAGTTCACTG",0,3,0,0,0,3,110
"GCATTAGCAACTGATC",2,5,2,0,0,9,159
"GCATTAGCACCTGCGA",0,3,2,0,0,5,94
"GCATTAGCAGCAATTC",0,13,2,0,2,17,79
"GCATTAGGTGCGGATA",0,6,2,0,0,8,246
"GCATTAGTCACCATGA",0,0,0,0,0,0,10
"GCATTAGTCGGTTAGT",2,2,0,0,0,4,112
"GCCAACGAGCGCCTCA",21,7,3,0,4,35,900
"GCCAACGAGCTAAGTA",0,3,0,0,0,3,81
"GCCAACGAGTAAATGC",2,15,5,0,26,48,1375
"GCCAACGCAAATCAAG",218,75,29,12,38,372,10829
"GCCAACGCAAGAATAC",0,2,0,0,0,2,112
"GCCAACGGTCATCACA",0,0,0,0,0,0,14
"GCCAACGGTCGCTCGA",2,8,2,0,3,15,246
"GCCAACGGTGTATTGC",0,3,0,0,0,3,10
"GCCAACGGTTAAACAG",1,5,2,0,3,11,305
"GCCAACGTCTCCGCAT",0,4,2,0,0,6,131
"GCCAGCAAGCGAAACC",0,4,0,0,2,6,87
"GCCAGCACAATAACCC",2,9,0,0,2,13,285
"GCCAGCAGTATTTCCT",0,2,0,0,0,2,63
"GCCAGCAGTTGCCGCA",0,4,0,0,0,4,82
"GCCAGCATCCATCTCG",1,8,3,0,0,12,47
"GCCAGCATCTGTCGTC",0,4,0,0,0,4,70
"GCCAGGTAGACGATAT",0,0,0,0,0,0,98
"GCCAGGTAGAGCAGTC",5,85,16,4,15,125,2229
"GCCAGGTAGGGTGGGA",0,0,2,0,0,2,53
"GCCAGGTAGTTGAAAC",18,87,250,8,39,402,13623
"GCCAGGTCACAGGATG",1,7,3,0,0,11,331
"GCCAGGTCACCGGCTA",2,16,3,0,0,21,464
"GCCAGGTCAGCGTACC",0,0,0,0,0,0,15
"GCCAGGTGTCGATTAC",0,2,0,0,0,2,34
"GCCAGTGAGAAGCCAC",11,30,81,4,14,140,3246
"GCCAGTGAGGAAACGA",0,10,0,0,0,10,79
"GCCAGTGCACAGCGCT",10,6,7,2,2,27,664
"GCCAGTGTCGCAGATT",0,0,0,0,0,0,204
"GCCAGTGTCTTCTGGC",56,425,111,19,76,687,20842
"GCCATGGAGGCTAACG",4,16,2,34,8,64,1101
"GCCATGGAGTACCGGA",1,3,3,0,0,7,116
"GCCATGGAGTGCACTT",1,17,5,0,3,26,654
"GCCATGGCAAGACGGT",2,11,6,0,0,19,537
"GCCATGGGTCTAGGTT",2,9,11,3,4,29,367
"GCCATGGGTGAAAGTT",1,3,0,0,0,4,32
"GCCATGGGTGTTCGAT",2,10,0,0,0,12,136
"GCCATTCCAAATACGA",1,13,0,0,7,21,326
"GCCATTCCACGACGAA",0,3,0,0,0,3,60
"GCCATTCCAGGCATGA",0,2,0,0,0,2,45
"GCCATTCCAGGCCTGT",0,2,0,0,0,2,159
"GCCATTCGTTCACCGG",1,7,0,0,0,8,67
"GCCATTCTCTGTGCTC",2,2,2,0,0,6,66
"GCCCAGAAGAACTTCC",0,3,0,0,0,3,57
"GCCCAGAAGAATAACC",4,33,8,0,5,50,661
"GCCCAGAAGTGGCAGT",0,8,2,0,0,10,18
"GCCCAGACACGAAAGC",0,5,0,0,4,9,196
"GCCCAGACACTCTGCT",5,13,2,0,0,20,448
"GCCCAGACAGTCAGCC",2,5,0,0,2,9,149
"GCCCAGACATGTTTGG",2,7,3,0,0,12,275
"GCCCAGAGTATCCTCC",4,18,0,0,3,25,602
"GCCCAGATCACAGTGT",2,4,5,0,10,21,510
"GCCCAGATCATGAGAA",14,50,85,9,91,249,8178
"GCCCGAAAGAATTCAG",1,7,2,0,2,12,190
"GCCCGAAAGAGAGTTT",5,22,21,0,7,55,1411
"GCCCGAACAAAGGCGT",0,0,0,0,0,0,44
"GCCCGAACAGAAACCG",0,13,2,0,0,15,331
"GCCCGAAGTTCCTAGA",35,392,70,10,64,571,18615
"GCCCGAATCAACTGAC",5,18,14,0,3,40,364
"GCCCGAATCCCTGGTT",29,72,8,0,13,122,2901
"GCCCGAATCGCGTCGA",0,0,0,0,0,0,0
"GCCCGAATCGGAAACG",1,0,0,0,0,1,22
"GCCGATGCAAACTCGT",29,113,158,16,263,579,21434
"GCCGATGCAAGTGGTG",2,14,3,0,3,22,800
"GCCGATGGTCGCATTA",7,56,11,5,9,88,2456
"GCCGATGTCCGTGGGT",0,0,0,0,0,0,26
"GCCGTGACAAATGGCG",1,3,0,0,4,8,134
"GCCGTGATCTCCCTAG",0,2,0,0,0,2,157
"GCCTGTTCACATGTTG",0,5,0,0,0,5,65
"GCCTGTTCACGAGAAC",1,10,2,0,7,20,267
"GCCTGTTGTACAGGTG",4,3,0,0,4,11,331
"GCCTGTTGTATGAGGC",0,4,0,0,0,4,89
"GCCTGTTGTGCCTTCT",0,0,0,0,0,0,45
"GCCTGTTGTGTTAACC",0,2,2,0,0,4,87
"GCCTGTTTCCTCACCA",0,4,2,0,0,6,145
"GCGAGAAAGGCCTAGA",0,7,2,0,3,12,102
"GCGAGAAAGTTACGTC",0,5,0,0,0,5,64
"GCGAGAACACGGTGTC",0,0,0,0,0,0,132
"GCGAGAACATGCCATA",1,2,0,0,0,3,163
"GCGAGAAGTCAACACT",0,5,2,0,0,7,51
"GCGAGAAGTCTAGGTT",2,10,0,2,2,16,204
"GCGAGAATCAGTCTTT",2,17,3,0,3,25,382
"GCGAGAATCGGCTGGT",1,3,0,0,0,4,77
"GCGAGAATCTAGCAAC",0,0,0,0,0,0,3
"GCGATCGAGAGTGAAG",108,164,48,8,37,365,12225
"GCGATCGAGTGGCCTC",0,0,0,0,0,0,55
"GCGATCGGTAAGGCCA",1,14,2,0,2,19,552
"GCGATCGTCCGAAGGA",0,10,3,0,3,16,280
"GCGATCGTCTCGTGAA",1,20,5,10,3,39,960
"GCGGAAAAGTATAGAC",0,0,0,0,0,0,5
"GCGGAAAAGTCCCAAT",0,18,6,0,0,24,392
"GCGGAAATCTAAGCCA",85,776,144,38,135,1178,36504
"GCGGATCAGATGCAGC",11,134,28,4,25,202,8765
"GCGGATCAGTAATACG",3,12,20,0,7,42,1446
"GCGGATCAGTCACTAC",15,149,26,10,29,229,8658
"GCGGATCAGTCTAGAA",0,0,2,0,0,2,50
"GCGGATCAGTGGTTGG",0,4,2,0,0,6,13
"GCGGATCCATCGTGGC",0,17,4,0,5,26,576
"GCGGATCCATGGAAGC",2,6,2,0,0,10,71
"GCGGATCGTCCAAGAG",16,252,36,8,34,346,11252
"GCGGATCGTGCATTAC",1,0,0,0,0,1,21
"GCGGATCGTTCCAGGC",3,9,3,0,4,19,384
"GCGGATCGTTTCGTGA",0,0,0,0,0,0,4
"GCGGATCTCACCGGTG",0,0,0,0,0,0,8
"GCGGATCTCCTAAGTG",19,168,39,7,37,270,8472
"GCGGATCTCGAGCACC",0,8,2,0,2,12,314
"GCGGATCTCTGCAGCG",0,0,0,0,0,0,96
"GCGTGCACACTAGAGG",0,0,0,0,0,0,67
"GCGTGCACAGCAAGAC",5,78,13,3,13,112,3811
"GCGTGCACATAATGAG",0,3,2,0,2,7,137
"GCGTGCAGTTGCATTG",0,0,0,0,0,0,9
"GCGTGCATCCTAGCTC",2,8,0,0,0,10,240
"GCGTTTCAGGCGCTTC",0,0,0,0,0,0,21
"GCGTTTCCAAAGCTAA",447,1427,883,180,4042,6979,240935
"GCGTTTCCAGAGGAAA",0,10,0,0,6,16,322
"GCGTTTCCATTGAAAG",6,43,13,4,15,81,2373
"GCGTTTCGTCCTTTGC",0,4,0,0,0,4,131
"GCGTTTCGTCGCTCGA",1,4,0,0,0,5,103
"GCGTTTCGTGTAAATG",0,0,0,0,0,0,51
"GCGTTTCGTTGCCGAC",0,0,0,0,0,0,121
"GCGTTTCTCCCGGTAG",0,2,0,0,0,2,43
"GCGTTTCTCTGGTTGA",0,11,2,0,6,19,417
"GCTACAAAGAGCTGCA",0,15,0,0,3,18,306
"GCTACAAAGTGTACAA",0,4,0,0,0,4,110
"GCTACAACAACAGCTT",4,43,42,5,14,108,2482
"GCTACAACACATATCG",76,688,221,65,207,1257,40558
"GCTACAACAGTGGGTA",2,6,0,0,4,12,182
"GCTACAAGTCACCGAC",0,3,0,0,0,3,121
"GCTACAAGTGAACGGT",83,356,371,47,478,1335,45688
"GCTACAAGTGGACTGA",44,137,72,411,81,745,21633
"GCTACAATCACCGGGT",4,21,5,2,13,45,917
"GCTACAATCTACACAG",4,14,5,2,5,30,452
"GCTACCTAGAGCAGTC",0,4,0,0,0,4,52
"GCTACCTCAATTGGTC",1,12,3,0,4,20,315
"GCTACCTGTAACAGTA",1,3,2,0,3,9,142
"GCTACCTTCATCCCGT",3,16,4,0,6,29,529
"GCTACCTTCCATTCGC",0,11,2,0,0,13,601
"GCTCAAAAGCATTGAA",9,37,63,6,50,165,5852
"GCTCAAAAGCCGTTGC",1,11,0,0,6,18,399
"GCTCAAAAGGGAGAAT",0,2,2,0,0,4,51
"GCTCAAAAGGTAAGGA",0,0,0,0,0,0,0
"GCTCAAACACCGGAAA",0,0,0,0,0,0,9
"GCTCAAAGTCCGGATC",34,359,67,21,53,534,17963
"GCTCAAAGTCTTACTT",0,14,0,0,0,14,704
"GCTCAAAGTGTGAGCA",0,5,6,0,4,15,720
"GCTCAAATCACTTTGT",11,81,63,7,68,230,7239
"GCTCAAATCCGAACGC",0,0,0,0,0,0,18
"GCTCAAATCGTAACCA",143,1507,316,65,253,2284,71361
"GCTGAATAGACGAAGA",0,4,0,0,0,4,60
"GCTGAATAGGCGCTCT",0,0,0,0,0,0,3
"GCTGAATAGGTACTGG",0,0,2,0,0,2,28
"GCTGAATAGTCTTGGT",1,7,0,0,0,8,114
"GCTGAATAGTTTCAGC",9,35,11,0,10,65,2089
"GCTGAATCACACCGCA",4,55,8,3,15,85,2533
"GCTGAATCACCCTTAC",0,4,2,0,0,6,221
"GCTGAATGTACATACC",0,3,2,0,0,5,79
"GCTGAATGTCAAAGCG",0,3,0,0,0,3,19
"GCTGAATTCAAATAGG",2,22,31,4,5,64,2418
"GCTGAATTCCATCTAT",0,3,0,0,5,8,214
"GCTGAATTCGCACGGT",3,18,8,2,31,62,1333
"GCTGAATTCTAACACG",1,3,5,0,2,11,542
"GCTGCAGCAAGACCTT",0,7,0,0,0,7,157
"GCTGCAGCACCCTGAG",3,22,10,4,40,79,3076
"GCTGCAGTCAGGAACG",1,9,4,0,2,16,236
"GCTGGGTAGAGTTCGG",13,114,19,7,21,174,6670
"GCTGGGTAGGTCGACA",4,8,0,0,3,15,189
"GCTGGGTAGTTGGAAT",2,10,4,0,5,21,249
"GCTGGGTCACAAGTGG",2,4,4,0,3,13,366
"GCTGGGTCAGACACAG",5,54,80,2,16,157,4885
"GCTGGGTTCCCATACC",0,0,0,0,0,0,91
"GCTGGGTTCCCTGTTG",0,3,0,0,0,3,52
"GCTGGGTTCCGATCTC",3,10,0,0,2,15,298
"GCTGGGTTCGATCCAA",1,16,4,0,7,28,332
"GCTGGGTTCTCGCAGG",0,0,0,0,0,0,63
"GCTTCACAGGGTGAAA",0,2,2,0,0,4,243
"GCTTCACGTACCTTCC",0,0,0,0,0,0,2
"GCTTCACGTAGGTCAG",3,9,10,0,13,35,1547
"GCTTCACGTCTCGCGA",2,2,0,0,0,4,19
"GCTTCACTCATTGTTC",0,3,0,0,2,5,99
"GCTTCACTCCACAAGT",2,3,4,0,0,9,134
"GCTTCACTCCACATAG",1,13,0,0,0,14,301
"GCTTCACTCGTCAAAC",0,0,0,0,0,0,24
"GCTTGGGCACAAATCC",0,0,0,0,0,0,32
"GCTTGGGCAGCAAGAC",0,2,0,0,3,5,87
"GCTTGGGCATTCGGGC",2,4,2,0,2,10,142
"GCTTGGGGTCCAATCA",2,6,2,0,2,12,523
"GCTTGGGGTGACCGTC",1,13,0,0,4,18,309
"GCTTGGGGTGGAGGTT",3,9,6,0,3,21,291
"GCTTGGGTCCTCTCGA",1,3,0,0,2,6,294
"GCTTTCGAGGCGAAGG",0,0,2,2,0,4,127
"GCTTTCGCAGTACTAC",0,7,0,0,2,9,129
"GCTTTCGCATCGATAC",0,0,0,0,0,0,32
"GCTTTCGGTCGCTCGA",1,14,2,0,2,19,329
"GCTTTCGTCAATGCAC",3,2,0,0,0,5,85
"GCTTTCGTCCATCTGC",0,4,0,0,0,4,179
"GCTTTCGTCTATTCGT",13,52,66,8,97,236,7623
"GCTTTCGTCTTTGCGC",2,9,4,3,0,18,563
"GGAACCCAGACCGTTT",2,16,3,2,4,27,470
"GGAACCCAGGACTAAT",0,5,2,0,0,7,75
"GGAACCCAGTATGAAC",89,409,167,42,986,1693,48710
"GGAACCCAGTCACTGT",7,24,3,0,4,38,904
"GGAACCCCATCCGCGA",1,13,0,0,0,14,428
"GGAACCCGTAACTTCG",1,2,2,0,0,5,80
"GGAACCCGTGCATTAC",0,3,0,0,0,3,61
"GGAACCCGTTCATCTT",1,40,6,2,43,92,2587
"GGAACCCTCGCCACTT",0,5,2,0,2,9,99
"GGAAGTGAGCAGGCTA",2,14,12,0,5,33,739
"GGAAGTGAGTTGGAAT",1,3,0,0,0,4,55
"GGAAGTGCAAAGGTTA",2,8,8,0,5,23,47
"GGAAGTGGTCTACACA",1,3,0,0,0,4,143
"GGAAGTGTCACGTCCT",0,8,2,0,2,12,30
"GGAAGTGTCCGACAGC",1,7,0,0,2,10,123
"GGAAGTGTCGTGCATA",0,0,0,0,0,0,17
"GGAATCTAGAACTCCT",0,0,0,0,0,0,20
"GGAATCTAGAGTCAGC",0,3,0,0,0,3,64
"GGAATCTAGTGGCAGT",3,18,3,0,6,30,541
"GGAATCTCAGCCCACA",14,46,12,3,8,83,2848
"GGAATCTCAGGACATG",0,2,2,0,0,4,78
"GGAATCTCAGGCATGA",85,85,58,151,52,431,9054
"GGAATCTCATGGCCAC",0,6,0,0,2,8,200
"GGAATCTCATTGCTGA",2,17,10,0,8,37,529
"GGAATCTGTGCACATT",40,337,69,22,58,526,18311
"GGAATCTGTGTTGAGG",8,70,16,2,16,112,3573
"GGAATCTTCAGCGCGT",3,8,6,0,22,39,914
"GGAATCTTCATCCCGT",1,0,0,0,0,1,57
"GGAATGGAGAAATTCG",11,53,143,3,31,241,8141
"GGAATGGCATAATCGC",0,14,3,0,2,19,276
"GGAATGGGTAGTGATA",2,27,15,0,6,50,892
"GGAATGGGTATTCCGA",0,8,2,0,0,10,252
"GGAATGGGTTAACAGA",0,0,0,0,0,0,0
"GGAATGGGTTATAGCC",4,6,3,0,0,13,237
"GGAATGGGTTGGTAGG",0,13,2,0,5,20,236
"GGAATGGTCCTGGGTG",2,7,0,0,0,9,143
"GGACGTCAGATGGGCT",1,9,4,0,2,16,261
"GGACGTCAGCTAGCCC",0,2,0,0,0,2,5
"GGACGTCAGGTCGACA",20,216,44,13,32,325,11148
"GGACGTCCAACCGACC",0,2,0,0,0,2,16
"GGACGTCCAGCGTAGA",79,1097,212,35,173,1596,50096
"GGACGTCCATTAGGCT",1,7,0,0,0,8,148
"GGACGTCGTAGGTACG",0,11,3,0,2,16,25
"GGACGTCGTATCGAAA",0,2,0,0,0,2,27
"GGACGTCGTATGACAA",271,169,53,23,47,563,10807
"GGACGTCGTCTGTAAC",0,0,0,0,0,0,0
"GGACGTCGTTCCATTT",1,6,0,0,3,10,21
"GGAGAACAGGACAAGA",0,0,0,0,0,0,52
"GGAGAACCAACATACC",0,12,2,0,3,17,44
"GGAGAACCAAGATGGC",0,0,0,0,0,0,13
"GGAGAACGTCCACAGC",0,8,4,0,2,14,318
"GGAGAACTCGTAGAGG",1,4,0,0,0,5,37
"GGAGATGAGAAACTCA",4,11,4,0,3,22,272
"GGAGATGAGGGTGAGG",28,275,84,15,54,456,14112
"GGAGATGAGTTGCCTA",0,0,0,0,0,0,27
"GGAGATGCAAACTCTG",0,13,3,0,2,18,444
"GGAGATGCACGTAGAG",8,83,15,4,14,124,3980
"GGAGATGGTAATCAAG",52,289,152,20,446,959,26984
"GGAGATGGTCGGATTT",0,22,5,0,8,35,348
"GGAGATGTCCATAGAC",0,10,2,0,0,12,226
"GGAGATGTCTTGATTC",3,17,5,2,17,44,847
"GGAGCAAAGTACTGGG",61,548,88,16,95,808,29580
"GGAGCAACACCTCAGG",0,2,0,0,0,2,60
"GGAGCAAGTTTACCAG",0,3,2,0,2,7,89
"GGAGGATAGACGCCAA",0,2,0,0,0,2,59
"GGAGGATAGTAAAGCT",3,14,4,0,6,27,182
"GGAGGATAGTACTCGT",0,0,0,0,0,0,13
"GGAGGATCACTGCACG",0,3,0,0,0,3,32
"GGAGGATCAGAGTGAC",0,0,0,0,0,0,44
"GGAGGATGTATCATGC",0,0,0,0,0,0,20
"GGAGGATGTCGTCATA",13,120,28,3,22,186,4811
"GGAGGATTCACTTGGA",0,0,0,0,0,0,2
"GGAGGATTCAGCAGAG",0,7,0,0,0,7,76
"GGAGGATTCCTGTAAG",116,50,16,8,23,213,4749
"GGAGGATTCTTACACT",0,0,0,0,0,0,2
"GGAGGTAAGGAATCGC",0,7,5,0,2,14,424
"GGAGGTACAATCCAGT",1,0,0,0,0,1,17
"GGAGGTACAGAAGCGT",0,4,2,0,0,6,190
"GGAGGTAGTAATTAGG",2,4,0,0,0,6,35
"GGAGGTAGTCCTCAGG",0,0,0,0,0,0,39
"GGAGGTAGTGAATAAC",0,5,2,0,0,7,26
"GGAGGTAGTTCGGACC",1,11,6,0,3,21,446
"GGAGGTAGTTCGTACA",0,6,0,0,0,6,85
"GGAGGTATCGATGGAG",29,87,239,13,47,415,15529
"GGATCTAAGACCGTTT",0,3,0,0,0,3,82
"GGATCTACAAGAGATT",0,2,0,0,0,2,28
"GGATCTACACACTGGC",1,10,0,0,4,15,340
"GGATCTACACTGTCGG",0,0,0,0,0,0,12
"GGATCTACAGTTAAAG",5,37,12,2,12,68,1980
"GGATCTAGTACCCACG",0,0,0,0,0,0,7
"GGATCTAGTATCGCTA",0,0,0,0,0,0,3
"GGATCTAGTCGCTTAA",1,10,4,0,49,64,1190
"GGATCTAGTGCCCACA",1,3,0,0,0,4,115
"GGATCTAGTGTCCATA",5,49,21,4,10,89,2096
"GGATCTAGTTGCCAAT",0,9,4,0,5,18,261
"GGATCTATCCGTGTCT",4,32,9,3,9,57,1783
"GGATCTATCGGATACT",2,25,11,2,29,69,1567
"GGATCTATCTGTCAGA",5,33,24,2,9,73,1143
"GGATGTTCAATTCTCT",0,23,9,0,7,39,465
"GGATGTTGTCGTCATA",1,0,0,0,0,1,13
"GGATGTTTCATTTGGG",17,62,153,4,25,261,10414
"GGATGTTTCCTCACTG",0,3,0,0,0,3,17
"GGATGTTTCTGCGGCA",8,26,62,2,11,109,2871
"GGCACGTAGCCACAAG",0,2,0,0,0,2,23
"GGCACGTAGTCGGCCT",1,4,0,0,0,5,58
"GGCACGTGTCGCGGTT",5,16,31,2,23,77,1368
"GGCACGTGTCGTACAT",0,2,0,0,0,2,5
"GGCACGTTCATCGTAG",0,0,0,0,0,0,20
"GGCAGTCAGACTTGTC",0,0,0,0,0,0,8
"GGCAGTCAGCCGTCGT",0,0,0,0,0,0,53
"GGCAGTCAGGGCCAAT",1,2,0,0,0,3,60
"GGCAGTCAGTTGTCGT",8,34,91,2,13,148,3054
"GGCAGTCCAAGCGAGT",0,2,0,0,0,2,7
"GGCAGTCCATTCTCTA",0,0,0,0,0,0,4
"GGCAGTCGTCACGACC",1,7,0,0,0,8,109
"GGCAGTCGTGCGTGCT",0,0,0,0,0,0,1
"GGCGTCAAGCACACCC",2,0,0,0,0,2,14
"GGCGTCAAGCATTTGC",0,0,0,0,0,0,11
"GGCGTCACAATTGAAG",0,0,0,0,2,2,26
"GGCGTCACACGCGCAT",50,660,100,19,81,910,22829
"GGCGTCACAGGCATGA",1,4,3,0,0,8,12
"GGCGTCACATGTGTCA",0,3,0,0,0,3,96
"GGCGTCAGTCAAGTTC",0,0,0,0,0,0,1
"GGCGTCAGTCGGAACA",0,0,0,0,0,0,7
"GGCGTCAGTTCCTACC",10,56,181,6,23,276,5351
"GGCGTCAGTTTACCAG",0,3,4,0,0,7,97
"GGCGTCATCACCCTTG",0,0,0,0,0,0,8
"GGCGTCATCACCTCAC",1,14,30,0,8,53,923
"GGCGTCATCCAAGCTA",0,0,0,0,0,0,27
"GGCGTCATCGTGGAAG",6,39,109,6,51,211,4983
"GGCTGTGCAAGGATGC",1,7,2,0,0,10,184
"GGCTGTGCAGCGCTTG",0,0,0,0,0,0,2
"GGCTGTGTCAACCTCC",2,8,0,0,0,10,230
"GGCTGTGTCGCCGAGT",1,2,0,0,0,3,48
"GGCTGTGTCTGGAGAG",0,0,0,0,0,0,17
"GGCTTGGAGAGTTGCG",0,0,0,0,0,0,18
"GGCTTGGAGATCACCT",0,2,0,0,0,2,6
"GGCTTGGAGTTGAAGT",0,0,0,0,0,0,2
"GGCTTGGCATCGTGCG",1,0,0,0,0,1,31
"GGCTTGGGTGTCTTAG",0,3,0,0,0,3,58
"GGCTTGGTCCCGTGAG",0,10,2,0,0,12,147
"GGCTTGGTCTACGCAA",0,4,0,0,0,4,15
"GGCTTTCAGCAAACAT",6,63,7,6,11,93,2234
"GGCTTTCCAAGTGGTG",22,93,92,7,222,436,11333
"GGCTTTCCAGGCATTT",0,0,0,0,0,0,17
"GGCTTTCGTATGACAA",0,0,0,0,0,0,0
"GGCTTTCGTCATAAAG",0,0,0,0,0,0,35
"GGCTTTCGTCTAGATC",5,43,13,0,8,69,1467
"GGCTTTCGTGCATACT",2,3,0,0,0,5,41
"GGCTTTCTCAGCTTGA",4,58,9,2,15,88,2203
"GGCTTTCTCTACTGAG",0,0,2,0,0,2,18
"GGGAAGTAGATGCCGA",0,0,0,0,0,0,47
"GGGAAGTAGCTGTACT",0,0,0,0,0,0,55
"GGGAAGTAGGATGAGA",0,3,0,0,0,3,97
"GGGAAGTAGTTCCTGA",0,0,0,0,0,0,2
"GGGAAGTCAACGTTAC",1,3,0,0,0,4,15
"GGGAAGTCAAGAAATC",2,7,6,0,2,17,245
"GGGAAGTCAAGTAGTA",0,10,4,2,0,16,200
"GGGAAGTCATAGAGGC",0,0,0,0,0,0,24
"GGGAAGTGTATGGAGC",4,24,6,0,6,40,590
"GGGAAGTGTGAATGTA",0,9,0,0,0,9,43
"GGGAAGTGTTACACAC",0,11,0,0,2,13,238
"GGGAAGTGTTCTGACA",6,4,5,0,3,18,294
"GGGAAGTTCACTTCTA",2,29,14,0,12,57,1785
"GGGAAGTTCCGATAGT",0,3,0,0,2,5,78
"GGGACAAAGAGGTTTA",1,3,2,0,0,6,116
"GGGACAAAGGTAAGTT",2,2,0,0,0,4,70
"GGGACAACAATTTCCT",1,8,5,0,2,16,33
"GGGACAACACAGTATC",5,27,49,2,8,91,2693
"GGGACAACAGCTGTAT",0,0,0,0,0,0,24
"GGGACAACAGTCAGCC",0,6,0,0,2,8,178
"GGGACAACATCAACCA",10,82,20,3,15,130,4427
"GGGACAAGTGCTCTTC",52,382,177,23,160,794,26476
"GGGACAATCAGCTGAT",1,17,5,2,5,30,388
"GGGACCTAGTATGGCG",0,2,0,0,0,2,70
"GGGACCTCAACTCCAA",0,5,0,0,0,5,45
"GGGACCTCAGAGGAAA",0,0,0,0,2,2,66
"GGGACCTTCTCCGCAT",1,9,0,3,0,13,214
"GGGACTCAGCGACTAG",1,8,2,0,4,15,290
"GGGACTCCAATACAGA",1,0,0,0,0,1,76
"GGGACTCGTCCGTACG",0,5,0,0,2,7,277
"GGGACTCGTTCAAGTC",1,2,0,0,0,3,91
"GGGACTCTCACTTATC",0,3,0,0,0,3,79
"GGGAGATAGAAACTGT",2,3,4,0,0,9,88
"GGGAGATAGCAAGTGC",0,6,0,0,2,8,20
"GGGAGATAGGCGACAT",0,0,0,0,0,0,46
"GGGAGATTCACGACTA",8,145,23,5,26,207,6875
"GGGAGTAAGCAGAAAG",29,29,12,3,7,80,1144
"GGGAGTAAGCCTCAAT",0,15,3,0,3,21,203
"GGGAGTACAACACAGG",2,11,4,0,5,22,623
"GGGAGTACATAATCCG",1,8,2,0,0,11,140
"GGGAGTACATAGCTGT",2,8,2,0,0,12,211
"GGGAGTAGTCTGTCAA",1,4,0,0,0,5,85
"GGGAGTAGTGCATTTG",0,6,7,0,5,18,323
"GGGAGTATCCCTTTGG",0,3,0,0,0,3,77
"GGGAGTATCGAGTTGT",0,10,3,0,5,18,191
"GGGATCCAGCGCCCAT",0,0,0,0,0,0,36
"GGGATCCAGCGCCTAC",6,24,10,5,40,85,2737
"GGGATCCAGGCATCTT",0,6,0,0,2,8,207
"GGGATCCAGTGCACCC",0,0,0,0,0,0,7
"GGGATCCCAGCCGTCA",0,0,0,0,0,0,26
"GGGATCCCATTCACCC",0,5,0,0,0,5,61
"GGGATCCGTTAGAAAC",0,2,0,0,0,2,64
"GGGATCCTCAAGTAAG",1,2,0,0,3,6,118
"GGGATCCTCCTTGACC",0,0,0,0,0,0,32
"GGGATCCTCTACACTT",2,5,0,0,0,7,41
"GGGATGAAGCTGACTT",13,57,30,3,176,279,9075
"GGGATGACAAAGGCAC",0,0,0,0,0,0,0
"GGGATGAGTAGGAGTC",13,209,45,7,23,297,8415
"GGGATGAGTGGACCTC",0,12,3,0,0,15,148
"GGGATGAGTTACCTGA",3,11,6,0,3,23,264
"GGGATGAGTTAGGCCC",0,0,0,0,0,0,32
"GGGATGAGTTAGGGAC",2,11,3,0,0,16,415
"GGGATGAGTTAGGGTG",41,25,10,2,14,92,3697
"GGGCCATAGGTAACTA",1,3,0,0,3,7,55
"GGGCCATAGTAATACG",0,2,0,0,0,2,69
"GGGCCATAGTGATAAC",0,0,0,0,0,0,54
"GGGCCATAGTTTCGGT",0,2,0,0,0,2,8
"GGGCCATCAGGCTTGC",163,1491,320,54,258,2286,67761
"GGGCCATGTGAGATTA",1,3,2,0,0,6,46
"GGGCCATGTTAAGGAT",0,3,0,0,0,3,79
"GGGCCATGTTGCAAGG",0,5,0,0,2,7,172
"GGGCCATTCTTTCCGG",2,7,3,3,2,17,432
"GGGCGTTAGGAACGAA",0,10,2,0,3,15,146
"GGGCGTTCAAAGACTA",0,2,0,0,0,2,23
"GGGCGTTGTAATTGGA",1,2,0,0,3,6,34
"GGGCGTTGTGAATGAT",10,65,21,8,16,120,2824
"GGGCGTTGTTTCCATT",2,6,0,0,4,12,487
"GGGCGTTTCGCAACAT",0,0,0,0,0,0,10
"GGGCTACAGTAGAATC",0,0,0,0,0,0,6
"GGGCTACCAAGTATAG",0,2,0,0,0,2,12
"GGGCTACCACCATATG",0,2,0,0,0,2,31
"GGGCTACGTCCAGAAG",0,3,2,0,0,5,25
"GGGCTACTCAGCAGAG",0,8,0,0,0,8,148
"GGGCTACTCCAGCACG",3,9,2,0,0,14,238
"GGGCTACTCTATCGCC",0,9,3,0,3,15,301
"GGGCTACTCTGGGCGT",191,450,71,15,74,801,24095
"GGGCTCAAGACATAGT",118,640,266,53,1237,2314,69123
"GGGCTCAAGTTGGCTT",0,0,0,0,0,0,33
"GGGCTCACAGGGACTA",100,1218,237,49,183,1787,59822
"GGGCTCAGTCAATGGG",20,155,59,9,46,289,6940
"GGGCTCAGTGAAAGTT",0,0,0,0,0,0,2
"GGGTAGAAGTACCATC",0,12,6,0,4,22,283
"GGGTAGACAGACCTAT",0,2,0,0,0,2,31
"GGGTAGAGTGCCGAAA",0,0,0,0,0,0,19
"GGGTAGATCGGACGTC",1,3,0,0,0,4,132
"GGGTAGATCGTGGCGT",1,4,0,0,0,5,370
"GGGTAGATCTCAGTCC",1,28,5,0,5,39,1030
"GGGTATTAGCTCAGAG",0,10,0,0,0,10,145
"GGGTATTAGGGTTAAT",0,13,4,0,4,21,167
"GGGTATTCAAATCAAG",5,31,61,3,12,112,3671
"GGGTATTGTATAATGG",3,16,3,0,3,25,79
"GGGTATTGTCACAGTT",1,8,7,0,12,28,489
"GGGTATTTCCAAGAGG",0,0,0,0,0,0,5
"GGGTATTTCGTGCACG",1,0,0,0,2,3,106
"GGGTCACCAATTGCTG",0,0,0,0,0,0,17
"GGGTCACCAGTAGTGG",0,0,0,0,0,0,3
"GGGTCACGTACTGGGA",1,16,0,0,0,17,280
"GGGTCACGTAGCGTCC",0,0,0,0,0,0,27
"GGGTCACGTCGGCACT",0,3,0,0,0,3,94
"GGGTCACGTCTCTCAC",0,0,0,0,0,0,86
"GGGTCACGTTATTCCT",6,30,3,0,8,47,1143
"GGGTCACTCCTCATAT",53,40,13,0,14,120,3584
"GGGTCACTCGAGAATA",42,580,76,14,104,816,28521
"GGGTCTGAGTCATGGG",0,4,0,2,2,8,79
"GGGTCTGCACTGAGGA",7,3,0,0,2,12,294
"GGGTCTGCAGATACCT",1,5,0,0,2,8,85
"GGGTCTGCAGCACCCA",37,32,8,3,9,89,2515
"GGGTCTGCAGCGTGCT",2,6,4,0,2,14,463
"GGGTCTGGTAGGACCA",2,13,5,0,3,23,221
"GGGTCTGGTCCGTACG",0,2,0,0,0,2,39
"GGGTCTGGTTTCGGCG",33,295,64,16,57,465,11833
"GGGTCTGTCGGATACT",0,0,0,0,0,0,19
"GGGTGAAAGGCTAACG",0,4,0,0,0,4,42
"GGGTGAAAGTCGAGGT",10,25,15,3,55,108,3000
"GGGTGAAAGTGATAGT",4,24,7,2,4,41,812
"GGGTGAACATTAGGCT",2,4,2,0,3,11,464
"GGGTGAAGTAGTGCGA",0,2,0,0,0,2,39
"GGGTGAAGTATCGTGT",6,0,0,0,0,6,118
"GGGTGAAGTGCCTGAC",0,7,0,0,0,7,79
"GGGTGAAGTTACGGAG",2,4,0,0,2,8,169
"GGGTGTCCACATAACC",1,0,0,0,0,1,77
"GGGTGTCCACGCTTAA",0,11,3,0,0,14,339
"GGGTGTCTCAGGGTAG",0,0,0,0,0,0,73
"GGGTGTCTCCTTCGAC",0,3,0,0,2,5,60
"GGGTGTCTCGGCCTTT",3,17,7,3,4,34,355
"GGGTGTCTCTGACAGT",0,0,2,0,2,4,63
"GGGTTATAGAAGCCAC",1,15,5,0,4,25,284
"GGGTTATAGCGTACAG",0,0,0,0,0,0,99
"GGGTTATCAGCAGACA",1,3,0,0,2,6,81
"GGGTTATCAGTGTGCC",4,13,4,0,2,23,412
"GGGTTATCAGTTGTCA",47,580,91,23,100,841,26472
"GGGTTATCATACTGAC",1,12,7,0,4,24,421
"GGGTTATCATCCTATT",0,7,0,0,0,7,161
"GGGTTATTCCGGCAGT",0,7,2,0,0,9,110
"GGGTTATTCTCATGGA",2,11,0,0,0,13,143
"GGGTTTAAGCAGCACA",0,2,0,0,0,2,39
"GGGTTTAAGGAAAGTG",0,3,0,0,0,3,12
"GGGTTTACAACTGATC",0,3,3,0,0,6,65
"GGGTTTACAAGACGAC",0,2,2,0,0,4,62
"GGGTTTACAGGTCCCA",1,14,2,0,4,21,237
"GGGTTTAGTGCATCTA",1,4,0,0,2,7,49
"GGGTTTAGTTAGAGAT",0,3,2,0,0,5,98
"GGGTTTATCGGTTCAA",1,0,0,0,0,1,38
"GGGTTTATCGTTTACT",13,70,30,2,13,128,3551
"GGTAACTAGAGCCTGA",1,19,7,4,23,54,1729
"GGTAACTAGCTCCCTT",1,0,0,0,3,4,107
"GGTAACTAGGGCAAGG",0,2,0,0,0,2,47
"GGTAACTAGGTAAGGA",0,3,0,0,0,3,17
"GGTAACTAGGTTTGAA",0,0,0,0,2,2,8
"GGTAACTAGTCCCTAA",2,13,0,0,2,17,204
"GGTAACTCAGAAGCTG",0,9,5,0,3,17,204
"GGTAACTCATTGAGGG",1,3,2,0,0,6,110
"GGTAACTGTAACATGA",0,3,0,0,0,3,35
"GGTAACTGTCTTCGAA",1,4,0,0,0,5,187
"GGTAACTTCCGGCAGT",0,2,0,0,0,2,67
"GGTAACTTCGCAGTTA",3,41,12,2,5,63,2304
"GGTAATCAGCGACCCT",0,0,0,0,0,0,81
"GGTAATCAGGTAGCAC",0,3,0,0,0,3,50
"GGTAATCCATAAGCGG",2,21,3,0,5,31,786
"GGTAATCGTACGTACT",4,11,6,2,3,26,469
"GGTAATCGTAGCGAGT",15,11,3,0,3,32,850
"GGTAATCGTTGCTGAT",20,78,70,6,167,341,11656
"GGTAATCTCCTCACTG",1,20,6,2,16,45,1050
"GGTAATCTCTTCGGAA",1,4,0,0,0,5,119
"GGTAGAGAGATGCGAC",2,15,3,0,13,33,838
"GGTAGAGAGCTGACTT",17,85,37,14,221,374,12193
"GGTAGAGGTTGTGCCG",3,13,0,0,2,18,291
"GGTAGAGGTTTGAAAG",0,0,0,0,0,0,2
"GGTAGAGTCACAAGAA",4,34,8,0,0,46,96
"GGTAGAGTCGCTGACG",1,8,0,0,0,9,70
"GGTAGAGTCTGGGTCG",19,170,27,19,33,268,7879
"GGTAGAGTCTTGCGCT",2,7,2,0,2,13,227
"GGTCACGAGCCAGTAG",3,28,4,0,4,39,838
"GGTCACGAGGTTAGTA",0,3,0,0,0,3,46
"GGTCACGCAATACCTG",1,4,4,0,0,9,84
"GGTCACGGTAAGATTG",7,108,13,4,20,152,4882
"GGTCACGGTATGAAAC",1,0,0,0,0,1,4
"GGTCACGTCCTAAGTG",0,0,0,0,0,0,0
"GGTCACGTCGGTTAGT",0,3,0,0,0,3,17
"GGTCTGGAGAAACTAC",2,37,5,0,13,57,1255
"GGTCTGGAGAAAGTCT",1,7,0,0,0,8,179
"GGTCTGGAGACCACGA",3,19,12,0,3,37,1254
"GGTCTGGAGACTCATC",0,2,0,0,0,2,39
"GGTCTGGAGATTACCC",1,5,2,0,4,12,233
"GGTCTGGCAAGGGCAT",0,2,0,0,0,2,97
"GGTCTGGCAGGATTCT",1,2,0,0,0,3,41
"GGTCTGGCAGTAGTTC",0,2,0,0,0,2,3
"GGTCTGGCATGCAGGA",0,0,0,0,0,0,120
"GGTCTGGGTAGTTACC",0,0,0,0,0,0,22
"GGTCTGGGTATGGAAT",0,0,2,0,0,2,24
"GGTCTGGTCCATTTAC",0,0,0,0,0,0,3
"GGTGAAGAGGGTTTCT",1,15,0,2,9,27,185
"GGTGAAGCAAACACCT",32,132,297,13,178,652,24660
"GGTGAAGCACGACTAT",0,4,2,0,0,6,90
"GGTGAAGCACGGCCAT",6,41,23,6,125,201,7226
"GGTGAAGCACTGGCCA",22,196,34,3,25,280,10066
"GGTGAAGCACTGTGAT",1,4,0,0,0,5,69
"GGTGAAGGTAGGCTCC",21,191,43,9,33,297,11134
"GGTGAAGGTTGTAAAG",5,52,12,4,9,82,2440
"GGTGAAGTCCATTTGT",1,14,0,0,2,17,212
"GGTGAAGTCCTCACCA",3,22,6,0,29,60,1628
"GGTGAAGTCGTGCAGC",0,5,3,0,2,10,117
"GGTGATTAGGAGAGGC",84,175,40,7,41,347,10624
"GGTGATTAGGCATTTC",0,0,0,0,0,0,5
"GGTGATTAGGCCTGAA",0,0,0,0,0,0,63
"GGTGATTCATAGGTAA",14,57,26,5,118,220,6815
"GGTGATTGTAGTATAG",0,2,0,0,0,2,17
"GGTGATTTCAAGTGGG",7,71,15,2,11,106,3657
"GGTGATTTCATAAGGA",0,3,0,0,0,3,24
"GGTGGCTAGGTCCCTG",1,9,2,0,4,16,210
"GGTGGCTAGTATCTGC",2,3,0,0,0,5,71
"GGTGGCTCAATGGCCC",0,0,0,0,0,0,1
"GGTGGCTCACGACGCT",0,4,0,0,0,4,60
"GGTGGCTGTTATCTGG",0,0,0,0,0,0,0
"GGTGGCTTCCCATAAG",0,11,4,0,5,20,331
"GGTGGCTTCGACCACG",0,0,0,0,0,0,31
"GGTGGCTTCTTCGATT",0,0,0,0,0,0,3
"GGTGTCGAGGTGGCTA",0,7,0,0,2,9,305
"GGTGTCGCAGCAGACA",0,0,0,0,0,0,85
"GGTGTCGCATAGCTGT",0,2,2,0,0,4,33
"GGTGTCGGTTTGGGAG",1,4,6,0,5,16,248
"GGTGTCGTCTAACGGT",0,0,0,0,0,0,20
"GGTGTTAAGAGCTGAC",0,0,0,0,0,0,40
"GGTGTTACAGAGGTTG",1,8,0,0,0,9,552
"GGTGTTACATGTAACC",0,3,0,0,0,3,69
"GGTGTTAGTACAAACA",0,0,2,0,0,2,90
"GGTGTTAGTCACTAGT",1,14,5,2,8,30,397
"GGTGTTAGTCCGACGT",0,2,0,0,0,2,4
"GGTGTTAGTGTCCACG",13,110,46,7,25,201,5396
"GGTGTTAGTTCGAACT",1,12,4,0,3,20,343
"GGTGTTATCAACGAGG",0,10,5,0,0,15,240
"GGTGTTATCACCGGTG",0,0,0,0,0,0,11
"GGTGTTATCTGCCTCA",1,17,4,0,3,25,218
"GGTTAACAGCTGGCTC",0,0,0,0,0,0,4
"GGTTAACAGGCATGGT",1,12,0,0,2,15,282
"GGTTAACCAGGTCTCG",0,14,2,0,2,18,249
"GGTTAACGTGCTCTCT",28,108,286,15,69,506,19366
"GGTTAACGTGTTGATC",0,3,0,0,0,3,91
"GGTTAACGTTACACTG",0,5,0,0,0,5,44
"GGTTAACGTTAGGCCC",1,2,2,0,0,5,107
"GGTTAACTCCCGGTAG",0,0,0,0,0,0,27
"GGTTAACTCTACTATC",1,6,0,0,0,7,57
"GGTTCTCAGCGAGTCA",0,0,0,0,0,0,7
"GGTTCTCAGGCATCGA",2,24,2,0,6,34,812
"GGTTCTCAGTAGAATC",2,0,2,0,0,4,58
"GGTTCTCCACTACACA",165,150,39,9,37,400,12072
"GGTTCTCCATCTGGGC",0,2,2,0,2,6,71
"GGTTCTCCATCTGTTT",1,4,0,0,0,5,106
"GGTTCTCGTTTCGTGA",0,0,0,0,0,0,55
"GGTTGTAAGAGGACTC",0,0,0,0,0,0,41
"GGTTGTAGTAGCACGA",2,24,3,0,4,33,965
"GGTTGTATCACTTATC",0,8,2,0,2,12,99
"GGTTGTATCGAACACT",0,2,0,0,0,2,73
"GGTTGTATCGCAATTG",0,10,3,0,0,13,103
"GGTTGTATCTGAGGTT",0,0,0,0,0,0,7
"GTAACACAGGCTGAAC",3,40,5,0,4,52,1418
"GTAACACCAGACAAAT",0,4,3,0,6,13,123
"GTAACACCAGAGGCAT",0,4,2,0,0,6,54
"GTAACACTCAGTGGGA",2,13,7,0,6,28,417
"GTAACACTCCTGCTAC",0,0,0,0,0,0,87
"GTAACCAAGACTACGG",2,15,4,0,6,27,358
"GTAACCAAGATCACCT",3,14,0,0,5,22,370
"GTAACCAAGCAGCACA",0,17,3,0,0,20,364
"GTAACCAAGCGGTAGT",0,2,0,0,0,2,5
"GTAACCAAGGGTCAAC",1,8,0,0,0,9,165
"GTAACCAGTCACAGTT",2,15,5,0,3,25,578
"GTAACCAGTCTAACTG",0,5,0,0,0,5,54
"GTAACCAGTTGGGTAG",0,2,0,0,0,2,87
"GTAACCATCCGGACTG",28,78,93,4,180,383,13754
"GTAAGTCAGCAATTAG",1,0,0,0,0,1,46
"GTAAGTCAGGTTGGTG",2,9,6,0,3,20,360
"GTAAGTCCACCAGCCA",0,0,0,0,0,0,127
"GTAAGTCCAGCAGTTT",0,20,9,2,5,36,549
"GTAAGTCCATGAAAGT",0,8,0,0,0,8,77
"GTAAGTCCATTGTACG",11,41,38,9,81,180,4558
"GTAAGTCGTCATAAAG",3,17,10,0,5,35,915
"GTAAGTCGTGAATATG",0,3,2,0,0,5,80
"GTAAGTCTCCCAAGTA",0,0,2,0,0,2,22
"GTAAGTCTCTCTGACC",0,6,0,0,0,6,115
"GTAATCGAGCGTTCAT",1,8,2,0,0,11,134
"GTAATCGAGTGGTGGT",3,29,2,0,3,37,1143
"GTAATCGAGTTTCGGT",2,13,2,0,2,19,424
"GTAATCGCACTATGTG",6,24,5,0,19,54,1316
"GTAATCGCACTTGGGC",0,2,2,0,0,4,53
"GTAATCGCAGGAGGTT",0,0,0,0,0,0,19
"GTAATCGCATGCCGGT",1,6,0,0,4,11,364
"GTAATCGCATTCATCT",4,23,4,2,2,35,607
"GTAATCGCATTGACTG",142,112,41,98,35,428,11802
"GTAATCGGTATTAAGG",1,3,0,2,4,10,132
"GTAATCGGTCCTACGG",0,4,4,0,2,10,285
"GTAATCGGTGGGTTGA",0,5,2,0,2,9,159
"GTAATCGGTGTACGCC",0,14,4,2,7,27,319
"GTAATCGTCGGAACTT",1,4,2,2,6,15,310
"GTAATGCAGACTCCGC",0,3,0,0,0,3,39
"GTAATGCAGGGACCAT",0,2,0,0,0,2,57
"GTAATGCAGTCAGCGA",0,3,3,0,0,6,132
"GTAATGCCATCACAGT",23,99,33,9,126,290,7135
"GTAATGCTCACACCCT",9,45,24,4,104,186,4897
"GTAATGCTCCACGGAC",7,44,11,2,13,77,1552
"GTAATGCTCGTCGACG",30,127,258,20,156,591,21741
"GTAATGCTCTCGGTCT",1,0,0,0,0,1,31
"GTAATGCTCTGGACTA",15,57,31,7,112,222,6511
"GTAATGCTCTGTAAGC",0,9,2,0,0,11,275
"GTACAACCAACGTATC",0,3,2,0,4,9,57
"GTACAACCAATGTGGG",1,13,2,0,3,19,85
"GTACAACGTAGAGGAA",1,0,0,0,0,1,25
"GTACAACGTCAAAGTA",0,0,0,0,0,0,56
"GTACAACGTGCCCGTA",0,7,2,0,2,11,228
"GTACAACTCACCATGA",0,2,0,0,0,2,75
"GTACAACTCGAGGCAA",0,3,0,0,2,5,57
"GTACAACTCTGGTTGA",2,17,3,3,7,32,354
"GTACAGTAGACCTGGA",2,4,2,0,2,10,41
"GTACAGTAGAGTCAAT",0,0,0,0,0,0,7
"GTACAGTAGGCTCTCG",1,15,5,0,0,21,468
"GTACAGTAGGTCGACA",1,5,0,0,0,6,98
"GTACAGTCAAAGGCTG",0,2,0,0,3,5,116
"GTACAGTCAAGTACCT",1,5,0,2,2,10,58
"GTACAGTGTTATGTGC",1,10,0,0,4,15,220
"GTACAGTTCCCGAGAC",2,9,0,0,3,14,219
"GTACAGTTCCCTGGTT",0,13,0,2,2,17,278
"GTACAGTTCGACACTA",0,0,0,0,0,0,15
"GTACAGTTCTCTCCGA",5,24,37,2,40,108,4023
"GTAGAAAAGGAACTAT",1,7,0,0,0,8,100
"GTAGAAACACACACGC",1,11,4,0,6,22,254
"GTAGAAACACTAGTAC",0,2,0,0,0,2,27
"GTAGAAACAGCACCCA",1,5,0,0,0,6,166
"GTAGAAACATGCCGGT",33,113,319,17,88,570,19601
"GTAGAAATCCATTTAC",8,87,12,3,12,122,4166
"GTAGAAATCGAGAGAC",0,3,0,0,0,3,96
"GTAGAAATCGCAACAT",4,42,76,3,15,140,4508
"GTAGAGGAGAACCCGA",0,0,0,0,0,0,74
"GTAGAGGAGATGATTG",0,5,0,0,0,5,97
"GTAGAGGAGGCATCTT",2,11,3,0,0,16,235
"GTAGAGGCAAACACCT",1,4,2,0,0,7,85
"GTAGAGGCAAGTTCCA",0,2,0,0,0,2,12
"GTAGAGGCAATGTTGC",16,47,113,3,22,201,6948
"GTAGAGGGTCACCGAC",3,45,48,3,60,159,3895
"GTAGAGGGTCGTGGAA",1,10,0,0,2,13,109
"GTAGAGGTCGTCTCAC",2,18,46,0,8,74,1335
"GTAGAGGTCTGTCGTC",1,12,3,0,0,16,469
"GTAGATCAGCCGCTTG",49,689,102,24,82,946,32115
"GTAGATCAGGTTACAA",0,2,0,0,0,2,121
"GTAGATCCAGAGTTGG",0,11,4,0,0,15,264
"GTAGATCGTATCGGTT",0,5,0,0,0,5,88
"GTAGATCGTCGGCACT",0,0,0,0,0,0,7
"GTAGATCTCCGTATGA",2,7,2,0,0,11,368
"GTAGATCTCTCTTCAA",0,6,2,0,0,8,74
"GTAGCTAAGCTAAGTA",1,14,2,0,9,26,75
"GTAGCTACAAAGGGTC",2,5,4,0,3,14,243
"GTAGCTACAGGTGTGA",36,464,103,17,84,704,26984
"GTAGCTAGTAACATCC",1,24,8,0,7,40,400
"GTAGCTAGTCCTACAA",10,41,25,0,13,89,2119
"GTAGCTAGTGACCGAA",4,30,20,2,89,145,3768
"GTAGCTAGTGGCTACC",116,33,16,0,19,184,6253
"GTAGCTAGTTACTCAG",14,135,41,5,15,210,8682
"GTAGCTATCCTATTGT",2,12,0,0,4,18,372
"GTAGCTATCTGGGTCG",1,0,8,0,2,11,233
"GTAGGAGAGAGCAGAA",1,10,7,0,0,18,210
"GTAGGAGAGGAACGTC",0,0,0,0,0,0,15
"GTAGGAGCACAATTCG",0,0,0,0,3,3,77
"GTAGGAGCACCAGCCA",2,14,0,0,0,16,261
"GTAGGAGCAGAACGCA",0,0,0,0,0,0,76
"GTAGGAGGTTTCGTAG",3,19,23,0,7,52,1924
"GTAGGAGTCAGACATC",0,0,0,0,0,0,48
"GTAGGAGTCGGCTTCT",0,2,0,0,0,2,48
"GTAGGAGTCGGTCTGG",0,0,0,0,0,0,29
"GTAGGTTGTAAGGCTG",0,6,4,0,0,10,284
"GTAGGTTGTCAGTTTG",0,7,2,0,5,14,285
"GTAGGTTGTTAATCGC",1,5,3,0,0,9,85
"GTAGGTTGTTTCCCAC",83,194,31,9,36,353,9443
"GTAGGTTTCTGAACGT",0,5,0,0,0,5,73
"GTAGTACAGACATAAC",1,7,2,3,0,13,55
"GTAGTACAGTAAGACT",5,23,6,0,4,38,313
"GTAGTACAGTGATCGG",0,2,0,0,0,2,28
"GTAGTACCACGCCACA",306,173,94,22,392,987,28443
"GTAGTACCACTACCCT",0,0,0,0,0,0,8
"GTAGTACCATTCAGGT",4,19,16,3,6,48,1423
"GTAGTACTCAAGCTTG",0,4,0,0,0,4,117
"GTAGTACTCAAGTGGG",0,4,0,0,0,4,65
"GTATTGGAGCAACAAT",2,41,7,0,6,56,2159
"GTATTGGAGCAGCACA",6,52,12,4,22,96,2724
"GTATTGGAGCGAGAAA",1,10,2,0,3,16,31
"GTATTGGAGGCCACCT",1,2,0,0,0,3,90
"GTATTGGCAACCCTAA",2,2,0,0,0,4,31
"GTATTGGCACGCAGTC",1,21,6,0,0,28,843
"GTATTGGCACGGTGTC",1,12,0,0,4,17,254
"GTATTGGCACTACCCT",0,0,0,0,0,0,27
"GTATTGGCAGAATTCC",1,2,3,0,0,6,75
"GTATTGGCAGCTTCCT",1,0,0,0,0,1,52
"GTATTGGGTACCGTCG",1,0,3,0,2,6,56
"GTATTGGGTTCGTACA",1,10,2,0,4,17,29
"GTATTGGTCAATCCAG",1,3,0,0,0,4,75
"GTATTGGTCACCTGGG",0,10,6,0,5,21,326
"GTATTGGTCCTAGAGT",0,7,0,0,0,7,63
"GTATTGGTCCTCACCA",0,0,0,0,0,0,4
"GTATTGGTCGATACAC",25,90,151,8,114,388,16573
"GTATTGGTCGGCATCG",2,15,6,0,16,39,640
"GTATTGGTCTGCCTCA",0,0,0,0,0,0,4
"GTATTTCAGCGGTAAC",0,2,0,0,0,2,44
"GTATTTCAGCTCCGAC",108,873,183,42,151,1357,47291
"GTATTTCAGGAGGGTG",0,4,0,0,0,4,94
"GTATTTCAGGTAGATT",11,65,70,6,19,171,5682
"GTATTTCCAGTTCCAA",0,7,3,0,4,14,202
"GTATTTCGTACAGAAT",1,7,0,0,0,8,180
"GTATTTCGTTACACTG",0,11,5,0,5,21,560
"GTATTTCGTTAGAGAT",31,79,23,2,17,152,4472
"GTATTTCGTTATGGTC",10,36,18,4,67,135,4936
"GTATTTCTCAGTGTCA",2,2,0,0,2,6,61
"GTATTTCTCCCAGGCA",0,5,0,0,0,5,15
"GTATTTCTCCCTTGGT",0,9,0,0,0,9,113
"GTATTTCTCGGATTAC",3,16,3,0,9,31,465
"GTATTTCTCTGCCCTA",0,0,2,0,0,2,89
"GTATTTCTCTGTCGCT",2,10,4,0,0,16,365
"GTCAAACAGTACAGCG",6,25,74,6,11,122,3962
"GTCAAACCAGATCACT",0,4,2,2,0,8,190
"GTCAAACTCATCTATC",0,8,3,2,3,16,423
"GTCAAACTCCTGTAGA",1,0,0,0,0,1,79
"GTCAAACTCGTCAAAC",0,17,5,2,7,31,552
"GTCAAACTCGTTCCCA",2,3,0,0,3,8,197
"GTCAAACTCTTTGCAT",0,0,0,0,0,0,3
"GTCAAGTAGGGCAGTT",3,15,3,0,3,24,184
"GTCAAGTAGTATAGAC",0,5,0,0,3,8,99
"GTCAAGTCAAGATGTA",0,0,0,0,0,0,20
"GTCAAGTCAAGTCCAT",0,0,0,0,0,0,5
"GTCAAGTCACACGGAA",0,2,0,0,0,2,6
"GTCAAGTCACCTGAAT",1,7,0,0,0,8,219
"GTCAAGTCAGAAATCA",9,111,17,3,14,154,5199
"GTCAAGTCATCTCAAG",0,0,0,0,0,0,27
"GTCAAGTGTATCGCTA",0,2,2,0,0,4,130
"GTCAAGTGTTTGCAGT",3,14,8,0,10,35,825
"GTCAAGTTCAAACGAA",1,8,4,0,2,15,205
"GTCAAGTTCGCAAGAG",5,28,30,3,30,96,2289
"GTCAAGTTCGCTTACC",0,0,0,0,0,0,36
"GTCACGGAGCAAGGAA",0,4,2,0,0,6,89
"GTCACGGCAACCACAT",0,0,3,0,0,3,38
"GTCACGGCAGCACGAA",0,2,0,0,0,2,11
"GTCACGGTCCGCACTT",0,3,0,0,2,5,52
"GTCACGGTCCTGGGTG",1,4,0,0,2,7,158
"GTCACGGTCTCCATAT",1,0,0,0,0,1,82
"GTCACTCAGCCGATAG",0,3,0,0,0,3,50
"GTCACTCAGGGTTAAT",2,6,2,0,0,10,85
"GTCACTCAGTTGGAAT",0,0,0,0,0,0,18
"GTCACTCCAAGAGAGA",0,5,0,0,0,5,109
"GTCACTCGTCAGTTTG",26,98,104,10,244,482,14859
"GTCACTCGTCTACGTA",0,0,0,0,0,0,7
"GTCACTCGTTAGTTCG",5,45,8,0,7,65,1613
"GTCACTCTCGTCAGAT",2,4,0,0,3,9,59
"GTCACTCTCTTAGTTC",0,3,0,0,2,5,80
"GTCAGCGCACAACATC",0,2,0,0,2,4,167
"GTCAGCGCACGCTATA",0,2,0,0,0,2,74
"GTCAGCGCACGGCCAT",0,2,0,0,0,2,12
"GTCAGCGCACTGCGAC",0,4,0,0,0,4,112
"GTCAGCGCAGAACCGA",4,19,25,0,5,53,1168
"GTCAGCGGTACTAGCT",1,5,2,0,2,10,153
"GTCAGCGGTTGAGAGC",0,0,0,0,0,0,15
"GTCATCCCATGTTCGA",11,22,36,2,8,79,2103
"GTCATCCGTACGTACT",33,325,68,15,55,496,13980
"GTCATCCGTATACGGG",0,0,2,0,3,5,34
"GTCATCCGTTCTATCT",1,2,0,0,0,3,86
"GTCATCCGTTCTCGTC",2,15,3,0,7,27,665
"GTCATGAAGAGCACTG",28,450,55,14,55,602,16255
"GTCATGAAGTGGTGGT",0,3,0,0,0,3,44
"GTCATGACAGCAGTAG",19,101,329,4,63,516,13599
"GTCATGAGTAGGGTAC",0,14,4,0,4,22,37
"GTCATGAGTCGAAACG",10,48,17,4,108,187,4596
"GTCATGAGTTACACTG",17,60,16,5,11,109,2211
"GTCATGATCACCTACC",1,18,22,0,4,45,886
"GTCATGATCCGAGCTG",0,0,2,0,0,2,15
"GTCATTTGTCGGCTAC",15,218,29,4,28,294,8925
"GTCATTTGTCTATGAC",1,3,0,0,0,4,32
"GTCATTTTCCGTGTAA",1,25,6,2,3,37,432
"GTCCACTAGAATAGTC",3,5,3,0,0,11,160
"GTCCACTAGAGAACCC",0,0,2,0,0,2,58
"GTCCACTAGCTGTTAC",1,3,0,0,0,4,147
"GTCCACTAGTGCTCGC",42,181,48,7,52,330,9063
"GTCCACTCATCGCTAA",0,0,0,0,0,0,95
"GTCCACTGTGCATCTA",1,3,0,0,0,4,53
"GTCCACTGTTGCGGCT",0,0,0,0,0,0,38
"GTCCACTGTTTGATCG",1,2,3,0,0,6,61
"GTCCACTTCCTACGAA",15,182,35,6,36,274,9289
"GTCCACTTCGCTGCGA",2,14,2,0,20,38,1684
"GTCCACTTCGTAGCTA",0,2,0,0,0,2,109
"GTCCACTTCGTGCAGC",0,6,2,0,0,8,127
"GTCCCATAGAAGCGCT",1,5,2,0,0,8,165
"GTCCCATAGACCTCAT",0,3,0,0,0,3,85
"GTCCCATAGAGGATGA",24,73,199,7,36,339,11162
"GTCCCATAGCTTAGTC",0,0,0,0,0,0,25
"GTCCCATCAATATCCG",0,0,0,0,0,0,1
"GTCCCATCACAGCTTA",0,4,0,0,2,6,222
"GTCCCATCACTTGTGA",0,8,2,0,4,14,248
"GTCCCATGTACTTCCC",0,9,0,0,2,11,322
"GTCCCATTCAACCCGG",1,5,0,0,3,9,243
"GTCCCATTCCGAGTGC",2,2,2,0,0,6,62
"GTCCTCAAGCGAACTG",5,69,12,2,7,95,2461
"GTCCTCAAGCTGAGCA",1,12,0,0,6,19,342
"GTCCTCAAGGTAACTA",1,2,7,0,3,13,515
"GTCCTCAAGTGGATAT",2,7,4,0,7,20,95
"GTCCTCACACTCACTC",0,0,0,0,0,0,82
"GTCCTCAGTCTGTCAA",1,5,5,0,0,11,212
"GTCCTCAGTTAGAGAT",2,2,0,0,2,6,77
"GTCCTCATCATTACGG",1,10,3,0,2,16,190
"GTCCTCATCGTTCCTG",29,84,104,12,135,364,9909
"GTCCTCATCTGAATCG",0,9,2,0,3,14,100
"GTCGAATAGAATCGTA",2,12,3,0,2,19,166
"GTCGAATAGGGACACT",6,9,2,0,4,21,291
"GTCGAATCAGCTATAC",0,24,3,0,5,32,950
"GTCGAATGTAATGATG",1,0,0,3,0,4,210
"GTCGAATGTATAGGAT",22,16,6,0,10,54,1657
"GTCGAATGTCTGTCCT",188,2020,326,72,296,2902,99633
"GTCGAATTCCCGTGTT",0,8,0,0,0,8,49
"GTCGCGAAGGTTCTTG",29,38,13,3,10,93,2294
"GTCGCGACATAGTCGT",2,27,5,0,0,34,855
"GTCGCGAGTGGATCGA",0,0,0,0,0,0,53
"GTCGTAAAGAGTGGCT",0,4,0,0,0,4,125
"GTCGTAAAGGGAGGCA",0,2,0,0,0,2,17
"GTCGTAAAGTAACCTC",0,19,0,0,2,21,203
"GTCGTAACAAGATCCT",35,83,43,219,28,408,9440
"GTCGTAACAGTATTCG",0,2,2,0,0,4,113
"GTCGTAAGTAGTCACT",2,4,0,0,0,6,85
"GTCGTAAGTGAACTAA",1,0,0,0,0,1,9
"GTCGTAAGTGAATGAT",0,3,0,0,0,3,16
"GTCGTAATCGTTGTAG",7,20,70,2,12,111,3745
"GTCGTTCAGTGCCAGA",17,68,208,8,35,336,8441
"GTCGTTCCAACCGACC",0,0,0,0,0,0,21
"GTCGTTCGTAGGACTG",0,0,0,0,0,0,2
"GTCGTTCGTCGTGGTC",0,0,0,0,0,0,3
"GTCGTTCTCAGCTTCC",0,0,0,0,0,0,26
"GTCTACCAGAAGTGTT",0,3,0,0,2,5,27
"GTCTACCAGATAACAC",1,10,2,0,0,13,271
"GTCTACCGTCGCAACC",0,6,0,0,0,6,127
"GTCTACCGTGACCGAA",0,5,0,0,0,5,63
"GTCTACCGTTGAGGAC",2,8,0,0,3,13,227
"GTCTACCTCATTCTTG",0,0,0,0,0,0,9
"GTCTACCTCCAATGCA",2,11,0,2,4,19,306
"GTCTACCTCGACGAGA",17,59,62,11,136,285,8785
"GTCTACCTCTTAGTTC",0,3,0,0,0,3,26
"GTCTAGAAGACTTCAC",0,0,0,0,0,0,47
"GTCTAGAAGAGGTCAC",0,0,0,0,0,0,24
"GTCTAGACACTGTCGG",9,35,87,5,31,167,4738
"GTCTAGACAGAACTTC",1,6,2,0,0,9,312
"GTCTAGACATGATAGA",1,4,0,0,0,5,15
"GTCTAGAGTATAGGAT",2,6,2,0,4,14,35
"GTCTAGAGTATCTTCT",6,17,2,0,2,27,46
"GTCTAGATCACCATCC",1,2,0,0,0,3,72
"GTCTAGATCGCAATGT",26,300,38,16,41,421,13452
"GTCTCACAGTATGATG",1,5,2,0,2,10,125
"GTCTCACAGTTGCGAG",0,0,0,0,0,0,37
"GTCTCACCAAGGCAAC",6,64,33,2,14,119,3204
"GTCTCACCACGTCTCT",1,2,2,0,3,8,238
"GTCTCACGTAGGTACG",9,109,29,2,19,168,5201
"GTCTCACGTCCGGATC",0,4,0,0,0,4,88
"GTCTCACTCAAGTGTC",0,5,0,0,0,5,30
"GTCTCACTCATTCACT",13,98,17,9,20,157,4136
"GTCTCACTCTGTCAGA",1,6,0,0,0,7,33
"GTCTGTCAGACCATTC",15,41,83,5,16,160,5294
"GTCTGTCAGCCTATTG",3,18,33,0,8,62,2375
"GTCTGTCAGGGAGGTG",0,3,0,0,0,3,102
"GTCTGTCCAAACTCGT",15,62,131,3,54,265,7396
"GTCTGTCCAAACTGCT",1,12,7,2,7,29,555
"GTCTGTCCACCAAATC",0,0,0,0,0,0,85
"GTCTGTCCAGAGCGTA",0,5,5,0,2,12,140
"GTCTGTCCAGTATACC",1,2,0,0,0,3,102
"GTCTGTCCATGCCATA",4,22,6,0,40,72,2455
"GTCTGTCGTTCATCGA",1,6,0,0,2,9,83
"GTCTGTCGTTTGCAGT",0,0,0,0,0,0,20
"GTCTGTCTCATCGACA",0,2,5,0,0,7,264
"GTCTGTCTCGATAACC",19,120,20,5,27,191,6246
"GTCTGTCTCGGCCCAA",0,2,2,0,0,4,42
"GTCTGTCTCTGAGAGG",10,86,21,5,11,133,2727
"GTCTGTCTCTTGAACG",1,0,0,0,3,4,79
"GTCTTTAAGAGTGTTA",1,4,0,0,0,5,70
"GTCTTTAAGGTTCCAT",3,13,3,0,4,23,359
"GTCTTTACAAGAGGTC",0,4,0,0,0,4,111
"GTCTTTACAGCTATAC",1,10,2,0,0,13,196
"GTCTTTACATGCCGCA",0,0,0,0,0,0,31
"GTCTTTAGTTCTCTAT",0,2,0,0,0,2,37
"GTCTTTAGTTGTGGCC",0,16,0,0,2,18,300
"GTCTTTATCAAGAGTA",11,63,161,10,35,280,9701
"GTCTTTATCATTTCGT",0,4,2,0,4,10,125
"GTCTTTATCGGTCTAA",1,15,3,0,0,19,262
"GTGACGCAGACAAGCC",0,2,0,0,0,2,28
"GTGACGCAGAGCATAT",1,5,0,0,0,6,94
"GTGACGCAGATCGCTT",0,2,0,0,3,5,118
"GTGACGCAGGATACAT",26,173,52,10,150,411,14652
"GTGACGCAGGTGAGAA",0,0,0,0,0,0,29
"GTGACGCCAAGAATGT",0,5,0,0,0,5,186
"GTGACGCCAGCCCAGT",16,119,24,30,21,210,8554
"GTGACGCCATCGATAC",0,5,0,0,0,5,140
"GTGACGCGTTGCAAGG",0,8,0,0,0,8,155
"GTGACGCGTTTCCATT",1,4,3,0,3,11,260
"GTGACGCTCGTGCACG",0,0,0,0,0,0,44
"GTGACGCTCTGGTGGC",2,7,2,0,5,16,206
"GTGAGCCAGGGCCCTT",0,0,0,0,0,0,39
"GTGAGCCCAAACTAAG",0,3,0,0,0,3,57
"GTGAGCCCAACGCATT",1,13,3,0,5,22,252
"GTGAGCCCAAGGCTTT",0,10,2,0,0,12,239
"GTGAGCCCACATACTG",0,5,0,0,2,7,82
"GTGAGCCCAGTTCACA",0,3,0,0,0,3,215
"GTGAGCCTCCAAACCA",68,230,143,428,305,1174,30351
"GTGAGCCTCGCACGAC",0,0,0,0,0,0,27
"GTGAGCCTCGCCTAGG",8,37,82,3,8,138,3304
"GTGAGCCTCTCCCATG",1,0,0,0,0,1,24
"GTGAGCCTCTGGCCAG",1,20,4,0,4,29,385
"GTGAGGACAGCTTCGG",0,2,0,0,0,2,71
"GTGAGGACAGGACTTT",0,7,0,0,0,7,148
"GTGAGGAGTATCGCTA",0,2,0,0,2,4,75
"GTGAGGATCAAGAATG",0,10,2,0,0,12,169
"GTGAGGATCGAGCCAC",3,12,7,0,17,39,917
"GTGAGTTAGTAAGAGG",1,3,0,0,0,4,155
"GTGAGTTCACTAACCA",0,2,0,0,0,2,31
"GTGAGTTCAGTTGCGC",1,0,0,0,0,1,114
"GTGAGTTGTAGTCTTG",0,0,0,0,0,0,35
"GTGAGTTGTCACAGAG",0,7,0,0,0,7,133
"GTGAGTTTCCCGTGTT",0,0,0,0,0,0,24
"GTGAGTTTCTTACGTT",0,4,0,0,0,4,95
"GTGATGTAGATTGGGC",0,0,0,0,0,0,39
"GTGATGTCAGCCTTCT",0,0,3,0,0,3,65
"GTGATGTGTAATGTGA",3,26,6,0,2,37,397
"GTGATGTTCGAAGAAT",0,2,0,0,0,2,90
"GTGATGTTCTACACAG",4,19,50,0,12,85,3696
"GTGATGTTCTCCAAGA",0,18,3,0,3,24,230
"GTGCACGAGCAATTAG",1,2,0,0,0,3,39
"GTGCACGAGGACCCAA",0,2,0,0,0,2,34
"GTGCACGAGGTCGTAG",0,0,0,0,0,0,26
"GTGCACGAGTAGAATC",0,2,0,0,0,2,34
"GTGCACGCATCCTTCG",2,5,0,0,0,7,111
"GTGCACGCATTAGGCT",0,2,0,0,2,4,78
"GTGCACGTCAATCAGC",0,0,0,0,0,0,39
"GTGCACGTCATTTACC",1,4,0,0,0,5,84
"GTGCACGTCGGTAGAG",0,2,0,0,2,4,29
"GTGCACGTCTTACACT",10,46,121,7,28,212,7459
"GTGCAGCAGATGCTAA",1,3,0,0,0,4,73
"GTGCAGCAGCGTATGG",0,0,0,0,0,0,54
"GTGCAGCAGTTCTACG",0,0,0,0,0,0,47
"GTGCAGCCATGGAACG",0,11,0,0,0,11,24
"GTGCAGCGTCGTATGT",0,2,0,0,0,2,4
"GTGCAGCGTTTGTTCT",1,6,2,0,0,9,148
"GTGCAGCTCGCATTAG",61,74,24,3,23,185,5516
"GTGCAGCTCTTGGTGA",0,0,0,0,0,0,20
"GTGCGTGCAAGCGATG",3,9,2,0,2,16,235
"GTGCGTGCATAGATGA",3,13,2,0,3,21,430
"GTGCGTGGTGCATACT",1,2,0,0,0,3,32
"GTGCGTGGTGCTGCAC",0,0,0,0,0,0,14
"GTGCGTGTCCATTGGA",1,10,0,2,2,15,38
"GTGCGTGTCGGCCCAA",0,2,0,0,0,2,30
"GTGCGTGTCTCCACTG",1,7,0,0,2,10,219
"GTGCTGGAGTGGAATT",0,2,0,0,0,2,15
"GTGCTGGGTCGTATTG",25,103,276,16,46,466,17327
"GTGCTGGGTTACGGAG",27,127,65,9,99,327,10168
"GTGCTGGTCAGCCTCT",1,9,0,0,2,12,138
"GTGCTGGTCGACGTCG",0,11,2,0,0,13,189
"GTGCTTCCAGTCCGTG",0,5,3,0,2,10,139
"GTGCTTCCATGCCGAC",1,8,3,0,3,15,531
"GTGCTTCGTGTCTAAC",0,0,0,0,0,0,24
"GTGCTTCGTTCAGCGC",43,324,60,15,62,504,13477
"GTGCTTCTCGGAATTC",6,29,73,6,15,129,4411
"GTGGAAGAGTAACGTA",0,4,0,0,0,4,82
"GTGGAAGCACAAATCC",0,2,0,0,0,2,40
"GTGGAGAAGATCCAAA",5,17,2,0,2,26,352
"GTGGAGAGTAATACCC",0,6,2,0,2,10,76
"GTGGAGAGTCCGGTGT",0,10,5,0,2,17,248
"GTGGAGAGTTTCGACA",0,5,0,0,2,7,123
"GTGGAGATCGTCGATA",0,2,2,0,0,4,17
"GTGGCGTAGGTGCCAA",25,137,25,4,30,221,7353
"GTGGCGTAGTATTCCG",0,11,0,0,3,14,301
"GTGGCGTGTCAAGTTC",2,22,9,2,4,39,295
"GTGGCGTGTGTCCCTT",0,4,0,0,0,4,72
"GTGGCGTTCGTGTTCC",0,2,0,0,3,5,65
"GTGGCGTTCTGGGATT",1,5,0,0,2,8,205
"GTGGGAAAGAGGTATT",3,31,4,0,9,47,1538
"GTGGGAAAGCCAGAGT",0,0,0,0,0,0,10
"GTGGGAACAAGGGCAT",88,506,140,76,108,918,35288
"GTGGGAACACTGCGAC",2,7,6,0,2,17,249
"GTGGGAACAGGAGGTT",2,8,4,0,4,18,382
"GTGGGAAGTACGGGAT",0,5,0,0,0,5,54
"GTGGGAAGTATGCTTG",8,36,47,2,8,101,3610
"GTGGGAAGTGGCAGAT",4,14,0,0,3,21,228
"GTGGGAAGTGGTTTAC",24,83,112,9,130,358,14423
"GTGGGAATCAAAGACA",0,0,0,0,0,0,45
"GTGGGAATCCTTGAAG",0,0,0,0,0,0,8
"GTGGGAATCGCATAGT",0,5,2,0,0,7,46
"GTGGGAATCGTACACA",1,0,0,0,0,1,118
"GTGGGAATCTTCTTCC",0,2,2,0,0,4,38
"GTGGTTAAGGCGTTGA",0,0,0,0,0,0,16
"GTGGTTAAGTGAATAC",10,29,57,2,13,111,3434
"GTGGTTACAAGCGCTC",0,5,0,0,0,5,87
"GTGGTTACACATGACT",0,2,0,0,0,2,13
"GTGGTTACAGGCATGA",0,4,0,0,0,4,79
"GTGGTTACATTGAGCT",0,0,0,0,0,0,10
"GTGGTTAGTCGTAATC",0,0,0,0,0,0,3
"GTGGTTATCAGCTGAT",0,0,3,0,0,3,79
"GTGGTTATCTCTCTTC",1,12,4,0,3,20,407
"GTGGTTATCTTGAGCA",0,3,0,0,0,3,70
"GTGTAACAGACCGTTT",1,5,0,0,0,6,328
"GTGTAACAGGCATCGA",0,3,0,0,0,3,27
"GTGTAACAGGGACTGT",0,3,0,0,0,3,47
"GTGTAACAGTCCTGTA",2,27,12,4,63,108,4285
"GTGTAACCAAACGGCA",0,0,0,0,0,0,5
"GTGTAACCAATAGGGC",0,0,0,0,0,0,53
"GTGTAACCAATGCAGG",5,43,8,3,5,64,1812
"GTGTAACCACACAGCC",0,0,0,0,0,0,25
"GTGTAACCACACCTTC",5,35,17,2,6,65,1716
"GTGTAACCATGACGAG",2,14,5,2,4,27,257
"GTGTAACCATGGAGAC",1,3,0,0,0,4,68
"GTGTAACCATGGTGGA",67,89,65,4,31,256,7304
"GTGTAACGTAACTAAG",1,10,7,0,7,25,417
"GTGTAACGTAGTTACC",0,0,0,0,0,0,93
"GTGTAACGTGGGAGAG",0,9,3,0,2,14,310
"GTGTAACGTTGGCCTG",0,0,0,0,0,0,1
"GTGTAACTCAGAGTTC",5,21,8,0,5,39,356
"GTGTAACTCCCTCATG",0,0,0,0,0,0,8
"GTGTAACTCGTGCGAC",0,0,0,0,0,0,15
"GTGTCCTAGCGTTCAT",0,4,0,0,0,4,68
"GTGTCCTAGGCCACTC",25,70,211,14,33,353,13160
"GTGTCCTAGGTGTGAC",4,10,5,3,2,24,386
"GTGTCCTCAACGATCT",2,2,0,0,0,4,43
"GTGTCCTCACAGCCAC",17,233,123,16,71,460,16006
"GTGTCCTCACGCAAAG",7,65,27,4,11,114,4598
"GTGTCCTTCAGTGTCA",0,0,2,0,2,4,63
"GTGTGATAGCTGTCCG",1,3,0,0,0,4,162
"GTGTGATAGGGCAGGA",1,8,0,0,0,9,142
"GTGTGATCAGGCCCTA",1,11,9,0,5,26,220
"GTGTGATCATGGCACC",1,7,2,0,2,12,63
"GTGTGATTCATTCGTT",2,34,13,4,10,63,986
"GTGTGATTCATTTCGT",0,2,2,0,0,4,70
"GTGTGATTCCAAGCCG",0,4,0,0,0,4,96
"GTGTGATTCCGGCAAC",0,2,0,0,2,4,49
"GTGTGATTCGCTCTAC",1,0,2,0,0,3,72
"GTGTGATTCTGACCCT",3,17,3,2,3,28,1001
"GTGTGATTCTGTCTCG",1,3,0,0,0,4,67
"GTGTGGCAGAGTGTTA",19,114,105,6,32,276,10738
"GTGTGGCCAAGAAATC",0,7,2,0,3,12,98
"GTGTGGCCAAGACGGT",1,4,0,0,0,5,80
"GTGTGGCGTAGTGTGG",5,85,19,4,19,132,4621
"GTGTGGCGTCGGCTAC",0,0,0,0,0,0,4
"GTGTGGCGTTAGGGTG",18,92,68,4,72,254,9308
"GTGTGGCTCCATACAG",0,10,2,0,2,14,315
"GTGTGGCTCTCCGATC",0,5,0,0,0,5,103
"GTGTTAGCAGCTACAT",0,0,2,0,0,2,106
"GTGTTAGCATCCGAAT",0,0,0,0,0,0,40
"GTGTTAGGTACAGTTC",1,0,0,0,2,3,77
"GTGTTAGGTCTAGGTT",0,0,0,0,0,0,11
"GTGTTAGGTTCTCCAC",2,10,4,3,5,24,576
"GTGTTAGGTTGCATTG",0,0,0,0,0,0,1
"GTGTTAGTCAAGCTGT",0,2,0,0,0,2,24
"GTGTTAGTCGCTTAAG",1,12,0,0,2,15,182
"GTGTTAGTCGGTTGTA",0,0,0,0,2,2,13
"GTGTTCCAGATTGATG",58,188,465,23,148,882,39547
"GTGTTCCCAACGTTAC",22,91,46,168,33,360,12555
"GTGTTCCCAGCGACCT",1,8,4,0,5,18,26
"GTGTTCCCAGTCCGTG",0,2,0,0,0,2,108
"GTGTTCCGTCCGACGT",5,25,43,0,8,81,2882
"GTGTTCCTCCTATGGA",1,5,0,0,0,6,39
"GTGTTCCTCGTCCTCA",94,1050,222,49,167,1582,55043
"GTTACAGAGAAGCGAA",0,5,0,0,2,7,52
"GTTACAGAGATAACAC",2,6,0,0,2,10,188
"GTTACAGAGGCCTGAA",1,2,0,0,0,3,195
"GTTACAGCAAGGCGTA",4,14,4,4,11,37,1041
"GTTACAGCACCCTTGT",0,0,2,0,0,2,70
"GTTACAGGTACGTAGG",0,2,2,0,0,4,53
"GTTACAGGTATTAAGG",2,13,4,2,2,23,315
"GTTACAGGTGCGAGTA",1,3,0,0,0,4,70
"GTTACAGTCATGACAC",2,8,2,0,0,12,57
"GTTACAGTCATGCCAA",4,14,3,0,8,29,508
"GTTACAGTCGTCACCT",2,8,6,0,3,19,310
"GTTACAGTCTCTCTAA",0,0,0,0,0,0,10
"GTTACAGTCTGGGCGT",0,0,0,0,0,0,27
"GTTACCCCACATACGT",1,5,2,0,0,8,92
"GTTACCCCACTGTTCC",0,10,2,0,2,14,325
"GTTACCCCAGGAGGAG",0,2,0,0,0,2,7
"GTTACCCGTCCATCTC",1,4,0,0,0,5,83
"GTTACCCGTCGCACGT",0,8,3,0,7,18,384
"GTTACCCTCATTACCT",0,7,0,0,2,9,113
"GTTACCCTCATTGTTC",0,0,0,0,0,0,6
"GTTACCCTCCACAGCG",9,10,3,0,2,24,686
"GTTACCCTCCTGGCTT",0,0,0,0,0,0,42
"GTTACGAAGAGCCGTA",0,2,0,0,0,2,77
"GTTACGAAGCCTCTGG",0,5,0,2,2,9,69
"GTTACGAAGCTTTCCC",2,8,4,0,3,17,81
"GTTACGAAGTTAACAG",1,13,0,0,4,18,445
"GTTACGACAACCGTAT",0,0,0,0,0,0,34
"GTTACGAGTACTCAAC",0,3,0,0,0,3,52
"GTTACGAGTGAACTAA",1,4,0,0,0,5,104
"GTTACGAGTTAAGTCC",4,13,5,0,4,26,541
"GTTACGAGTTCCAGGC",0,3,0,0,3,6,218
"GTTACGATCGCTTAAG",3,28,8,0,5,44,1128
"GTTAGACAGATGTTGA",2,11,0,2,2,17,446
"GTTAGACCAAACTAAG",0,2,0,0,0,2,46
"GTTAGACCAAAGGAGA",0,3,0,0,0,3,37
"GTTAGACCAACGGGTA",0,5,0,0,2,7,99
"GTTAGACCACGCTGTG",0,11,2,0,3,16,306
"GTTAGACCACTGATTG",0,2,0,0,0,2,48
"GTTAGACCAGTTAAAG",0,17,8,0,7,32,524
"GTTAGACCATTGTCGA",0,0,2,0,0,2,76
"GTTAGACCATTGTGCA",2,10,4,0,4,20,435
"GTTAGACTCCATCTAT",0,2,0,0,0,2,46
"GTTAGACTCCGGACGT",0,11,3,0,4,18,321
"GTTAGACTCCTGGTCT",1,5,4,2,0,12,199
"GTTAGACTCTCGTCGT",0,0,0,0,0,0,16
"GTTAGTGAGCGAGAAA",75,251,55,11,54,446,15899
"GTTAGTGAGTATGTAG",63,58,21,7,20,169,3909
"GTTAGTGCATAGACTC",0,0,0,0,0,0,15
"GTTAGTGCATCTATCT",0,14,2,0,6,22,370
"GTTAGTGCATGAGAAT",4,60,15,0,12,91,3505
"GTTAGTGCATGGAATA",0,3,0,0,0,3,25
"GTTAGTGGTAGGCTCC",2,7,2,0,3,14,333
"GTTAGTGTCGGACTGC",2,12,3,0,2,19,221
"GTTATGGAGAAGTGTT",1,8,0,0,0,9,62
"GTTATGGAGCTCCGAC",2,15,3,3,6,29,622
"GTTATGGCACAGAGCA",1,16,4,0,0,21,31
"GTTATGGCAGCCGGTT",0,2,0,0,0,2,12
"GTTATGGCAGTTGCGC",10,5,2,0,2,19,875
"GTTATGGGTTGGGAAC",4,21,6,0,7,38,1236
"GTTATGGTCATAGGCT",1,5,0,0,0,6,54
"GTTATGGTCGCTATTT",222,934,123,13,71,1363,14871
"GTTATGGTCTTACTGT",0,3,0,0,0,3,11
"GTTCATTCAACTAGAA",1,8,4,0,0,13,183
"GTTCATTGTGTCCGGT",0,2,0,0,0,2,116
"GTTCCGTCAAACGAGC",0,0,0,0,0,0,18
"GTTCCGTCAGAGTGAC",1,15,5,0,7,28,435
"GTTCCGTGTACAGGTG",0,2,0,0,0,2,69
"GTTCCGTGTGGCCCAT",0,6,0,0,0,6,64
"GTTCCGTTCATCACCC",0,3,0,0,0,3,19
"GTTCGCTAGTTCCGGC",0,8,0,0,0,8,92
"GTTCGCTCAAGTTTGC",0,0,0,0,0,0,53
"GTTCGCTGTCCCGGTA",0,15,4,0,3,22,366
"GTTCGCTTCTCATTGT",3,8,4,2,3,20,536
"GTTCTATAGATGATTG",11,46,92,6,13,168,6091
"GTTCTATAGCACCGAA",0,2,0,2,0,4,79
"GTTCTATAGGCGTTGA",0,0,0,0,0,0,19
"GTTCTATAGTGATAGT",2,11,4,0,7,24,362
"GTTCTATCATCGCTAA",28,73,21,5,13,140,4959
"GTTCTATCATTGCCTC",0,2,0,0,0,2,4
"GTTCTATGTAACGCGA",7,49,38,7,105,206,6849
"GTTCTATGTATCGCGC",0,6,2,0,0,8,23
"GTTCTATGTCTTAGTG",0,5,0,0,0,5,49
"GTTCTATTCTCGTGGG",0,7,3,0,2,12,97
"GTTGAACCAACAGCTT",3,17,11,0,6,37,366
"GTTGAACCACAATTCG",1,6,0,2,2,11,150
"GTTGAACCACGCACCA",6,38,19,3,135,201,8294
"GTTGAACCAGACAAGC",0,7,0,0,2,9,249
"GTTGAACGTACAGTAA",1,3,3,0,0,7,81
"GTTGAACGTAGTCACT",0,3,0,0,0,3,141
"GTTGAACGTTGCTCAA",0,3,0,0,2,5,151
"GTTGAACTCGAGTCTA",1,6,0,0,0,7,248
"GTTGCGGAGTGGTTAA",0,6,3,0,0,9,73
"GTTGCGGCAGGCTTGC",0,3,0,0,0,3,43
"GTTGCGGGTCGTATTG",0,5,0,0,0,5,79
"GTTGCGGGTCTGTCCT",16,91,31,82,14,234,8841
"GTTGCGGGTGATGAAT",0,3,0,0,0,3,48
"GTTGCGGGTTCCGGTG",1,0,2,2,0,5,143
"GTTGCGGTCAACTGGT",126,71,32,8,26,263,8313
"GTTGCGGTCGAGAATA",0,0,0,0,0,0,33
"GTTGCGGTCTACGGTA",0,3,2,0,0,5,74
"GTTGCTCAGTTACGAA",2,6,2,0,2,12,663
"GTTGCTCCAACACAGG",0,2,0,0,0,2,237
"GTTGCTCCACCTTCCA",2,11,3,0,22,38,1304
"GTTGCTCCAGACACAG",3,8,2,0,0,13,299
"GTTGCTCCATTGTACG",27,353,91,16,59,546,21452
"GTTGCTCGTAGTGTGG",4,24,71,4,7,110,2848
"GTTGCTCTCCGATTAG",1,20,6,0,7,34,758
"GTTGCTCTCTGGAGAG",0,3,2,0,0,5,101
"GTTGTAGCAGCGACCT",0,3,0,0,0,3,46
"GTTGTAGCATTACGGT",0,26,9,0,38,73,2539
"GTTGTAGCATTAGGCT",1,4,2,0,0,7,138
"GTTGTAGGTCCTCATC",12,36,93,0,16,157,5784
"GTTGTAGGTTGCGTAT",0,2,0,0,0,2,7
"GTTGTAGTCACGAACT",1,3,3,0,0,7,160
"GTTGTAGTCTACGGGC",1,0,0,0,0,1,34
"GTTGTAGTCTCAAAGC",0,5,2,0,0,7,42
"GTTGTCCAGTAGGATT",5,19,2,0,2,28,324
"GTTGTCCGTGCTGCAC",0,4,0,0,0,4,78
"GTTGTCCTCACCACAA",5,85,18,6,18,132,4909
"GTTGTCCTCCACGTCT",0,3,2,0,0,5,98
"GTTGTCCTCGAGAACG",2,4,2,0,0,8,56
"GTTGTCCTCTGTCCGT",0,2,3,0,0,5,80
"GTTGTGAAGAGTACCG",134,72,22,6,26,260,7283
"GTTGTGAAGCATTGAA",2,10,5,0,5,22,316
"GTTGTGAAGTCGCCAC",0,0,0,0,0,0,10
"GTTGTGACACCAATTG",2,7,2,0,5,16,204
"GTTGTGAGTCGTACAT",0,0,0,0,0,0,36
"GTTGTGAGTTAGTTCG",11,29,24,4,56,124,3531
"GTTGTGATCGAGTCTA",5,30,6,0,9,50,867
"GTTTACTAGACCATTC",3,7,0,2,2,14,317
"GTTTACTAGGAAGTGA",4,20,3,0,0,27,270
"GTTTACTAGGCTAGCA",1,10,0,4,2,17,263
"GTTTACTAGTAATACG",33,128,240,17,108,526,16669
"GTTTACTAGTGGTCAG",0,2,0,0,0,2,109
"GTTTACTCACCGTCGA",1,22,0,0,3,26,493
"GTTTACTTCATGCCCT",0,4,0,0,0,4,128
"GTTTGGACACGACAGA",2,7,5,0,0,14,184
"GTTTGGACATAGGCGA",1,0,0,0,2,3,73
"GTTTGGAGTAGAGACC",2,3,2,0,0,7,112
"GTTTGGATCCACCCTA",3,12,3,0,3,21,422
"GTTTGGATCCACTAGA",3,31,9,2,7,52,1516
"GTTTGGATCCTTCTAA",0,2,0,0,2,4,63
"GTTTGGATCCTTTAGT",1,9,6,0,0,16,103
"TAACACGAGAATCGAT",4,6,2,0,3,15,121
"TAACACGAGAATTCAG",3,15,0,0,6,24,84
"TAACACGAGTCTCGTA",0,6,0,0,2,8,71
"TAACACGGTGAGACGT",8,87,12,4,12,123,3400
"TAACCAGAGAAACTAC",0,3,0,0,0,3,8
"TAACCAGAGAATTGTG",4,26,48,4,5,87,2799
"TAACCAGAGAGAGTGA",1,9,0,0,0,10,76
"TAACCAGAGGGAGGGT",6,41,9,0,7,63,2025
"TAACCAGAGTCCCGGT",0,5,0,0,2,7,294
"TAACCAGCACGGCTAC",0,0,2,0,0,2,67
"TAACCAGCAGTCGGTC",19,12,5,2,2,40,1619
"TAACCAGGTCAACGCC",0,0,0,0,0,0,40
"TAACCAGGTCGATTCA",0,9,3,0,2,14,253
"TAACCAGGTGAATATG",120,531,564,52,1004,2271,86908
"TAACCAGGTGACCTGC",0,4,0,0,0,4,106
"TAACCAGGTGCTGCAC",1,3,0,0,0,4,309
"TAACCAGTCACTTATC",1,13,0,0,4,18,559
"TAACGACCAATAGTGA",1,6,0,0,0,7,80
"TAACGACCAGGCTATT",1,5,2,0,0,8,214
"TAACGACGTCATCCGG",1,3,0,0,0,4,114
"TAACGACTCACTGATG",0,2,0,0,0,2,20
"TAACGACTCTGAATGC",0,6,0,0,0,6,305
"TAACTTCAGGATACGC",111,80,25,4,24,244,7639
"TAACTTCCATCCGATA",2,31,24,4,9,70,1747
"TAACTTCCATGAGTAA",0,3,2,0,0,5,10
"TAACTTCGTAACCAGG",63,461,121,86,84,815,26625
"TAACTTCGTATGTCAC",4,11,3,0,0,18,568
"TAACTTCTCCCGAATA",2,5,0,0,0,7,40
"TAACTTCTCGTTCTCG",4,37,7,2,11,61,1848
"TAAGCACAGAAATTGC",1,0,0,0,0,1,69
"TAAGCACAGCATAGGC",0,6,2,0,2,10,167
"TAAGCACAGGGATCTG",0,2,0,0,0,2,92
"TAAGCACGTATTGAGA",0,7,0,0,0,7,102
"TAAGCACTCATGAGAA",0,5,0,0,0,5,69
"TAAGCACTCCCGAGGT",35,135,101,23,468,762,25689
"TAAGCACTCTCCGCAT",1,0,0,0,0,1,86
"TAAGCACTCTGAGGTT",0,2,0,0,0,2,99
"TAAGCACTCTGAGTCA",1,4,0,0,0,5,67
"TAAGCCAAGGATTTGA",0,3,3,0,0,6,12
"TAAGCCACACGTTGGC",2,20,4,3,4,33,213
"TAAGCCACAGACCTGC",1,5,0,0,2,8,178
"TAAGCCAGTTAGGCTT",0,4,0,0,0,4,62
"TAAGCCAGTTGTTGCA",0,4,0,0,2,6,77
"TAAGCCATCGGAAACG",0,0,0,0,0,0,18
"TAAGCGTAGACGGATC",0,0,0,0,0,0,54
"TAAGCGTAGATGCCGA",83,759,112,27,117,1098,40420
"TAAGCGTAGTAAACTG",0,0,0,0,0,0,20
"TAAGCGTCAGTCACGC",1,7,2,0,0,10,33
"TAAGCGTCATCCGGTG",2,10,0,0,3,15,121
"TAAGCGTGTCGCCACA",0,5,2,0,0,7,175
"TAAGCGTTCCGATTAG",2,16,9,0,3,30,165
"TAAGTCGAGATTAGCA",6,78,14,5,13,116,4290
"TAAGTCGAGCTGTTCA",1,12,2,0,0,15,282
"TAAGTCGAGGATACCG",1,9,0,0,0,10,100
"TAAGTCGAGGGCAGAG",65,37,16,2,12,132,3654
"TAAGTCGCAAGCGCTC",0,10,0,0,3,13,341
"TAAGTCGCACACAGCC",1,19,32,2,14,68,1959
"TAAGTCGCACACTTAG",0,3,0,0,0,3,79
"TAAGTCGGTAGAATGT",1,14,5,0,6,26,337
"TAAGTCGGTATCCTCC",6,24,10,4,49,93,3077
"TAAGTCGGTATTTCGG",31,97,163,10,139,440,15518
"TAAGTCGGTCGTACAT",91,585,161,39,443,1319,45960
"TAAGTCGGTTGCACGC",0,4,3,0,2,9,169
"TAAGTCGTCAGTGCGC",5,8,0,0,0,13,25
"TAAGTCGTCCACGTCT",1,7,0,0,2,10,231
"TAAGTCGTCTGCCTCA",0,0,0,0,0,0,14
"TAATCTCAGAATCCCT",0,6,0,0,0,6,82
"TAATCTCTCAAGAAAC",0,3,0,0,0,3,29
"TAATCTCTCAAGTTGC",2,24,19,0,5,50,1072
"TAATCTCTCCGATGTA",0,3,0,0,0,3,29
"TAATCTCTCCGCAAAT",0,0,0,0,2,2,58
"TAATCTCTCCGTGGCA",3,17,6,2,4,32,557
"TAATCTCTCCTGTTGC",1,7,0,0,4,12,832
"TAATTCCAGTGGCCTC",1,2,0,0,2,5,106
"TAATTCCGTATCGCGC",1,7,2,0,0,10,91
"TAATTCCGTCTGCATA",1,10,13,0,14,38,1719
"TAATTCCGTCTTCAAG",0,2,0,0,3,5,53
"TAATTCCGTGGACAGT",0,4,0,0,0,4,43
"TAATTCCTCTACTCAT",0,12,5,0,5,22,310
"TACAACGAGACTCTAC",9,44,9,2,6,70,1841
"TACAACGCAACCGCTG",0,9,3,0,2,14,433
"TACAACGGTGGTCAAG",1,11,0,0,0,12,260
"TACAACGTCAACCTCC",1,6,0,0,2,9,196
"TACAACGTCGGTGCAC",0,6,0,0,0,6,179
"TACAACGTCTTCTGTA",0,5,0,0,0,5,105
"TACACCCAGTTCGCAT",0,0,0,0,0,0,17
"TACACCCCAAGGCGTA",8,20,44,2,9,83,2444
"TACACCCCACCCTAAA",0,0,0,0,2,2,2
"TACACCCTCTGGGCCA",64,625,111,23,98,921,33455
"TACAGGTAGGGACAGG",41,458,82,16,76,673,25435
"TACAGGTAGTTTCGAC",3,38,4,7,19,71,2633
"TACAGGTCAAACGGCA",8,82,12,3,22,127,3931
"TACAGGTGTAGGTTTC",5,21,26,4,13,69,1488
"TACAGGTGTCGTTGCG",1,2,0,0,0,3,17
"TACAGGTGTGCCCGTA",0,0,0,0,0,0,46
"TACAGGTGTGCTGCAC",40,171,100,12,41,364,11083
"TACAGGTTCCTAGAGT",794,319,151,36,176,1476,40266
"TACAGGTTCCTGTAAG",4,36,7,0,4,51,1598
"TACAGGTTCTCGAGTA",1,2,0,0,0,3,10
"TACATTCAGTGGGAAA",0,4,0,0,0,4,15
"TACATTCCAATCGCAT",0,4,4,0,0,8,98
"TACATTCCACCAGTTA",6,31,3,0,4,44,1990
"TACATTCCATAGTCGT",0,3,0,0,2,5,11
"TACATTCCATGCGGTC",20,94,198,15,189,516,16346
"TACATTCTCGGTTAGT",2,11,3,0,0,16,79
"TACATTCTCTAAGCCA",1,3,0,0,2,6,120
"TACCCACAGCATGTTC",129,386,104,24,86,729,29847
"TACCCACAGGAGTATT",0,3,0,0,0,3,55
"TACCCACCATCCGATA",0,2,0,0,2,4,64
"TACCCACTCTAGAACC",2,2,0,0,2,6,186
"TACCCGTAGACTCCGC",0,6,3,0,5,14,107
"TACCCGTCACATCCCT",0,8,2,0,2,12,123
"TACCCGTCACTAACGT",5,9,0,0,2,16,514
"TACCCGTCAGTTCTAG",0,4,0,0,0,4,102
"TACCCGTCATGTTCGA",38,130,17,10,23,218,6962
"TACCCGTGTATAGGAT",0,0,0,0,0,0,8
"TACCCGTGTGGATTTC",0,0,0,0,0,0,6
"TACCCGTGTTTAGACC",0,2,2,0,0,4,152
"TACCCGTTCGGTTAGT",234,176,50,10,52,522,16618
"TACCCGTTCGTTCCCA",0,2,0,0,0,2,48
"TACCCGTTCTCCTACG",0,3,0,0,5,8,74
"TACCCGTTCTTCGCTG",1,2,0,0,0,3,129
"TACCGAAAGCAGCAGT",1,3,0,0,0,4,119
"TACCGAAAGTTGCCCG",1,17,4,0,4,26,338
"TACCGAACAAGTATAG",0,2,0,0,2,4,96
"TACCGAACACAAGTGG",0,5,3,0,2,10,250
"TACCGAACACCTCAGG",0,2,0,0,0,2,15
"TACCGAAGTAATGCTC",2,17,3,2,0,24,766
"TACCGAAGTATCCCAA",0,3,0,0,0,3,77
"TACCGAATCGGTAGAG",0,6,0,0,2,8,154
"TACCGGGAGGACTAAT",2,8,0,0,3,13,63
"TACCGGGCACATAGCT",0,19,9,0,3,31,970
"TACCGGGCACTACCCT",1,0,0,0,0,1,106
"TACCGGGCATGGAATA",3,21,24,0,4,52,1410
"TACCGGGGTTCAATCG",6,24,54,2,14,100,3734
"TACCGGGGTTGTCAGT",0,0,0,0,0,0,45
"TACCGGGTCGATAACC",0,7,0,0,0,7,177
"TACCTCGAGGTTGAGC",7,23,12,2,31,75,2290
"TACCTCGCAATTGAAG",0,4,0,0,0,4,87
"TACCTCGCACGTGTGC",4,16,45,0,11,76,3254
"TACCTCGCAGGCGATA",1,0,0,0,0,1,121
"TACCTCGCAGGTTCGC",0,3,2,0,2,7,82
"TACCTCGGTAACTGCT",3,11,0,0,2,16,707
"TACCTCGGTACGATTC",35,328,63,15,66,507,20728
"TACCTCGGTACTTGTG",1,3,0,0,3,7,117
"TACCTCGGTTGACTAC",0,0,0,0,0,0,0
"TACCTCGTCGACCAAT",0,8,3,2,0,13,186
"TACCTGCAGACCAACG",0,2,2,0,0,4,24
"TACCTGCAGCTCCCTT",1,3,0,0,0,4,108
"TACCTGCCACATTACG",7,75,15,2,11,110,4578
"TACCTGCCACGTAACT",2,8,2,0,2,14,37
"TACCTGCCATGGCTGC",0,3,3,0,0,6,156
"TACCTGCGTCCGAAGA",0,10,4,0,16,30,1182
"TACCTGCGTTGGAGAC",0,0,0,0,0,0,2
"TACCTGCTCAGCTAGT",0,3,0,0,0,3,55
"TACCTGCTCTAGAGCT",2,6,0,0,0,8,93
"TACGCTCAGCAGATAT",51,397,87,16,84,635,25971
"TACGCTCAGTACTGGG",47,195,79,306,83,710,18803
"TACGCTCCAAATCAGA",4,16,4,0,18,42,813
"TACGCTCCAGCTATAC",0,3,2,0,0,5,132
"TACGCTCGTGATACCT",0,2,0,0,0,2,11
"TACGCTCGTTCTGACA",0,3,0,0,0,3,157
"TACGCTCGTTGCCGCA",1,23,3,0,2,29,1109
"TACGCTCTCCGCGATG",1,4,0,0,2,7,163
"TACGCTCTCTAGAGCT",2,23,4,0,3,32,303
"TACGCTCTCTCGAACA",2,31,7,4,4,48,684
"TACGGGCAGCTAATCC",0,3,0,0,0,3,89
"TACGGGCCAAGAATGT",0,6,0,0,0,6,92
"TACGGGCCACACCTGG",0,0,0,0,0,0,14
"TACGGGCGTCTCGGAC",0,0,0,0,0,0,28
"TACGGGCGTGCTTCAA",72,266,45,14,33,430,18041
"TACGGTAAGGATTCAA",5,12,4,0,6,27,333
"TACGGTACACGCGCTA",1,4,0,0,0,5,139
"TACGGTAGTCGTCAGC",0,9,0,0,0,9,375
"TACGGTATCGCCGATG",0,4,0,0,2,6,232
"TACGGTATCGCCTAGG",0,5,0,0,0,5,46
"TACGTCCAGAAGTGTT",1,4,2,0,0,7,104
"TACGTCCAGTGCAACG",63,66,14,5,19,167,4338
"TACGTCCAGTTACGGG",2,10,2,0,2,16,278
"TACGTCCCAGCGTTTA",2,21,2,0,2,27,383
"TACGTCCGTACTCCCT",5,30,68,0,11,114,4219
"TACGTCCGTCACGCTG",1,3,0,0,2,6,101
"TACGTCCGTCGAGTTT",2,6,2,0,2,12,256
"TACGTCCGTCTCGCGA",1,7,0,0,2,10,194
"TACGTCCGTCTTAGTG",0,10,2,0,2,14,199
"TACGTCCTCTCATGGA",2,19,8,0,3,32,568
"TACTGCCAGACGAAGA",1,17,3,0,6,27,163
"TACTGCCAGATGGTCG",0,4,0,0,0,4,66
"TACTGCCCACCTGCAG",1,5,4,0,0,10,90
"TACTGCCGTAACATGA",0,6,0,0,3,9,246
"TACTGCCGTAACGGTG",3,8,2,0,5,18,44
"TACTGCCGTCCAGCCA",3,18,14,2,3,40,977
"TACTGCCGTGGAAGTC",1,0,2,0,0,3,124
"TACTGCCGTGTGGTCC",0,6,2,0,7,15,354
"TACTGCCGTTATGGTC",0,2,0,0,2,4,72
"TACTGCCGTTCTCCAC",0,3,0,0,0,3,45
"TACTGCCTCTGCACCT",0,0,0,0,0,0,161
"TACTGCCTCTTCGTAT",0,5,2,0,0,7,181
"TACTTACAGGTGCCTC",0,8,2,0,0,10,455
"TACTTACAGTCTTGGT",2,19,4,2,4,31,322
"TACTTACGTTACACTG",24,65,101,5,152,347,11684
"TACTTACGTTGGGATG",44,24,14,2,14,98,2991
"TACTTACTCACCCTCA",0,3,0,0,0,3,109
"TACTTACTCCTCGATC",9,53,28,2,98,190,6941
"TACTTACTCTGCCTCA",1,2,0,2,0,5,31
"TACTTACTCTTGATTC",1,4,2,0,0,7,136
"TACTTCAAGAATCGTA",0,4,0,0,0,4,55
"TACTTCAGTATTTCTC",0,4,0,0,2,6,155
"TACTTCAGTCCGGTCA",0,0,0,0,0,0,67
"TACTTCAGTTGGGCCT",10,59,11,3,10,93,3144
"TACTTCATCCCTCTTT",0,26,3,0,5,34,541
"TACTTCATCGATGCAT",0,3,2,0,0,5,9
"TACTTGTAGCCATTTG",1,3,0,0,2,6,92
"TACTTGTAGGCCCAAA",3,21,10,3,33,70,1914
"TACTTGTCAATTGCTG",3,10,6,0,6,25,358
"TACTTGTCACGATAGG",1,0,0,0,0,1,88
"TACTTGTCAGGTACGA",3,28,7,0,5,43,1810
"TAGACCACAAACTAAG",0,11,0,0,4,15,42
"TAGACCACAAGATGGC",2,0,0,0,0,2,72
"TAGACCACAATGACCT",1,2,0,0,0,3,28
"TAGACCATCGAGTTGT",163,149,47,148,48,555,12953
"TAGACCATCGTAACTG",1,0,0,0,0,1,54
"TAGACCATCTCGTCAC",0,0,2,0,0,2,6
"TAGACCATCTGATGGT",11,51,19,4,122,207,8060
"TAGACTGAGATTGATG",0,2,0,0,0,2,46
"TAGACTGAGTAGTCTC",2,11,0,0,0,13,115
"TAGACTGAGTATTAGG",1,2,4,0,0,7,86
"TAGACTGAGTGGTGGT",1,2,0,0,0,3,96
"TAGACTGCAAGGCAAC",2,9,5,0,4,20,401
"TAGACTGCACGAAAGC",0,2,3,0,0,5,134
"TAGACTGTCTCAGTCC",1,12,4,0,4,21,273
"TAGACTGTCTGTGTGA",3,7,0,0,5,15,293
"TAGAGTCAGTCACGCC",2,23,5,0,3,33,547
"TAGAGTCGTGCGTCGT",0,0,26,0,8,34,144
"TAGAGTCGTTGTCCCT",0,3,0,0,0,3,48
"TAGAGTCTCCGTAATG",0,0,0,0,0,0,53
"TAGAGTCTCTCGGTCT",0,2,0,0,0,2,9
"TAGATCGAGACTAAGT",2,19,5,0,5,31,96
"TAGATCGAGCTACTAC",0,2,3,0,0,5,75
"TAGATCGCACCAAATC",0,5,0,0,0,5,101
"TAGATCGCAGAGATGC",2,19,33,4,6,64,2533
"TAGATCGGTGAGCGAT",0,0,0,0,0,0,32
"TAGATCGGTGCTATTG",0,3,0,0,0,3,12
"TAGATCGTCATCGTAG",3,3,0,0,2,8,108
"TAGATCGTCGACTCCT",0,0,0,0,2,2,35
"TAGCACAAGGTTACCT",0,8,0,0,0,8,73
"TAGCACACAATGTCTG",6,66,10,5,10,97,2329
"TAGCACAGTGGACCTC",0,4,0,0,0,4,15
"TAGCACAGTGTTAACC",1,15,6,0,6,28,409
"TAGCACAGTGTTCCTC",1,14,12,0,5,32,994
"TAGCACATCCTACGGG",0,3,3,0,3,9,136
"TAGCACATCTCTAAGG",0,5,0,0,0,5,105
"TAGCACATCTTACCGC",0,2,0,0,0,2,18
"TAGGAGGCACGGATCC",0,4,0,0,0,4,58
"TAGGAGGCAGAGACTG",0,3,2,0,0,5,39
"TAGGAGGCAGAGTTGG",8,24,9,2,32,75,1911
"TAGGAGGCAGGTGACA",2,14,3,0,4,23,153
"TAGGAGGGTAAGTTAG",3,24,6,3,3,39,611
"TAGGAGGGTCTCGCGA",0,0,2,0,0,2,10
"TAGGAGGGTGTTACTG",0,0,0,0,0,0,10
"TAGGAGGTCGGCGATC",0,0,0,0,0,0,37
"TAGGGTTAGAGTAACT",4,21,5,2,6,38,388
"TAGGGTTCAAATACGA",1,2,0,0,2,5,51
"TAGGGTTCAAGACCGA",0,6,2,0,0,8,281
"TAGGGTTCAAGGCAAC",4,41,8,3,11,67,1845
"TAGGGTTGTATGCGGA",0,5,0,0,2,7,80
"TAGGGTTGTCAAGTTC",2,9,2,0,2,15,257
"TAGGGTTGTCACAGAG",0,2,0,0,0,2,51
"TAGGGTTGTGACTAAA",1,2,0,0,0,3,43
"TAGGGTTGTGTCTTGA",4,30,33,2,9,78,2634
"TAGGGTTTCGCCTTGT",0,2,0,0,0,2,190
"TAGGTACAGCTGACAG",27,99,62,11,272,471,16995
"TAGGTACAGGCCTTCG",1,21,3,3,2,30,678
"TAGGTACGTGCCTAAT",2,2,0,0,0,4,65
"TAGGTACTCACCCTGT",21,69,32,9,164,295,10132
"TAGGTACTCGGTCACG",60,507,121,28,99,815,27132
"TAGGTTGAGATCGGTG",1,6,0,0,0,7,214
"TAGGTTGAGGTTTGAA",0,2,0,0,2,4,84
"TAGGTTGCAACCGACC",2,0,2,0,0,4,72
"TAGGTTGCAGCCCACA",1,2,0,0,3,6,61
"TAGGTTGCAGCTACCG",9,106,25,6,19,165,6429
"TAGGTTGTCATATGGC",0,2,0,0,0,2,83
"TAGGTTGTCCGGTAAT",1,4,0,0,0,5,27
"TAGGTTGTCGGCTTGG",1,0,0,0,0,1,76
"TAGTGCACAGGAACCA",0,5,0,0,0,5,58
"TAGTGCACAGGTTCCG",1,11,5,0,2,19,379
"TAGTGCATCCTACGAA",3,14,5,0,7,29,419
"TATACCTAGACAAGCC",0,19,4,0,3,26,426
"TATACCTAGCGCCGTT",0,0,0,0,0,0,17
"TATACCTAGGAGCAAA",1,5,0,0,0,6,74
"TATACCTCAAGCGCTC",21,185,42,10,35,293,9471
"TATACCTCAATAGTAG",0,2,0,0,0,2,4
"TATACCTCACGACAAG",2,11,0,0,0,13,68
"TATACCTCAGCTACTA",181,984,714,101,1617,3597,141914
"TATACCTCAGGTGACA",0,0,0,0,0,0,56
"TATACCTCAGTCGGTC",3,3,0,0,0,6,39
"TATACCTCATCGTGGC",0,0,0,0,0,0,78
"TATACCTCATGACTTG",0,4,0,0,2,6,51
"TATACCTGTACAGTTC",0,6,4,0,2,12,81
"TATACCTGTCCCGTGA",22,79,219,14,82,416,16609
"TATACCTGTGGCTACC",2,20,3,2,3,30,398
"TATATCCAGACCATTC",0,3,0,0,0,3,6
"TATATCCAGTTGAATG",5,17,9,3,13,47,1049
"TATATCCCATGTGTCA",3,4,4,0,2,13,308
"TATATCCTCAGTCTTT",4,43,66,3,14,130,4751
"TATATCCTCATACAGC",0,7,0,0,0,7,143
"TATATCCTCGGAGATG",3,16,5,0,6,30,279
"TATATCCTCGTAGAGG",0,3,3,0,2,8,222
"TATATCCTCTACTATC",7,26,5,0,6,44,558
"TATATCCTCTTCTTCC",0,0,2,0,0,2,116
"TATCAGGAGAGCAGAA",0,0,0,0,0,0,60
"TATCAGGAGAGGTGCT",37,344,54,13,53,501,18923
"TATCAGGAGCAACTTC",13,48,118,7,16,202,7811
"TATCAGGAGCCGATCC",0,2,0,0,0,2,72
"TATCAGGAGGGCAACT",0,5,0,0,0,5,126
"TATCAGGAGGTCATAA",1,20,8,0,20,49,1552
"TATCAGGAGTTTGTCG",1,6,0,0,2,9,163
"TATCAGGCAGTAACCT",1,5,0,0,0,6,141
"TATCAGGGTCAAGCGA",1,15,8,0,0,24,618
"TATCAGGTCACTAGCA",35,154,34,12,38,273,7805
"TATCAGGTCGCATGAT",0,2,3,0,0,5,91
"TATCCTAAGGAGGTTC",2,13,5,0,0,20,267
"TATCCTAAGTAGTGCG",1,4,2,0,3,10,100
"TATCCTACAAAGACTA",1,3,0,0,0,4,28
"TATCCTACAATCGAAA",1,6,0,0,0,7,116
"TATCCTACAGGCGATA",0,4,0,0,0,4,52
"TATCCTAGTCTAGGCC",0,0,0,0,0,0,6
"TATCGCCAGAAACTCA",0,0,0,0,0,0,1
"TATCGCCAGCCACAAG",0,8,0,0,0,8,127
"TATCGCCAGGGAGTGG",0,0,3,0,0,3,137
"TATCGCCCAGTTCTAG",0,2,0,0,0,2,67
"TATCGCCGTTGGACTT",1,16,0,0,3,20,627
"TATCGCCTCACCGGGT",1,2,0,0,0,3,65
"TATCGCCTCGATACTG",0,4,5,0,0,9,363
"TATCGCCTCGTTCGCT",1,11,0,0,0,12,166
"TATCTGTAGCTAGAGC",76,42,20,3,18,159,3830
"TATCTGTCATATCTCT",1,11,2,0,9,23,487
"TATCTGTTCCATCTGC",1,5,0,0,0,6,105
"TATCTGTTCTGGGAGA",0,4,0,0,0,4,60
"TATCTGTTCTTAGTTC",2,12,0,0,2,16,30
"TATCTTGAGCATACTC",0,4,2,0,2,8,76
"TATCTTGCAACGCATT",0,3,0,0,0,3,79
"TATCTTGCAATCGTCA",0,4,0,0,0,4,81
"TATCTTGCACTGCGTG",0,0,0,0,0,0,13
"TATCTTGCAGTACTAC",4,19,5,0,8,36,701
"TATCTTGCATAGAGGC",0,0,0,0,0,0,24
"TATCTTGTCATGCAGT",0,3,4,0,0,7,232
"TATCTTGTCCTTCTGG",0,0,0,0,0,0,83
"TATCTTGTCGAGTCCG",1,8,4,0,2,15,89
"TATCTTGTCTTCACGC",0,3,0,0,0,3,114
"TATGTTCAGAGAAGGT",0,3,3,0,0,6,99
"TATGTTCAGGAGATAG",0,2,0,0,0,2,18
"TATGTTCGTCAAACGG",1,8,3,0,0,12,135
"TATGTTCGTCCGTTTC",2,18,0,0,0,20,472
"TATGTTCGTTGGTACT",0,2,0,0,0,2,27
"TATGTTCTCATCCTAT",13,88,21,7,16,145,4282
"TATGTTCTCGTGCTCT",0,3,0,0,0,3,32
"TATGTTCTCTTTCTAG",0,2,0,0,0,2,182
"TATTCCAAGGTTTGAA",0,0,0,0,0,0,12
"TATTCCACAACGGTAG",14,139,22,0,14,189,5879
"TATTCCACAATTTCTC",20,90,38,12,181,341,11287
"TATTCCACAGAGCGTA",1,0,0,0,0,1,1
"TATTCCAGTATGACAA",1,11,0,0,7,19,238
"TATTCCAGTCGCACGT",0,6,0,0,0,6,93
"TATTCCATCAGACATC",3,20,10,0,34,67,2266
"TATTCCATCCCATAAG",2,10,3,0,0,15,305
"TATTGCTAGTTAACAG",13,58,91,11,82,255,8146
"TATTGCTAGTTGGCTT",1,5,0,0,0,6,164
"TATTGCTCACAAGTGG",2,9,0,0,4,15,832
"TATTGCTCACTAGGTT",0,3,0,0,0,3,66
"TATTGCTGTGTTGAGG",6,54,15,5,37,117,4838
"TATTGCTTCAGAGTTC",2,20,19,2,16,59,1862
"TATTGCTTCCAAATGC",0,4,2,0,0,6,132
"TATTGGGCATGATGCT",2,6,0,0,0,8,160
"TATTGGGGTATCCTTT",0,2,0,0,0,2,101
"TATTGGGGTCAGTTTG",0,3,0,0,0,3,87
"TATTGGGTCACGGAGA",3,9,4,0,6,22,274
"TATTGGGTCGTGGCGT",3,14,2,0,4,23,239
"TATTGGGTCTGGTGGC",0,2,0,0,0,2,42
"TATTTCGAGCGACTGA",2,9,4,0,0,15,86
"TATTTCGAGTACAACA",76,54,25,7,42,204,6435
"TATTTCGAGTCAATCC",26,101,139,5,138,409,15537
"TATTTCGCACTTGTGA",2,27,7,0,5,41,543
"TATTTCGCAGGAGGTT",0,0,0,0,0,0,3
"TATTTCGCAGGCACAA",1,6,0,2,0,9,412
"TATTTCGCATCATTTC",1,2,0,0,0,3,70
"TATTTCGGTGAGAACC",6,21,54,5,22,108,4557
"TATTTCGGTGATGAAT",95,273,63,16,54,501,15508
"TATTTCGGTGTGACCC",0,2,0,0,0,2,42
"TATTTCGTCAGCCCAG",0,0,0,0,0,0,27
"TATTTCGTCCAAAGGG",0,13,0,0,0,13,222
"TATTTCGTCGTTGTGA",13,101,28,8,32,182,3637
"TATTTCGTCTCGACGG",1,0,0,0,0,1,5
"TCAAGACAGAGGTCGT",1,2,0,0,2,5,58
"TCAAGACCACGCCAGT",2,14,0,0,2,18,328
"TCAAGACCATCCTCAC",153,1575,324,72,249,2373,72727
"TCAAGACGTTAACAGA",0,7,25,0,3,35,1718
"TCAAGACTCCAATCTT",2,19,7,2,5,35,587
"TCAAGACTCGCCAATA",0,0,0,0,0,0,5
"TCAAGACTCGTAGTGT",0,0,0,0,0,0,22
"TCAAGCACAAGAATGT",0,3,0,0,0,3,65
"TCAAGCACAATAGTCC",2,24,5,0,3,34,829
"TCAAGCATCAACCCGG",4,13,3,0,2,22,68
"TCAAGCATCCCTCTTT",1,4,2,0,0,7,145
"TCAAGCATCTAGCATG",1,3,0,0,2,6,107
"TCAAGTGAGCTTCGTA",3,20,7,0,6,36,727
"TCAAGTGAGTAGACAT",0,0,0,0,0,0,13
"TCAAGTGCAAGACGGT",2,13,2,0,7,24,155
"TCAAGTGCAAGAGGTC",1,4,2,0,2,9,67
"TCAAGTGCAGCTGTAT",0,2,0,0,0,2,88
"TCAAGTGCAGGTGACA",0,3,2,0,0,5,111
"TCAAGTGGTCACTTCC",0,4,2,0,0,6,81
"TCAAGTGGTCTGTAGT",128,149,70,307,70,724,19248
"TCAAGTGGTGTTTGCA",0,24,5,3,3,35,254
"TCAAGTGTCAAACCTG",1,15,4,0,5,25,333
"TCAAGTGTCAAACTGC",0,3,0,0,0,3,134
"TCAAGTGTCACACGAT",5,17,6,0,6,34,128
"TCAAGTGTCCGATTAG",10,49,9,2,7,77,3453
"TCAAGTGTCGCCAGTG",4,26,9,0,15,54,1759
"TCAAGTGTCGCCGTGA",10,54,27,22,131,244,8407
"TCAATCTAGACCATTC",0,2,2,0,0,4,22
"TCAATCTAGCGTATGG",1,10,0,0,2,13,289
"TCAATCTAGCTACTAC",0,0,0,0,0,0,56
"TCAATCTCAATTGCAC",29,100,52,7,292,480,19475
"TCAATCTCAGAAACCG",0,6,3,0,0,9,55
"TCAATCTCATGGTACT",85,102,34,7,35,263,8777
"TCAATCTTCAGCGCAC",0,4,0,0,0,4,95
"TCAATCTTCATACGAC",0,0,0,0,0,0,4
"TCAATCTTCATTTCCA",1,4,2,0,0,7,15
"TCAATCTTCCGCACGA",22,239,29,9,31,330,12113
"TCAATCTTCGTCGGGT",17,24,7,0,10,58,931
"TCAATTCAGCTACTGT",0,4,3,0,0,7,76
"TCAATTCAGTAGCTCT",1,2,0,0,2,5,106
"TCAATTCCATGATGCT",0,2,0,0,0,2,103
"TCAATTCGTAAGTAGT",8,28,57,5,16,114,4786
"TCAATTCGTCGCAACC",0,3,2,0,2,7,229
"TCAATTCTCTGGGTCG",1,5,0,0,0,6,139
"TCACAAGAGGACATCG",0,3,0,0,0,3,27
"TCACAAGGTGCACAAG",2,5,12,0,13,32,1074
"TCACAAGTCCTGGGTG",1,0,5,0,0,6,281
"TCACACCAGGATATGT",2,2,0,0,0,4,112
"TCACACCCAAGACCTT",0,4,2,0,2,8,86
"TCACACCCAATTTCCT",0,2,2,0,0,4,72
"TCACACCCACAAGCAG",1,13,4,0,4,22,485
"TCACACCGTAACGATA",16,129,30,72,32,279,7652
"TCACACCGTCACGTGC",0,9,6,0,0,15,367
"TCACACCTCCTAGCCT",41,64,16,5,21,147,4149
"TCACACCTCGCACTCT",267,2734,485,110,427,4023,148785
"TCACACCTCTCCTACG",0,0,0,0,0,0,18
"TCACATTAGACTCCGC",2,5,0,0,0,7,105
"TCACATTAGATTAGAC",0,2,0,0,0,2,20
"TCACATTCAGACATCT",1,2,2,0,0,5,58
"TCACATTGTCGAAGCA",0,5,0,0,4,9,114
"TCACATTTCATCGTAG",0,0,0,0,0,0,29
"TCACGCTAGCGCTTCG",0,3,0,0,0,3,53
"TCACGCTAGGCGTTAG",0,3,2,3,4,12,161
"TCACGCTAGGTTACCT",10,46,27,4,103,190,7571
"TCACGCTAGTTGGACG",5,17,39,2,9,72,1863
"TCACGCTCAGTAGTGG",0,5,0,0,0,5,73
"TCACGCTCATCGGTTA",10,84,16,0,14,124,5484
"TCACGCTGTTGAGTCT",1,9,6,0,3,19,124
"TCACGCTTCACTCCGT",2,11,3,0,2,18,694
"TCACGCTTCATTCCTA",1,32,5,3,5,46,527
"TCACGCTTCCACGGGT",19,87,112,16,246,480,15176
"TCACGCTTCCTAACAG",2,7,10,0,2,21,715
"TCACGGGAGAGCACTG",0,0,0,0,0,0,26
"TCACGGGCAACTCCAA",0,3,0,0,0,3,14
"TCACGGGCAATCTGCA",0,3,0,0,0,3,76
"TCACGGGCATCCGAAT",9,66,18,3,11,107,4594
"TCACGGGGTAACTTCG",1,9,0,0,2,12,128
"TCACGGGGTCTTACAG",1,18,0,0,3,22,432
"TCACGGGTCATAGACC",1,13,5,0,0,19,389
"TCACGGGTCGGCCCAA",3,10,0,0,4,17,464
"TCACGGGTCGTGTCAA",0,2,0,0,0,2,65
"TCACTATAGATTGTGA",2,15,6,2,5,30,79
"TCACTATAGCCAAGGT",0,2,2,0,2,6,150
"TCACTATCACATCCCT",1,7,0,0,0,8,46
"TCACTATCACATGTTG",3,16,5,2,9,35,707
"TCACTATCAGCTGGTC",0,0,0,0,0,0,1
"TCACTATGTAGTGTGG",0,11,2,0,0,13,278
"TCACTATGTCTGTAGT",0,4,0,0,0,4,153
"TCACTATGTGTGAATA",0,16,0,0,5,21,406
"TCACTATTCATCTCTA",0,2,0,0,0,2,74
"TCACTATTCGTCTAAG",0,3,3,0,0,6,129
"TCACTCGAGAAACTAC",1,6,0,0,0,7,97
"TCACTCGAGTTGGACG",0,3,0,0,0,3,110
"TCACTCGCACGCGGTT",17,195,29,3,20,264,10455
"TCACTCGCAGTTCACA",0,5,0,0,0,5,187
"TCACTCGGTACCTAAC",7,14,7,2,23,53,1896
"TCACTCGTCAAGTCTG",0,0,0,0,0,0,125
"TCACTCGTCAGACTGT",1,6,3,8,0,18,638
"TCACTCGTCTCATAGG",1,3,4,0,0,8,165
"TCACTCGTCTCATGCC",0,8,0,0,0,8,159
"TCAGCAAAGCGATGCA",0,2,2,0,0,4,29
"TCAGCAAAGGACTATA",0,3,0,0,0,3,125
"TCAGCAACAGGACTTT",0,0,0,0,0,0,6
"TCAGCAACATATACCG",3,4,0,2,3,12,276
"TCAGCAACATGACCCG",6,42,8,0,8,64,2230
"TCAGCAAGTGTAGGAC",0,5,0,0,0,5,89
"TCAGCAAGTTGGTACT",0,11,5,2,3,21,472
"TCAGCAATCAAGTGTC",0,7,0,0,2,9,309
"TCAGCAATCCAACTGA",1,6,0,0,2,9,96
"TCAGCAATCCTCCACA",1,0,0,0,0,1,52
"TCAGCAATCTAGGCAT",0,0,0,0,0,0,102
"TCAGCCTAGCGTCGAA",0,0,0,0,0,0,33
"TCAGCCTCACGTTCGG",3,8,7,2,3,23,568
"TCAGCCTCAGCACGAA",0,2,0,0,2,4,106
"TCAGCCTCATGTGGCC",2,15,4,0,4,25,335
"TCAGCCTGTAACATCC",4,21,26,2,10,63,1823
"TCAGCCTGTAAGCTCT",3,24,15,2,6,50,1153
"TCAGCCTGTATTAAGG",0,0,0,0,0,0,13
"TCAGCCTTCACTCACC",3,25,9,2,9,48,844
"TCAGCCTTCACTCTTA",0,2,0,0,0,2,5
"TCAGCCTTCCGAACGC",0,5,0,0,2,7,155
"TCAGCCTTCTACGCAA",1,4,0,0,0,5,106
"TCAGCCTTCTTACGTT",0,4,0,0,0,4,120
"TCAGGGCAGATCCGAG",2,17,2,0,5,26,737
"TCAGGGCAGCGTTACT",0,3,0,0,0,3,146
"TCAGGGCAGCTGCCAC",0,0,0,0,0,0,25
"TCAGGGCCAGAAGCTG",0,2,3,0,2,7,107
"TCAGGGCGTACAGAAT",1,12,3,0,3,19,219
"TCAGGGCGTACTCGAT",0,2,0,0,0,2,93
"TCAGGGCGTGAGCTCC",2,3,2,0,0,7,188
"TCAGGGCTCACTTCTA",0,2,0,0,0,2,22
"TCAGGGCTCGGTCGAC",0,7,0,0,0,7,303
"TCAGGGCTCTAGCATG",1,12,32,2,4,51,1649
"TCAGGTAAGCTAGATA",0,5,0,0,2,7,190
"TCAGGTAAGGTCATAA",1,5,0,0,2,8,79
"TCAGGTAAGTCGCCAC",1,7,2,0,0,10,28
"TCAGGTAAGTGATAGT",1,3,2,0,0,6,74
"TCAGGTACACGCCACA",3,20,21,0,11,55,1574
"TCAGGTAGTTATCTTC",0,3,3,0,0,6,61
"TCAGTCCCAGAACATA",0,18,7,0,3,28,661
"TCAGTCCGTGGTAATA",18,160,32,10,30,250,7470
"TCAGTCCTCAGGCGAA",1,5,0,0,0,6,396
"TCAGTCCTCAGGGTAG",0,13,4,0,0,17,285
"TCAGTCCTCATTATCC",1,11,7,0,5,24,49
"TCAGTCCTCTATCCAT",3,11,5,2,3,24,560
"TCAGTCCTCTCTGGTC",10,36,28,5,53,132,4169
"TCAGTCCTCTTGTTAC",15,49,24,3,78,169,4347
"TCAGTGAAGGCCTGAA",0,0,0,0,0,0,9
"TCAGTGACACTTGGCG",0,0,0,0,0,0,43
"TCAGTGACATGAGAAT",3,10,11,3,2,29,484
"TCAGTGATCAAGTTGC",0,5,2,0,2,9,120
"TCAGTGATCACCCTGT",836,266,141,30,119,1392,49066
"TCAGTGATCAGTGATC",0,4,0,0,0,4,60
"TCAGTTTAGGGCAGTT",0,8,3,0,4,15,296
"TCAGTTTCAACTGTGT",7,22,24,2,11,66,1687
"TCAGTTTCAGGTCCCA",0,2,0,0,0,2,75
"TCAGTTTCATGGCCCA",0,0,0,0,0,0,3
"TCAGTTTGTAACGCGA",1,6,2,0,4,13,321
"TCAGTTTGTAGAGACC",0,5,0,0,0,5,48
"TCAGTTTGTCATCTAG",1,3,0,0,3,7,276
"TCAGTTTGTCTTCATT",5,8,3,0,0,16,105
"TCAGTTTGTGGACAGT",0,5,0,0,0,5,95
"TCAGTTTGTGTTTGCA",1,14,10,0,8,33,838
"TCAGTTTTCCACGAAT",0,3,0,0,0,3,89
"TCAGTTTTCTGCTAGA",1,0,0,0,2,3,40
"TCATACTAGGAAGTCC",2,25,6,3,4,40,1185
"TCATACTAGGCTATCT",3,32,3,0,5,43,625
"TCATACTAGTTAGAAC",3,10,2,0,0,15,70
"TCATACTCACCTATCC",12,90,15,2,16,135,4562
"TCATACTCAGGCCTGT",1,13,2,0,0,16,443
"TCATACTGTCGGATTT",1,3,2,0,0,6,120
"TCATACTGTCTGATAC",0,2,0,0,2,4,92
"TCATACTGTGAGAACC",0,5,2,0,0,7,85
"TCATACTTCATCTCTA",2,11,3,3,4,23,408
"TCATACTTCTCTTAAC",2,12,5,0,8,27,479
"TCATACTTCTGAATCG",0,2,0,0,2,4,50
"TCATATCAGCCGATCC",1,4,2,0,0,7,344
"TCATATCCAACCGTAT",29,104,193,10,68,404,15873
"TCATATCCAGCAGAAC",1,2,0,0,0,3,85
"TCATATCCAGGACAGT",1,3,0,0,0,4,23
"TCATATCGTCAACCAT",0,2,0,0,0,2,47
"TCATATCGTGATGTAA",0,2,0,0,2,4,75
"TCATATCTCCGATAGT",1,13,2,0,3,19,239
"TCATATCTCGTTAGTG",4,21,5,0,0,30,588
"TCATCATAGAGTGAAG",0,3,0,0,3,6,77
"TCATCATCAACTGTGT",0,0,0,0,0,0,21
"TCATCATGTCACTCTC",7,23,16,50,10,106,4222
"TCATCATGTCGACTTA",0,7,2,0,0,9,197
"TCATCATTCATTTGGG",1,10,0,0,3,14,570
"TCATCATTCGCAGATT",0,17,7,2,0,26,540
"TCATCATTCTTGGGCG",0,0,0,0,0,0,11
"TCATCCGAGAGGCCAT",2,17,5,0,3,27,506
"TCATCCGCAACACACT",0,5,0,0,0,5,65
"TCATCCGCAGTCACGC",5,29,11,0,7,52,70
"TCATCCGCAGTGGCTC",0,0,2,0,0,2,73
"TCATCCGCATCGATCA",0,9,0,0,4,13,268
"TCATCCGGTATACGGG",1,5,0,5,2,13,572
"TCATCCGGTCCTCAGG",0,0,0,0,0,0,82
"TCATCCGTCTGTAACG",0,10,5,0,2,17,375
"TCATGAGAGAGGTTAT",18,93,70,13,199,393,15266
"TCATGAGAGCGATGGT",0,3,3,0,2,8,111
"TCATGAGAGGAAGTAG",0,3,0,0,0,3,64
"TCATGAGAGTGACACG",0,0,0,0,0,0,15
"TCATGAGCATCGTCCT",0,3,0,0,0,3,29
"TCATGAGGTAAGACCG",1,10,3,0,2,16,575
"TCATGAGGTCACCGCA",0,0,2,0,2,4,37
"TCATGAGGTCCACAGC",0,2,0,0,0,2,63
"TCATGAGGTGCACATT",2,7,2,0,5,16,155
"TCATGAGGTGTCCTAA",1,14,3,3,4,25,141
"TCATGAGGTTAGTTCG",3,15,4,0,4,26,294
"TCATGAGGTTATTCCT",1,7,7,0,4,19,290
"TCATGCCAGCGGTAGT",1,2,0,0,0,3,34
"TCATGCCCAACCGATT",0,3,0,2,2,7,143
"TCATGCCCAACTCATG",3,4,0,0,0,7,213
"TCATGCCCAATGTGGG",1,3,3,0,0,7,509
"TCATGCCGTCGGTGTC",1,8,2,0,0,11,55
"TCATGCCGTGAATGTA",2,4,0,0,0,6,94
"TCATGCCTCAACCTTT",49,400,94,18,81,642,20916
"TCATGCCTCATCTGTT",4,5,0,0,0,9,242
"TCATGCCTCCGGTAAT",0,6,0,0,2,8,124
"TCATGCCTCGGTATGT",0,3,2,0,0,5,65
"TCATGCCTCGTTCAGA",0,8,0,2,0,10,296
"TCATGCCTCTGCCTCA",4,7,2,0,7,20,386
"TCATGGAAGCGTCTGC",0,0,0,0,2,2,45
"TCATGGAAGTCCTGTA",2,16,3,0,5,26,90
"TCATGGACACAGCCAC",0,0,0,0,0,0,2
"TCATGGACAGTTAGGG",14,105,17,2,19,157,5593
"TCATGGAGTACCGGCT",1,15,11,0,6,33,283
"TCATGGAGTACCGTCG",0,3,0,0,0,3,75
"TCATGGAGTATACGGG",25,292,34,10,34,395,11835
"TCATGGAGTGAATTGA",7,67,22,3,10,109,3118
"TCATGGATCCCGTTCA",2,20,4,0,2,28,813
"TCATGTTAGCCTAACT",0,0,0,0,0,0,81
"TCATGTTCACACCAGC",0,2,0,0,0,2,21
"TCATGTTCACTCATAG",0,0,0,0,0,0,19
"TCATGTTCAGAGGACT",0,3,0,0,0,3,75
"TCATGTTCAGAGGCTA",1,2,0,0,0,3,114
"TCATGTTGTTCTCCAC",0,2,0,0,2,4,82
"TCATGTTGTTGCTCGG",0,11,2,2,3,18,312
"TCATTACAGCGTGCTC",0,3,0,0,0,3,76
"TCATTACAGCGTTGTT",0,3,0,0,2,5,82
"TCATTACAGCTCAGAG",6,28,14,0,47,95,3038
"TCATTACCAAGATTGA",6,24,29,2,32,93,3289
"TCATTACCAGGTCCGT",0,5,0,0,0,5,88
"TCATTACCAGTAACAA",1,11,4,2,0,18,365
"TCATTACGTAACATCC",1,2,0,0,0,3,90
"TCATTACGTCCCAAAT",0,2,3,2,2,9,37
"TCATTACTCATTACGG",0,5,0,0,0,5,72
"TCATTACTCCGAGATT",0,5,2,0,0,7,105
"TCATTACTCTCTCCGA",0,2,2,0,0,4,46
"TCATTCACACGAAAGC",5,36,6,3,11,61,1366
"TCATTCACAGTGCGCT",1,14,0,0,4,19,656
"TCATTCAGTGACTGAG",2,4,2,0,0,8,47
"TCATTCAGTTCGAACT",1,2,0,0,0,3,89
"TCATTCATCACACCGG",1,5,3,0,0,9,106
"TCATTCATCTCGTTTA",0,6,2,0,0,8,131
"TCATTGTAGGGTACAC",0,3,0,0,0,3,7
"TCATTGTAGTTGTCGT",1,16,3,0,5,25,374
"TCATTGTCAGTTTGGT",0,6,0,0,0,6,96
"TCATTGTGTAGGCTGA",0,3,7,0,0,10,576
"TCATTGTGTTCATCTT",0,5,0,0,0,5,112
"TCATTGTGTTCGGCCA",0,2,0,0,0,2,128
"TCATTGTTCAAGCCCG",0,0,0,0,0,0,56
"TCATTGTTCAAGTCTG",29,163,40,12,41,285,8758
"TCATTGTTCGGACAAG",0,6,0,0,0,6,57
"TCATTTGAGAGCCCAA",0,3,0,0,0,3,91
"TCATTTGCAAATCCCA",0,0,3,0,0,3,50
"TCATTTGCAGGTAGTG",1,5,0,0,2,8,110
"TCATTTGTCGCTCTAC",0,3,0,0,0,3,43
"TCATTTGTCGGCTATA",63,631,182,28,114,1018,40217
"TCATTTGTCTCCCTAG",1,13,2,0,4,20,86
"TCCACCAAGCGAGGAG",0,3,0,0,0,3,89
"TCCACCACAAGAAACT",1,21,6,0,4,32,507
"TCCACCACATATGGCT",23,69,93,8,149,342,14027
"TCCACCAGTTCACCGG",20,273,41,6,48,388,15831
"TCCACCATCAAGCCTA",170,61,29,10,34,304,9363
"TCCACCATCATTCTTG",1,8,0,0,3,12,113
"TCCACCATCGCAACAT",0,6,0,0,0,6,141
"TCCACCATCGGTCTGG",0,4,2,0,2,8,97
"TCCACCATCTAGAGCT",2,17,2,2,5,28,77
"TCCACGTAGACGACGT",0,0,0,0,0,0,9
"TCCACGTAGCAACAGC",0,5,0,0,0,5,66
"TCCACGTAGCAATTAG",4,12,2,0,5,23,203
"TCCACGTAGGGAGATA",1,6,0,0,0,7,42
"TCCACGTAGTAGGAAG",0,2,0,0,0,2,75
"TCCACGTAGTTCCGGC",1,14,2,0,0,17,390
"TCCACGTCAATAACCC",0,3,0,0,0,3,99
"TCCACGTCAATAGGGC",2,0,0,0,0,2,42
"TCCACGTGTATGAAAC",0,2,0,0,0,2,34
"TCCACGTGTCGCATGC",0,0,0,0,0,0,19
"TCCACGTTCCCGTGAG",2,11,0,0,0,13,339
"TCCACGTTCGCCAGTG",0,2,0,0,2,4,102
"TCCACGTTCGTTCATT",1,17,7,0,7,32,109
"TCCACGTTCTCAGAAC",0,0,0,0,0,0,15
"TCCACGTTCTCTCGAC",1,7,2,0,3,13,333
"TCCAGAAAGAGCCGAT",0,5,0,0,0,5,90
"TCCAGAACAAATGGTA",0,0,0,0,0,0,7
"TCCAGAACACAAGCTT",6,28,25,2,8,69,2566
"TCCAGAACAGATTCGT",3,25,11,0,26,65,2271
"TCCAGAACATCCGTGG",0,4,0,0,0,4,79
"TCCAGAAGTATGCTTG",0,0,0,0,0,0,5
"TCCAGAAGTCAGTCTA",1,0,2,0,0,3,42
"TCCAGAATCACAACCA",3,10,4,0,0,17,286
"TCCAGAATCGCTTTAT",4,14,3,0,5,26,328
"TCCAGAATCTGTCAGA",0,3,0,0,0,3,47
"TCCATCGAGAGCCGAT",14,184,26,10,73,307,11325
"TCCATCGAGGGCCTCT",3,12,3,0,3,21,531
"TCCATCGCAACGTAAA",0,0,0,0,0,0,15
"TCCATCGCAAGAGGCT",1,0,0,0,0,1,102
"TCCATCGCAATTGCAC",0,2,0,0,0,2,64
"TCCATGCCACACCTGG",0,0,0,0,0,0,14
"TCCATGCCACGACAAG",2,16,3,0,2,23,463
"TCCATGCCATAGCACT",1,6,2,0,0,9,171
"TCCATGCGTCGTGTTA",0,22,0,0,0,22,59
"TCCATGCTCAAATGAG",1,30,4,0,7,42,659
"TCCATGCTCCGCATAA",5,29,44,2,9,89,2864
"TCCCACAAGGTCCCGT",2,50,2,2,7,63,1966
"TCCCACAGTCCCTGAG",1,8,2,0,2,13,464
"TCCCACAGTCGTGCCA",0,4,0,0,0,4,70
"TCCCACAGTTATCTGG",0,5,0,2,0,7,54
"TCCCACATCACCGCTT",0,5,0,0,0,5,305
"TCCCACATCTGGTCAA",0,0,0,0,0,0,110
"TCCCAGTAGAGAGCAA",1,3,0,0,2,6,201
"TCCCAGTAGCCTTTGA",1,5,0,0,0,6,142
"TCCCAGTAGTGCCTCG",2,15,4,0,3,24,466
"TCCCAGTCAAAGCACG",0,0,0,0,0,0,20
"TCCCAGTCATACTGTG",0,3,0,0,0,3,384
"TCCCAGTGTCCCTGAG",6,36,92,4,11,149,6273
"TCCCAGTGTCGAGCTC",1,10,0,0,0,11,244
"TCCCAGTGTGGCTCTG",0,0,0,0,0,0,7
"TCCCAGTTCATCCCGT",1,4,0,0,0,5,169
"TCCCAGTTCTCCCAAC",0,3,0,0,0,3,112
"TCCCATGAGATGAAGG",0,4,0,0,0,4,69
"TCCCATGAGTCTGCGC",1,0,0,0,0,1,119
"TCCCATGAGTTCTACG",0,18,0,0,4,22,400
"TCCCATGGTCAACACT",2,2,2,2,2,10,130
"TCCCATGGTCATCGCG",1,6,2,0,2,11,255
"TCCCATGGTTAATCGC",0,0,0,0,0,0,47
"TCCCATGTCAGAGTGG",0,3,0,0,0,3,71
"TCCCATGTCCGGCAGT",0,11,5,2,4,22,384
"TCCGAAAAGAAACTAC",6,22,76,0,8,112,3493
"TCCGAAAAGCTAAATG",61,528,93,27,88,797,26664
"TCCGAAAAGCTGAGCA",0,0,0,0,0,0,3
"TCCGAAACACTTCCTG",4,23,42,3,5,77,2512
"TCCGAAACATGTTCAG",6,16,5,0,36,63,2143
"TCCGAAAGTGCACATT",2,19,2,0,0,23,304
"TCCGAAAGTTGGGACA",1,5,0,0,2,8,51
"TCCGAAATCAATGTCG",2,8,4,0,3,17,352
"TCCGAAATCATGCTAG",27,296,60,15,52,450,15433
"TCCGAAATCCTCGCAT",1,7,0,0,0,8,153
"TCCGATCTCTAACGCA",2,22,21,0,8,53,1826
"TCCGGGAAGAGATTCA",0,3,0,0,0,3,192
"TCCGGGAAGCCTCCAG",0,0,0,0,0,0,18
"TCCGGGACAAGGGCAT",1,5,5,0,3,14,532
"TCCGGGACAGGGACTA",6,89,15,4,14,128,3798
"TCCGGGACAGTCTCTC",0,2,3,0,0,5,155
"TCCGGGACATCAGCGC",1,4,5,0,0,10,144
"TCCGGGACATGACCCG",1,7,3,0,2,13,357
"TCCGGGACATGACTTG",0,3,0,0,0,3,43
"TCCGGGAGTAACCCTA",2,17,8,0,6,33,617
"TCCGGGAGTCTCTCTG",0,3,0,0,0,3,23
"TCCGGGAGTTCTCTCG",3,17,4,2,0,26,523
"TCCGGGATCAACCGAT",0,0,0,0,0,0,11
"TCCGGGATCGGCCCAA",0,6,0,0,0,6,111
"TCCGTGTCAAGCAGGT",0,0,0,0,0,0,55
"TCCGTGTGTACCAATC",299,105,61,15,53,533,18203
"TCCGTGTTCACTGATG",8,33,48,3,47,139,5165
"TCCGTGTTCATCACTT",1,12,2,0,2,17,394
"TCCGTGTTCCAATCTT",19,28,7,0,8,62,1294
"TCCGTGTTCGGCTTGG",2,5,5,2,0,14,136
"TCCGTGTTCTGCGGCA",0,0,0,0,0,0,12
"TCCTAATAGATCCGAG",17,73,139,17,113,359,11728
"TCCTAATCATGAAGGC",0,5,0,0,0,5,108
"TCCTAATGTGATTAGA",0,2,0,0,0,2,2
"TCCTAATGTTACGGAG",43,25,8,0,13,89,2320
"TCCTAATGTTCGGCTG",1,0,0,0,0,1,55
"TCCTAATTCAGATGCT",36,397,75,10,62,580,24101
"TCCTAATTCGCTGACG",0,17,3,2,6,28,522
"TCCTAATTCTTACGGA",0,0,0,0,0,0,73
"TCCTCCCCAAGATTGA",95,875,152,46,137,1305,40175
"TCCTCCCCAGGCTCTG",0,0,2,0,0,2,136
"TCCTCCCCATCTCGTC",1,5,0,0,5,11,191
"TCCTCCCGTACAGAAT",0,0,0,0,0,0,44
"TCCTCCCGTCTCTCTG",0,0,0,0,2,2,171
"TCCTCCCGTTTCTATC",38,126,247,18,162,591,21740
"TCCTCCCTCACAGTGT",0,11,2,0,5,18,397
"TCCTCCCTCACATTGG",0,0,2,0,0,2,45
"TCCTCCCTCCCAAGCG",1,6,3,0,0,10,241
"TCCTCGAAGACCAGCA",2,17,4,0,14,37,1047
"TCCTCGAAGCTGTCCG",1,3,2,0,3,9,157
"TCCTCGAAGGTCCGAA",5,8,2,0,3,18,410
"TCCTCGACAACTCATG",0,3,0,0,0,3,107
"TCCTCGACACTTGTGA",15,72,183,5,29,304,11781
"TCCTCGACAGAGATGC",2,0,0,0,0,2,109
"TCCTCGACAGTATACC",0,3,0,0,0,3,83
"TCCTCGAGTACAGTTC",6,23,33,4,9,75,2698
"TCCTCGAGTAGAGACC",9,91,13,4,14,131,4927
"TCCTCGAGTCGTCGGT",0,0,0,0,0,0,3
"TCCTCGAGTGTTGACT",0,0,0,0,0,0,72
"TCCTCGATCGGCGATC",0,3,0,0,0,3,32
"TCCTCGATCGTGCTCT",0,4,0,0,0,4,48
"TCCTCTTAGACGGAAA",0,2,0,0,0,2,57
"TCCTCTTAGCACCAGA",15,51,149,6,23,244,9171
"TCCTCTTAGCGTTCAT",0,13,0,0,0,13,94
"TCCTCTTAGGTCGAGT",25,102,179,19,126,451,19386
"TCCTCTTAGTGGTTCT",162,1337,402,78,272,2251,85391
"TCCTCTTCAGGAGGTT",0,4,2,0,0,6,81
"TCCTCTTGTCAAACGG",0,4,0,0,0,4,78
"TCCTCTTTCTTCTCAA",2,14,0,0,5,21,56
"TCCTGCACAGTAGTTC",1,10,3,2,9,25,543
"TCCTGCAGTCCAACGC",42,37,11,39,18,147,4402
"TCCTGCAGTCTTCATT",0,0,0,0,0,0,31
"TCCTGCATCCTATTGT",0,7,0,0,2,9,71
"TCCTGCATCTCACGAA",11,53,130,9,21,224,7945
"TCCTTCTAGCTCACTA",0,4,0,0,0,4,163
"TCCTTCTCACGAGAAC",5,48,15,0,13,81,2090
"TCCTTCTCAGGCAATG",2,13,2,0,0,17,353
"TCCTTCTCATTCACCC",0,2,0,0,0,2,9
"TCCTTCTGTACAAGCG",2,11,4,0,4,21,349
"TCCTTCTGTATGATCC",2,40,6,0,2,50,944
"TCCTTCTGTCTAACTG",1,25,11,0,20,57,1586
"TCCTTCTGTGTCCAAT",0,3,3,0,0,6,89
"TCCTTCTTCAGGTAAA",27,95,53,13,247,435,14580
"TCCTTCTTCCGACGGT",0,0,0,0,0,0,8
"TCCTTCTTCCGATCTC",3,18,6,0,4,31,50
"TCCTTCTTCGATGGAG",5,16,7,0,5,33,473
"TCCTTTCAGGTCGACA",2,2,0,0,0,4,92
"TCCTTTCAGTTCCAGT",0,4,0,0,0,4,54
"TCCTTTCCAACTAGAA",1,12,5,0,2,20,259
"TCCTTTCCAATAACCC",1,15,0,0,0,16,454
"TCCTTTCGTGCACATT",1,3,3,0,0,7,8
"TCCTTTCGTGGCCCAT",0,4,0,0,2,6,66
"TCCTTTCGTTGACTAC",2,11,4,0,5,22,531
"TCCTTTCTCAGCGCAC",11,63,28,6,16,124,3509
"TCCTTTCTCGTCAAAC",0,4,0,0,4,8,175
"TCGAACAAGCAACTTC",1,2,2,0,0,5,31
"TCGAACAAGGAAAGTG",0,3,0,0,0,3,16
"TCGAACAAGTCGCTAT",0,0,0,0,0,0,41
"TCGAACACAAGTATCC",0,0,0,0,0,0,2
"TCGAACACAGAATGTA",3,39,8,5,6,61,125
"TCGAACACATCCGAAT",1,0,0,0,0,1,11
"TCGAACACATTGACCA",2,3,0,0,0,5,81
"TCGAACATCGCGTAGC",0,16,13,3,4,36,728
"TCGAAGTAGCACCCAC",0,4,0,0,0,4,135
"TCGAAGTAGCTTTCTT",3,23,2,0,2,30,407
"TCGAAGTAGTCCTGCG",0,0,0,0,0,0,3
"TCGAAGTAGTTTGGCT",4,24,2,0,3,33,405
"TCGAAGTCAAGAAACT",4,26,46,0,6,82,2961
"TCGAAGTCAAGTATCC",1,7,0,0,0,8,233
"TCGAAGTCAGGTATGG",1,2,0,0,2,5,17
"TCGAAGTCAGTGCGCT",0,4,0,0,0,4,79
"TCGAAGTGTAGCTCGC",0,0,0,0,0,0,1
"TCGAAGTGTGCACAAG",0,6,0,0,0,6,83
"TCGAAGTTCAAACTGC",0,3,2,0,0,5,50
"TCGAAGTTCGATCCAA",0,0,0,0,2,2,77
"TCGAAGTTCGGAGATG",0,2,0,0,0,2,25
"TCGAAGTTCTGAATCG",0,6,0,0,3,9,237
"TCGACCTAGACCATTC",1,14,5,0,17,37,1155
"TCGACCTAGATGAAGG",0,4,0,0,0,4,110
"TCGACCTCAGACCTGC",2,11,7,0,0,20,443
"TCGACCTCATTCCTCG",0,2,0,0,0,2,48
"TCGACCTGTGGCCCAT",1,0,0,0,0,1,70
"TCGACCTGTTAGGCTT",0,0,0,0,0,0,5
"TCGACCTTCAAGAATG",6,34,87,3,18,148,5605
"TCGACCTTCAAGAGTA",0,2,0,0,0,2,28
"TCGACCTTCAGACATC",0,15,2,2,4,23,347
"TCGACCTTCCGACATA",0,0,0,0,0,0,70
"TCGACCTTCCTTGAAG",0,4,0,0,0,4,53
"TCGACCTTCGAGTCTA",2,6,5,0,3,16,357
"TCGACGGAGAGTCAAT",1,10,2,0,3,16,344
"TCGACGGAGGAAGTGA",1,13,6,0,5,25,272
"TCGACGGAGGCATCGA",0,0,0,0,0,0,3
"TCGACGGAGGTCCTGC",0,9,9,0,3,21,821
"TCGACGGAGTGGTGAC",0,9,6,0,14,29,964
"TCGACGGCAAAGGATT",1,9,0,0,2,12,332
"TCGACGGCAATTTCTC",0,2,0,0,0,2,13
"TCGACGGCACCCTGTT",1,6,0,0,2,9,195
"TCGACGGCACTTGGCG",144,242,61,13,67,527,16160
"TCGACGGGTCATCTAG",0,3,0,0,3,6,35
"TCGACGGGTGCCGTTG",13,77,186,9,27,312,10221
"TCGACGGTCATGTCAG",57,547,110,46,103,863,30919
"TCGACGGTCCACTGGG",2,2,0,0,0,4,73
"TCGACGGTCTCCGATC",5,12,3,2,4,26,333
"TCGATTTCAGACTGCC",1,4,4,0,0,9,43
"TCGATTTCAGAGGTTG",1,13,3,0,5,22,341
"TCGATTTCAGCGAGTA",0,2,0,0,0,2,53
"TCGATTTCAGGAGGAG",2,13,0,0,3,18,184
"TCGATTTGTGTGGTCC",5,14,5,0,5,29,598
"TCGCACTAGTCACAGG",0,7,2,0,0,9,156
"TCGCACTCAAGAATGT",1,4,3,0,0,8,107
"TCGCACTCACCTCGTT",0,8,0,0,0,8,145
"TCGCAGGAGACTGTTC",1,4,0,0,0,5,106
"TCGCAGGAGGAAAGAC",2,17,2,0,2,23,653
"TCGCAGGAGGGAACAA",3,13,3,0,3,22,196
"TCGCAGGCATATCTCT",168,70,34,10,40,322,9410
"TCGCAGGGTGCCGGTT",1,10,7,0,2,20,272
"TCGCAGGTCCAACTAG",1,0,2,0,0,3,103
"TCGCAGGTCCTTACCG",2,0,0,0,0,2,67
"TCGCTCAAGATTCGAA",0,13,0,0,3,16,25
"TCGCTCAAGGAGAATG",3,10,3,0,0,16,389
"TCGCTCAAGTGGAATT",1,0,0,0,0,1,253
"TCGCTCACACTGTGAT",1,0,0,0,0,1,64
"TCGCTCACAGAGGTTG",3,33,5,0,8,49,1695
"TCGCTCACATACTGAC",2,10,2,0,3,17,329
"TCGCTCACATATGGCT",123,1185,238,71,222,1839,58865
"TCGCTCAGTGAGCCAA",0,5,0,0,0,5,96
"TCGCTCAGTTCGTTCC",0,0,0,0,0,0,8
"TCGCTCATCCGATCTC",0,0,0,0,0,0,66
"TCGCTCATCGAGATAA",0,3,0,0,0,3,53
"TCGCTTGAGGCCTGCT",0,0,0,0,0,0,18
"TCGCTTGCAACTGCTA",0,0,0,0,0,0,3
"TCGCTTGGTAACTGCT",3,15,6,4,3,31,469
"TCGCTTGGTGCCTTCT",3,24,10,0,8,45,539
"TCGCTTGTCCAACTGA",3,45,16,0,8,72,2574
"TCGGATAAGAGCCGTA",0,9,6,0,2,17,149
"TCGGATAAGAGTGTGC",7,27,4,3,3,44,1144
"TCGGATAAGCGATGGT",1,10,5,0,0,16,264
"TCGGATAAGGAACTCG",2,7,2,0,2,13,203
"TCGGATAAGGTAGTAT",9,50,4,5,12,80,2684
"TCGGATAAGGTTCACT",3,16,2,0,2,23,240
"TCGGATACATCCCACT",0,3,0,0,0,3,80
"TCGGATACATTGCTGA",1,24,7,0,5,37,547
"TCGGATAGTCGCACGT",0,2,0,0,0,2,15
"TCGGATATCGATACGT",1,15,4,0,3,23,636
"TCGGGACAGCACGTCC",3,50,11,2,9,75,1178
"TCGGGACAGTAGACAT",1,5,2,0,0,8,45
"TCGGGACGTAGCGTAG",4,20,8,3,47,82,2926
"TCGGGACGTGAATGAT",0,3,0,0,0,3,90
"TCGGGACTCTGACAGT",1,17,7,0,2,27,285
"TCGGGCAAGACCTCAT",2,13,0,0,4,19,83
"TCGGGCAAGACGTCGA",1,15,4,0,4,24,155
"TCGGGCAAGGACCCAA",0,5,2,0,2,9,234
"TCGGGCAAGGCATCGA",0,11,0,0,3,14,329
"TCGGGCAAGGTCCAGA",1,2,0,0,2,5,104
"TCGGGCACAAGTATAG",0,2,0,0,0,2,23
"TCGGGCACACATACTG",2,12,8,0,4,26,341
"TCGGGCACACTAGGTT",1,2,0,0,0,3,138
"TCGGGCAGTGACAGCA",40,490,77,16,77,700,19906
"TCGGGCAGTGAGTTGG",2,11,8,0,0,21,392
"TCGGGCAGTTCGTAAC",1,15,0,0,0,16,486
"TCGGGCATCCTGTAAG",0,0,0,0,0,0,23
"TCGGGCATCTGGCCAG",0,16,4,0,2,22,320
"TCGGGTGAGCGGGTAT",0,4,0,0,0,4,66
"TCGGGTGAGTGATCGG",15,167,26,8,27,243,8219
"TCGGGTGCATAAGCGG",0,13,0,0,2,15,219
"TCGGGTGGTCTCAGGC",0,9,2,0,0,11,238
"TCGGGTGGTGTTTGCA",0,0,0,0,0,0,51
"TCGGGTGTCAAACCTG",0,5,0,0,0,5,61
"TCGGTCTAGCTTGTGT",2,7,2,0,0,11,182
"TCGGTCTAGGGCAATC",0,2,0,0,0,2,17
"TCGGTCTAGTGGTCAG",0,0,0,0,0,0,12
"TCGGTCTCACACCGCA",1,7,0,0,2,10,263
"TCGGTCTCATGACACT",0,2,0,0,0,2,63
"TCGGTCTGTATCGAAA",1,21,4,0,4,30,297
"TCGGTCTGTCGCTCGA",0,0,0,0,0,0,0
"TCGTAGAAGCTCGTGC",0,3,0,0,2,5,113
"TCGTAGAAGGGCAGTT",0,13,6,0,2,21,330
"TCGTAGACAAGTATCC",2,5,2,0,0,9,75
"TCGTAGAGTCCTGGTG",0,0,0,0,0,0,27
"TCGTAGATCAGACCTA",161,1281,316,280,276,2314,65832
"TCGTAGATCCAACTAG",0,8,4,0,0,12,197
"TCGTAGATCGTAGCCG",0,2,0,0,2,4,101
"TCGTAGATCTAAGAAG",0,0,0,0,0,0,5
"TCGTCCAAGAAGCCTG",0,2,0,0,0,2,19
"TCGTCCAAGCTCTTCC",1,0,0,0,0,1,64
"TCGTCCAAGGGCAGGA",0,11,3,0,6,20,39
"TCGTCCACATAACAGA",6,27,45,0,8,86,1812
"TCGTCCACATCATTTC",7,41,64,3,17,132,3801
"TCGTCCACATTGACCA",6,35,79,4,16,140,4954
"TCGTCCAGTGTGAATA",0,5,0,0,2,7,45
"TCGTCCAGTTAGGGTG",1,6,0,0,2,9,207
"TCGTCCATCAAGTAAG",0,0,0,0,0,0,33
"TCGTCCATCGGTCACG",0,12,4,0,2,18,227
"TCGTGCTAGATACTGA",32,426,70,8,57,593,13710
"TCGTGCTAGGAGAGGC",2,0,0,0,0,2,57
"TCGTGCTCAACTGCTA",10,48,181,5,15,259,4923
"TCGTGCTCACTCCACT",1,2,0,0,0,3,48
"TCGTGCTCAGAGTGTG",0,4,0,0,0,4,45
"TCGTGCTCAGTCCGTG",171,64,25,8,25,293,4688
"TCGTGCTGTATCGTAC",13,269,45,6,34,367,7189
"TCGTGCTGTTCTCTCG",0,4,0,0,0,4,23
"TCGTGGGAGAGTTGCG",3,9,0,0,0,12,135
"TCGTGGGAGATTGAGT",0,2,0,0,0,2,17
"TCGTGGGAGGCGAAGG",5,7,4,0,4,20,272
"TCGTGGGAGTGCGCTC",0,0,0,0,0,0,5
"TCGTGGGCAAGATTGA",3,64,7,2,3,79,1511
"TCGTGGGCAGACTGCC",1,8,0,0,3,12,217
"TCGTGGGCAGTTAGAA",2,6,3,0,0,11,118
"TCGTGGGCATGTCTAG",0,8,0,0,2,10,159
"TCGTGGGGTACGGCAA",0,2,0,0,0,2,25
"TCGTGGGGTTGTTTGG",19,35,55,5,69,183,6277
"TCGTGGGTCTAGGAAA",2,24,6,32,8,72,1146
"TCGTGGGTCTGCAGCG",8,32,10,2,12,64,707
"TCTAACTAGAGATTCA",2,21,10,0,3,36,724
"TCTAACTAGCGCCTAC",2,10,7,0,5,24,1003
"TCTAACTCATTGTAGC",0,4,0,0,0,4,146
"TCTAACTGTAGTATAG",1,11,2,0,2,16,320
"TCTAACTGTGTTCCAA",0,2,0,0,2,4,48
"TCTAACTTCACCACAA",0,7,2,0,0,9,72
"TCTAACTTCTGAGCAT",6,43,17,3,9,78,2280
"TCTACATAGGTAGTAT",0,3,0,0,0,3,34
"TCTACATCAAGAGTTA",0,4,0,0,2,6,130
"TCTACATCACTAGTAC",2,6,4,0,3,15,264
"TCTACATCATGACGAG",0,6,2,0,2,10,134
"TCTACATGTCGCATTA",3,16,16,2,20,57,1535
"TCTACATGTGAATTAG",67,709,134,35,125,1070,39493
"TCTACATTCCGAGAAG",1,9,6,0,5,21,260
"TCTACCGAGTGTTCCA",0,8,0,0,0,8,175
"TCTACCGCACCAGTTA",0,0,0,0,0,0,38
"TCTACCGGTCGCATCG",6,30,42,3,39,120,4022
"TCTACCGGTCGTCATA",0,10,5,0,4,19,353
"TCTACCGGTTTCGACA",1,15,2,2,3,23,520
"TCTACCGTCAGAGTGG",1,0,0,0,0,1,3
"TCTATACCAAGTTCGT",35,220,57,22,226,560,19276
"TCTATACCAGACCTAT",37,248,39,9,39,372,12226
"TCTATACCAGGAGACT",9,34,64,2,16,125,4075
"TCTATACCATCCTATT",3,13,3,0,4,23,441
"TCTATACCATCCTTGC",0,5,0,0,2,7,73
"TCTATACGTAGCTCGC",0,4,0,0,0,4,161
"TCTATACGTATCGCTA",3,15,4,0,4,26,437
"TCTATACGTATTGACC",1,6,3,2,0,12,99
"TCTATACGTGCATCTA",0,3,0,0,2,5,72
"TCTATACTCATGCGGC",5,10,3,0,4,22,369
"TCTATACTCCGGCTTT",1,10,0,0,3,14,352
"TCTATACTCTTGGCTC",6,74,20,2,15,117,3865
"TCTATACTCTTTGCTA",0,0,0,0,3,3,52
"TCTATCAAGCATGAAT",2,4,2,0,3,11,270
"TCTATCAAGGCCTGCT",1,7,0,0,9,17,1044
"TCTATCACACGAAGAC",0,2,0,0,0,2,114
"TCTATCACACGATAGG",0,2,0,0,0,2,54
"TCTATCACAGCTCCTT",1,3,0,0,0,4,126
"TCTATCAGTGACCTGC",131,427,116,24,80,778,23206
"TCTATCAGTTCACCGG",79,264,48,12,46,449,11824
"TCTATCATCACCGACG",1,2,0,0,0,3,208
"TCTATCATCTTCTAAC",0,3,2,0,0,5,124
"TCTCACGCAAACAGGC",153,142,43,20,34,392,12528
"TCTCACGCACAAATGA",2,15,3,0,7,27,660
"TCTCACGCACCACATA",0,0,0,0,0,0,1
"TCTCACGCACGCTGCA",0,4,0,0,0,4,88
"TCTCACGCAGCGACCT",3,17,3,0,2,25,425
"TCTCACGGTATAGCTC",0,0,0,0,0,0,29
"TCTCACGGTCCGGTGT",0,6,0,0,2,8,330
"TCTCACGTCGCTTGAA",4,11,32,0,13,60,1243
"TCTCAGCAGACCATAA",90,826,190,34,155,1295,41405
"TCTCAGCAGATCGGTG",0,0,0,0,0,0,16
"TCTCAGCAGCCTCTGG",0,2,3,0,0,5,36
"TCTCAGCAGGGTTAGC",0,0,0,0,0,0,68
"TCTCAGCAGTAAGACT",1,3,0,0,0,4,19
"TCTCAGCCAGAACTCT",2,7,2,0,2,13,377
"TCTCAGCGTGGCTCTG",0,2,0,0,0,2,77
"TCTCAGCGTGTAAATG",11,44,125,7,19,206,8363
"TCTCAGCTCGGTAACT",2,7,0,0,4,13,201
"TCTCCGACAGCTTTGA",2,12,3,0,3,20,434
"TCTCCGAGTAGGCTGA",3,23,10,2,50,88,4055
"TCTCCGAGTGTTCATG",1,0,0,0,0,1,114
"TCTCCGATCACTGTCC",1,2,2,0,0,5,95
"TCTCCGATCGAGTCTA",4,32,8,0,8,52,1557
"TCTCCGATCTAGTACG",0,2,0,0,0,2,7
"TCTCTGGAGCCTGTCG",1,13,6,2,5,27,282
"TCTCTGGCAAATAAGC",1,18,2,0,7,28,560
"TCTCTGGCACTGTCCT",1,3,2,0,0,6,154
"TCTCTGGCAGGACATG",0,0,0,0,0,0,15
"TCTCTGGGTGATGTAA",1,0,0,0,0,1,151
"TCTGCCAAGCCTGACC",0,0,2,0,2,4,140
"TCTGCCAAGTGGGAAA",2,14,14,0,6,36,1057
"TCTGCCACAAACGGCA",0,5,0,0,0,5,177
"TCTGCCACAATTGAGA",0,0,0,0,0,0,60
"TCTGCCACATCGTTCC",0,0,0,0,0,0,18
"TCTGCCACATGTCAGT",1,2,2,0,0,5,71
"TCTGCCAGTATCATGC",2,20,5,0,3,30,887
"TCTGCCAGTGTCATCA",0,12,6,0,3,21,394
"TCTGCCAGTGTCCACG",1,0,0,0,0,1,31
"TCTGCCATCACAAGGG",6,66,10,2,11,95,2853
"TCTGCCATCATCGTAG",0,4,0,0,0,4,37
"TCTGCCATCTCCATAT",0,2,0,0,0,2,18
"TCTGGCTAGCCAACCC",2,4,0,0,0,6,282
"TCTGGCTAGTAGTCTC",2,3,4,0,0,9,144
"TCTGGCTAGTCCTGCG",0,6,2,0,0,8,268
"TCTGGCTGTAGTCTGT",1,12,0,0,2,15,294
"TCTGGCTGTCCTACAA",0,4,0,0,4,8,96
"TCTGGCTGTTTCACAG",9,99,26,4,19,157,4808
"TCTGGCTTCCTCGATC",9,38,12,0,10,69,1848
"TCTGGCTTCGAACGGA",2,14,3,0,2,21,542
"TCTGTCGAGCCTAGGA",83,232,49,9,47,420,13158
"TCTGTCGAGGAGAGTA",1,5,0,0,0,6,80
"TCTGTCGAGGCACTCC",0,0,0,0,0,0,4
"TCTGTCGAGTGCAGCA",0,3,2,0,2,7,47
"TCTGTCGCACATTCTT",13,67,40,9,126,255,8466
"TCTGTCGCAGAGGACT",0,7,4,0,0,11,226
"TCTGTCGCATGTCAGT",0,2,4,0,0,6,46
"TCTGTCGGTGTGGACA",2,5,0,0,0,7,92
"TCTGTCGGTTGACTGT",0,3,0,0,0,3,130
"TCTGTCGTCCTTCTTC",1,0,2,0,0,3,95
"TCTGTCGTCGTCTCAC",0,5,5,0,2,12,38
"TCTTAGTAGAGATCGC",3,15,6,0,3,27,519
"TCTTAGTAGAGTCAGC",1,11,0,0,2,14,354
"TCTTAGTGTAAGCAAT",1,2,4,0,0,7,105
"TCTTAGTGTATACGGG",0,3,0,0,0,3,205
"TCTTAGTGTGCCTGCA",0,4,0,0,0,4,140
"TCTTAGTTCTCCTGTG",0,3,0,0,0,3,77
"TCTTAGTTCTTTACAC",3,8,0,0,0,11,223
"TCTTCCTAGGATTTGA",2,17,2,0,4,25,417
"TCTTCCTAGGCCCACT",1,12,2,0,6,21,670
"TCTTCCTAGTACCGGA",0,4,2,0,0,6,73
"TCTTCCTAGTGCACCC",0,3,0,2,2,7,140
"TCTTCCTCAACGCCCA",2,7,0,0,0,9,118
"TCTTCCTCACTTGAGT",0,11,3,0,3,17,290
"TCTTCCTTCGGCCAAC",0,5,2,0,3,10,18
"TCTTCCTTCTAGCAAC",0,2,0,0,0,2,33
"TCTTCCTTCTGTGCTC",24,19,6,3,11,63,2342
"TCTTCCTTCTTGCAGA",0,0,0,0,2,2,142
"TCTTGCGAGGCCTAGA",0,2,0,0,0,2,57
"TCTTGCGAGTTTGAGA",2,12,5,0,8,27,370
"TCTTGCGGTTCTCTAT",0,0,0,0,2,2,85
"TCTTGCGTCCTTCAGC",0,0,0,0,0,0,14
"TCTTTGAAGCCGAACA",0,3,0,0,0,3,47
"TCTTTGAAGTACAGAT",5,32,31,3,17,88,2678
"TCTTTGACACGGCACT",17,142,24,5,25,213,8566
"TCTTTGAGTAACGTTC",0,0,0,0,0,0,58
"TCTTTGAGTATACCCA",3,41,7,0,8,59,1837
"TCTTTGAGTGGATCGA",54,208,415,22,297,996,39974
"TCTTTGATCAAGTGGG",0,8,0,0,0,8,91
"TCTTTGATCGAGAATA",1,12,4,3,6,26,347
"TCTTTGATCGCCAGTG",0,0,0,0,3,3,13
"TGAACGTAGGCCTGCT",3,14,4,0,9,30,801
"TGAACGTAGTCCCGGT",2,15,8,0,4,29,508
"TGAACGTCACCAACAT",1,2,2,0,0,5,108
"TGAACGTGTCGCGGTT",43,193,84,6,42,368,12436
"TGAACGTGTGCAGATG",4,8,0,0,2,14,509
"TGAACGTGTTAGAAGT",1,11,2,0,3,17,170
"TGAACGTTCTCAACCC",4,23,19,0,6,52,1055
"TGAACGTTCTTTCCAA",40,142,443,19,113,757,28316
"TGAATCGAGCATAGGC",0,4,0,2,0,6,27
"TGAATCGAGTCAATCC",1,11,0,0,2,14,755
"TGAATCGCAAGCAATA",0,10,2,0,2,14,225
"TGAATCGCAGCTACAT",0,3,0,0,0,3,89
"TGAATCGGTACTGTTG",0,3,0,0,2,5,287
"TGAATCGGTGTTAGCT",0,6,0,0,2,8,71
"TGAATCGTCACGATCA",1,4,0,0,0,5,121
"TGAATGCAGACTGGGT",0,6,0,0,2,8,311
"TGAATGCAGATGCTAA",6,34,53,2,8,103,3217
"TGAATGCAGTGCAAAT",1,4,0,0,0,5,24
"TGAATGCAGTTAACGA",1,0,0,0,0,1,12
"TGAATGCCACTCCCTA",10,82,40,3,17,152,4347
"TGAATGCCAGCACAGA",0,2,0,0,0,2,12
"TGAATGCCAGGGAGAG",0,2,2,0,0,4,45
"TGAATGCCAGTTGTTG",0,6,0,0,0,6,109
"TGAATGCGTCAGTCTA",0,5,2,0,3,10,224
"TGAATGCTCGCCTCTA",0,9,0,0,3,12,694
"TGACAGTAGTCGAAGC",1,4,0,0,0,5,118
"TGACAGTCAAGAGTGC",0,8,0,0,2,10,295
"TGACAGTCACGGGCTT",1,3,0,0,2,6,237
"TGACAGTCATGGAAGC",3,49,6,5,8,71,2299
"TGACAGTGTATGACAA",0,4,2,0,3,9,130
"TGACAGTGTCGAATGG",0,3,0,0,0,3,87
"TGACCCTAGACTACGG",0,0,0,0,0,0,4
"TGACCCTAGGAGGGTG",0,2,0,0,0,2,65
"TGACCCTCAGGACTAG",2,14,6,0,3,25,614
"TGACCCTGTGACAGGT",0,0,0,0,0,0,7
"TGACCCTGTGCCGTTG",0,0,0,0,0,0,48
"TGACCCTTCACCATAG",0,14,5,0,5,24,336
"TGACGCGAGAGAGCCT",0,5,2,0,0,7,132
"TGACGCGAGATACATG",2,9,0,2,0,13,51
"TGACGCGCAAATACAG",1,3,0,0,0,4,119
"TGACGCGCAAATGATG",0,5,0,0,0,5,93
"TGACGCGCACTGGACC",0,5,0,0,2,7,65
"TGACGCGGTGACTCGC",0,2,0,0,0,2,75
"TGACGCGGTTTCGGCG",1,14,3,0,4,22,336
"TGACTCCAGGGATGTC",0,0,0,0,0,0,6
"TGACTCCAGGTAGTCG",7,40,88,5,18,158,6219
"TGACTCCAGTATGATG",9,94,44,6,22,175,6366
"TGACTCCCACGCCACA",0,0,0,0,0,0,28
"TGACTCCCACTGGAAG",0,19,5,0,4,28,94
"TGACTCCCAGAAGCGT",1,5,0,0,0,6,72
"TGACTCCCAGAAGCTG",0,4,2,0,2,8,158
"TGACTCCCAGCTATAC",6,24,32,2,11,75,1975
"TGACTCCCATACTGAC",46,171,582,26,90,915,34230
"TGACTCCGTCCCGTGA",2,6,0,0,2,10,169
"TGACTCCGTCGTATTG",4,13,9,0,5,31,718
"TGACTCCGTGGTCTAT",1,3,4,0,8,16,287
"TGACTCCTCGGAATTC",0,5,5,0,0,10,114
"TGACTCCTCTTCTGTA",0,5,0,0,0,5,81
"TGAGACTAGATGATTG",1,14,2,0,4,21,452
"TGAGACTAGCCTATCA",43,423,88,23,73,650,25304
"TGAGACTAGTTTAGGA",1,20,7,0,2,30,44
"TGAGACTCAAAGAACT",0,0,0,0,0,0,0
"TGAGACTCAGCTTCCT",21,71,168,8,29,297,11326
"TGAGACTCAGGACTAG",1,0,0,0,0,1,74
"TGAGACTGTTTACTTC",0,0,0,0,0,0,3
"TGAGACTGTTTAGTCG",15,47,120,6,19,207,7632
"TGAGCATAGACCAGAC",0,7,0,0,0,7,95
"TGAGCATCAGGAGGAG",0,0,0,0,0,0,42
"TGAGCATCATGGACAG",0,2,0,4,0,6,255
"TGAGCATGTAGTCACT",38,373,70,21,87,589,19329
"TGAGCATGTTAGGAGC",2,0,0,0,0,2,74
"TGAGCATGTTATTCTC",45,147,291,17,218,718,28106
"TGAGCATGTTTAGTCG",8,48,15,4,12,87,3165
"TGAGCATTCAAGCCAT",1,0,0,0,0,1,35
"TGAGCATTCGCACTCT",0,11,0,0,0,11,368
"TGAGCATTCTGAGCAT",23,206,34,12,30,305,10579
"TGAGCGCAGTGATAAC",0,4,0,0,0,4,63
"TGAGCGCCATGATGCT",3,6,3,0,3,15,185
"TGAGCGCCATTCGGGC",2,10,0,0,0,12,211
"TGAGCGCGTTCTCCCA",0,0,0,0,0,0,56
"TGAGCGCTCCAACCAA",0,9,4,0,0,13,38
"TGAGGAGAGAGCCCAA",0,3,0,0,0,3,35
"TGAGGAGAGAGGTTTA",0,4,0,0,0,4,90
"TGAGGAGAGCCGAACA",3,22,6,2,20,53,1791
"TGAGGAGAGGAGTATT",2,0,0,0,0,2,61
"TGAGGAGCATCGCTCT",2,2,0,0,0,4,88
"TGAGGAGCATGAGGGT",0,6,0,0,0,6,74
"TGAGGAGGTCCGGTCA",0,2,0,0,0,2,21
"TGAGGAGGTCTGCATA",0,0,0,0,2,2,8
"TGAGGAGTCCAACCGG",1,0,0,0,0,1,15
"TGAGGAGTCTCCACTG",1,0,5,0,0,6,315
"TGAGGGAAGTAAGAGG",0,0,0,0,0,0,96
"TGAGGGAAGTACCCTA",2,17,0,0,0,19,640
"TGAGGGAGTAGTTACC",0,7,0,0,0,7,353
"TGAGGGAGTCTGTAAC",0,0,0,0,2,2,92
"TGAGGGATCCCTATTA",2,14,4,0,0,20,300
"TGAGGTTAGTGTAGTA",0,0,0,0,0,0,57
"TGAGGTTCAGAACATA",2,3,2,0,0,7,83
"TGAGGTTCATGTCGTA",1,6,0,0,0,7,180
"TGAGGTTGTACGAGTG",0,0,0,0,0,0,4
"TGAGGTTGTCCATACA",0,0,0,0,0,0,2
"TGAGGTTTCCTTTAGT",0,0,0,0,0,0,55
"TGAGTCACAACCAATC",2,2,4,0,3,11,289
"TGAGTCACACCAGTAT",1,0,0,0,0,1,52
"TGAGTCACACTGTGAT",1,4,0,0,0,5,126
"TGAGTCACAGCGTACC",0,5,0,0,0,5,37
"TGAGTCACAGGGATAC",1,4,0,0,0,5,157
"TGAGTCAGTGTAGCAG",54,570,108,22,87,841,29745
"TGAGTCAGTGTGTTTG",1,4,0,0,0,5,66
"TGAGTCAGTTTGACAC",0,36,9,2,4,51,1305
"TGAGTCATCCAAACCA",1,12,0,0,5,18,383
"TGAGTCATCCCGAACG",30,192,35,11,43,311,9039
"TGAGTCATCCGACAGC",22,16,8,0,5,51,1566
"TGAGTCATCCGTCCTA",17,187,27,8,27,266,9176
"TGAGTCATCGTGGTAT",0,7,2,0,0,9,57
"TGATCAGCACTGGCGT",8,83,10,2,14,117,4081
"TGATCAGCATCTCAAG",0,2,0,0,2,4,113
"TGATCAGTCGTTCTGC",2,11,3,0,2,18,363
"TGATCAGTCTGCAGCG",1,4,0,0,0,5,71
"TGATCTTAGCGAGTAC",7,13,3,0,4,27,398
"TGATCTTAGTTACTCG",3,6,2,0,2,13,171
"TGATCTTGTCATACCA",16,191,35,11,37,290,9813
"TGATCTTGTGCCTACG",2,10,2,4,9,27,1036
"TGATCTTTCACGTCCT",0,5,2,0,0,7,104
"TGATCTTTCAGCAATC",1,4,3,0,0,8,37
"TGATGCAAGAAGCGCT",4,73,25,2,18,122,5529
"TGATGCAAGGTAGACC",0,0,0,0,0,0,16
"TGATGCAAGTGGTTCT",0,6,0,0,3,9,494
"TGATGCAGTAACATCC",2,10,2,0,3,17,284
"TGATGCAGTACAGTCT",15,145,28,12,33,233,5799
"TGATGCAGTATAGGAT",0,15,3,0,0,18,291
"TGATGCAGTATCAAGA",4,52,8,0,11,75,2816
"TGATGCAGTCTGTGGC",0,6,0,0,0,6,164
"TGATGCAGTTGAAGTA",2,24,8,0,27,61,2301
"TGATGCAGTTTGGGAG",0,2,0,0,0,2,64
"TGATGCATCATGCTAG",0,0,0,0,0,0,47
"TGATGGTAGGCTAACG",0,4,0,0,0,4,65
"TGATGGTCAACCAACT",0,6,2,0,0,8,117
"TGATGGTCACGACAGA",3,2,0,0,0,5,145
"TGATGGTCAGTGGCTC",0,8,6,0,0,14,496
"TGATGGTCATGGCGCT",1,2,0,0,0,3,86
"TGATGGTGTCATCCGG",0,0,0,0,0,0,59
"TGATGGTGTCCTCATC",0,0,0,0,0,0,92
"TGATGGTGTTATGACC",0,19,5,0,5,29,587
"TGATTCTAGACCGCCT",2,4,0,0,2,8,438
"TGATTCTAGAGCCGAT",0,2,0,0,0,2,119
"TGATTCTAGCCTATTG",3,20,4,0,9,36,834
"TGATTCTAGTCCTACA",0,6,6,0,0,12,96
"TGATTCTCAGCGTGCT",2,3,0,0,0,5,132
"TGATTCTCAGCTGAGA",1,7,0,0,0,8,96
"TGATTCTCATCTAGAC",2,15,6,0,3,26,857
"TGATTCTCATCTGCGG",0,2,2,0,0,4,111
"TGATTCTGTACCCGAC",1,4,0,0,0,5,211
"TGATTCTGTGACTCGC",20,67,217,5,33,342,12747
"TGATTCTTCAAGAGGC",1,2,0,0,0,3,187
"TGATTCTTCAGGTAAA",3,15,8,0,2,28,530
"TGATTCTTCTTAGCCC",6,34,18,6,56,120,2853
"TGATTTCAGCAACCAG",0,5,3,0,2,10,192
"TGATTTCCAAGCCCAC",9,37,19,76,17,158,5423
"TGATTTCCAATTGAAG",6,50,13,3,50,122,2418
"TGATTTCCACGTCGGT",0,0,0,0,0,0,18
"TGATTTCCAGAAGTGC",1,9,3,0,3,16,148
"TGATTTCGTAACCCTA",0,6,3,0,2,11,153
"TGATTTCGTAAGATAC",0,5,0,2,2,9,110
"TGATTTCGTGACATCT",4,14,6,11,9,44,904
"TGATTTCGTGCATCTA",2,5,6,0,3,16,306
"TGCACGGAGCCGTAAG",42,133,373,24,65,637,16488
"TGCACGGAGCGTGCTC",0,0,0,0,0,0,2
"TGCACGGCAAACTCTG",2,11,3,0,0,16,366
"TGCACGGCACGAAGAC",0,0,3,0,0,3,58
"TGCACGGCACGAGAAC",1,0,0,0,0,1,29
"TGCACGGCAGGTTCCG",0,10,3,0,2,15,326
"TGCACGGGTCTGATAC",28,437,66,21,69,621,20789
"TGCACGGGTGTACAGG",21,79,138,10,150,398,14156
"TGCACGGGTTACCTGA",0,5,2,0,0,7,257
"TGCACGGTCACACGAT",1,0,0,0,0,1,21
"TGCACGGTCATCACCC",1,6,4,3,2,16,281
"TGCACGGTCCCAACTC",0,0,0,0,0,0,13
"TGCAGATAGCACCTGC",0,2,2,0,0,4,150
"TGCAGATAGTCCGCGT",0,6,2,0,0,8,275
"TGCAGATAGTGCTCAT",0,14,0,0,5,19,449
"TGCAGATCAAGTGGGT",1,4,0,0,4,9,417
"TGCAGATCACAACGAG",0,13,0,0,0,13,405
"TGCAGATCACGGGTAA",0,3,0,0,0,3,36
"TGCAGATGTACGCTAT",0,2,0,0,0,2,80
"TGCAGATGTAGACTGG",103,45,17,2,17,184,5126
"TGCAGATGTCAATCTG",0,2,2,0,2,6,136
"TGCAGATGTGGCTGAA",0,0,2,0,0,2,69
"TGCAGATTCATTTCCA",1,12,2,0,3,18,239
"TGCAGGCAGAACGCGT",1,0,0,0,0,1,44
"TGCAGGCAGAGTCAGC",9,11,53,0,5,78,2456
"TGCAGGCCAAGGATGC",0,4,0,0,4,8,57
"TGCAGGCCACAGTCAT",30,129,56,16,198,429,12918
"TGCAGGCCAGGACATG",0,0,0,0,0,0,84
"TGCAGGCGTGTATCCA",1,10,3,0,3,17,29
"TGCAGTAAGGTACCTT",1,0,0,0,0,1,30
"TGCAGTACAAGCGCAA",0,0,0,0,0,0,55
"TGCAGTACAGCACACC",2,13,3,0,3,21,621
"TGCAGTATCCACTAGA",0,0,0,0,0,0,44
"TGCAGTATCGTAGGAG",0,4,0,0,0,4,130
"TGCATCCAGATACGAT",77,250,851,43,122,1343,49339
"TGCATCCAGCAACTTC",0,0,0,0,0,0,4
"TGCATCCAGCGCTTCG",17,169,42,10,27,265,7628
"TGCATCCAGGAGACCT",1,5,0,0,0,6,231
"TGCATCCAGGGTATAT",1,12,21,2,7,43,1370
"TGCATCCCAAGGAGTC",0,0,0,0,0,0,4
"TGCATCCCACCTAAAC",1,4,0,0,2,7,98
"TGCATCCCATAATCCG",1,0,0,0,0,1,43
"TGCATCCCATCGATCA",257,75,35,11,33,411,13427
"TGCATCCGTCTAGATC",4,4,0,5,0,13,299
"TGCATCCTCTGATTCT",1,22,3,0,9,35,469
"TGCATGAAGTGCTACT",0,0,0,0,0,0,11
"TGCATGACAATAGTCC",2,19,8,0,3,32,442
"TGCATGACAGATCCAT",2,7,0,2,2,13,274
"TGCATGACATGGGTTT",5,35,14,3,21,78,2603
"TGCCGAGCAATAACGA",0,4,0,0,0,4,86
"TGCCGAGCATAACTCG",0,11,0,0,4,15,70
"TGCCGAGGTACGAGTG",0,6,0,0,0,6,259
"TGCCGAGTCTGGCCAG",0,2,0,0,0,2,103
"TGCGACGAGAATCTAG",6,29,28,3,40,106,3033
"TGCGACGAGACAACTA",0,2,0,0,0,2,98
"TGCGACGAGCCGAACA",0,0,0,0,0,0,21
"TGCGACGAGCGATGAC",2,7,2,0,3,14,260
"TGCGACGAGGTAGTCG",0,3,0,0,0,3,68
"TGCGACGCACGAGGTA",0,2,0,0,0,2,37
"TGCGACGTCTTGCAGA",5,20,31,2,3,61,1917
"TGCGATAAGATGTAGT",4,46,11,2,9,72,2432
"TGCGATAAGCCAGTAG",5,83,14,0,10,112,3115
"TGCGATAAGGTACATA",0,10,0,0,6,16,352
"TGCGATACAGGAATCG",0,6,0,0,0,6,118
"TGCGATATCCCGTGAG",0,5,0,0,0,5,69
"TGCGATATCTGTCTCG",1,16,5,0,6,28,703
"TGCGGCAAGATTGACA",2,6,3,0,2,13,363
"TGCGGCAAGGGCATGT",4,34,9,3,6,56,2060
"TGCGGCACAAGTTCCA",2,10,7,0,2,21,418
"TGCGGCACACTGAATC",0,0,0,0,0,0,48
"TGCGGCACAGATCATC",0,3,0,0,0,3,67
"TGCGGCACATTATGCG",5,19,6,0,3,33,111
"TGCGGCACATTCACAG",0,0,0,0,0,0,63
"TGCGGCAGTATGGTAA",0,4,0,0,0,4,128
"TGCGGCAGTTCAGCTA",3,10,2,0,3,18,309
"TGCGGCAGTTCAGGTT",2,17,3,0,0,22,354
"TGCGGGTAGCGATGCA",0,2,0,0,0,2,86
"TGCGGGTAGGTTCTTG",1,9,3,0,2,15,225
"TGCGGGTCAACCGACC",1,13,2,2,0,18,74
"TGCGGGTCAACCGTAT",23,89,14,3,20,149,4013
"TGCGGGTCAAGGACAC",26,84,46,11,293,460,17803
"TGCGGGTCACACGTGC",0,6,8,0,9,23,579
"TGCGGGTCACCTGCAG",5,21,43,2,8,79,2676
"TGCGGGTGTCAACCTA",1,10,3,0,2,16,278
"TGCGGGTGTCGGCCTA",3,11,11,0,3,28,629
"TGCGGGTGTCTTCGAA",3,9,4,0,3,19,449
"TGCGGGTTCAACTACG",1,0,0,0,0,1,120
"TGCGGGTTCGTAGTCA",1,12,3,0,2,18,56
"TGCTCCACAAGGGTCA",0,0,0,0,0,0,1
"TGCTCCACACAATTCG",0,2,0,0,0,2,30
"TGCTCCACACTTGGCG",0,3,0,0,0,3,93
"TGCTCCATCAAGAAAC",4,19,5,2,3,33,159
"TGCTCCATCGCTTACC",1,0,0,0,0,1,121
"TGCTCGTAGCGCATCC",0,13,5,0,3,21,349
"TGCTCGTAGCTAATGA",2,12,6,2,2,24,199
"TGCTCGTAGGCACGAT",0,3,0,0,0,3,184
"TGCTCGTAGTTCGCAT",0,2,0,0,0,2,70
"TGCTCGTCAACACACT",0,4,0,0,0,4,15
"TGCTCGTCAGTCTCTC",0,4,0,0,0,4,104
"TGCTCGTGTGAAAGTT",9,43,84,3,18,157,5341
"TGCTCGTGTGCCGTAC",0,0,0,0,0,0,14
"TGCTGAAAGGACATCG",0,6,0,0,0,6,90
"TGCTGAAAGGGCCCTT",100,48,18,4,19,189,6181
"TGCTGAACAGTTCACA",0,6,3,0,0,9,298
"TGCTGAAGTTGCACGC",0,0,0,0,0,0,62
"TGCTGAATCACAGTGT",0,5,3,0,4,12,186
"TGCTGAATCGATTCCC",13,121,27,6,103,270,10750
"TGCTGAATCTCTGACC",21,75,39,15,245,395,13767
"TGCTTCGAGACCGTTT",1,4,4,0,0,9,100
"TGCTTCGAGCCTCACG",1,16,2,0,4,23,177
"TGCTTCGCACTGCGAC",0,0,0,0,0,0,28
"TGCTTCGCAGCGATTT",3,21,5,0,5,34,707
"TGCTTCGGTATGGAGC",0,0,0,0,0,0,10
"TGCTTCGGTGACTAAA",0,4,3,0,0,7,95
"TGCTTCGTCACCGACG",2,16,4,0,4,26,512
"TGCTTCGTCCACTAGA",0,2,2,0,0,4,50
"TGCTTCGTCGACCCAG",0,2,0,0,0,2,29
"TGCTTGCCAATCAAGA",2,14,2,0,2,20,312
"TGCTTGCCACGAGGAT",3,16,0,0,2,21,476
"TGCTTGCCAGAGCGTA",1,0,0,0,0,1,29
"TGCTTGCCAGTCAACT",0,7,0,0,2,9,124
"TGCTTGCGTATCTTCT",0,4,3,0,0,7,447
"TGCTTGCGTATGCGTT",1,4,0,0,0,5,56
"TGCTTGCTCCGAAGGA",2,0,0,0,0,2,94
"TGCTTGCTCTAACACG",0,0,0,0,0,0,5
"TGCTTGCTCTTCTTCC",9,82,14,5,16,126,3872
"TGGAACTAGCTGACAG",0,0,0,0,0,0,13
"TGGAACTAGTAATTGG",6,61,13,2,15,97,2461
"TGGAACTCATGTCGTA",9,35,71,5,37,157,5612
"TGGAACTGTATTTCTC",0,0,0,0,0,0,2
"TGGAACTGTCTGTCAA",0,0,0,0,0,0,23
"TGGAACTGTTAACAGA",1,3,0,0,0,4,94
"TGGAACTTCAAAGACA",1,3,0,0,3,7,77
"TGGAACTTCAGTGTGT",0,6,2,0,4,12,49
"TGGAACTTCCATTTAC",0,5,0,0,3,8,80
"TGGAACTTCGTTACCC",3,5,4,0,2,14,176
"TGGAGAGAGATACATG",0,2,0,0,2,4,60
"TGGAGAGCACCGGTCA",1,4,0,0,0,5,266
"TGGAGAGCACCTTCGT",0,0,0,0,0,0,79
"TGGAGAGCAGAGTCTT",0,0,0,0,0,0,2
"TGGAGAGCATTCTCCG",0,0,0,0,0,0,2
"TGGAGAGGTCAGGAGT",0,2,0,0,0,2,116
"TGGAGAGGTCCTATAG",0,7,0,0,0,7,112
"TGGAGAGTCGACCCAG",2,6,3,2,0,13,41
"TGGAGAGTCGCAGTGC",15,222,33,11,27,308,8516
"TGGAGAGTCTACCACC",18,75,20,35,20,168,5180
"TGGAGAGTCTCGCTTG",0,8,0,0,0,8,352
"TGGAGGAAGTCATACC",188,167,50,11,48,464,13330
"TGGAGGAAGTGCAGGT",0,5,3,0,2,10,218
"TGGAGGACAAGACAAT",0,0,0,0,0,0,9
"TGGAGGAGTTTCGGCG",0,3,0,0,2,5,65
"TGGAGGATCAACTGGT",0,0,0,0,0,0,4
"TGGAGGATCGCATTGA",0,5,0,0,0,5,107
"TGGAGGATCGGACGTC",3,6,0,0,2,11,127
"TGGAGGATCGTAGGGA",2,4,7,0,2,15,236
"TGGATCAAGCACTCCG",0,5,3,0,2,10,175
"TGGATCACACGACCTG",2,2,3,0,2,9,140
"TGGATCACATAACAGA",2,6,4,0,3,15,269
"TGGATCAGTATTGCCA",4,25,20,0,6,55,1286
"TGGATCAGTTCAGCGC",1,7,2,0,0,10,157
"TGGATCATCAGGCGAA",1,11,2,0,5,19,343
"TGGATCATCCAAATGC",2,11,0,0,4,17,282
"TGGATGTAGCCATTGT",0,3,2,0,0,5,37
"TGGATGTCAGGATGAC",1,5,0,0,0,6,11
"TGGATGTCATGTGGTT",0,0,0,0,0,0,9
"TGGATGTCATTGGCAT",0,0,0,0,0,0,38
"TGGATGTGTATGCGGA",0,0,0,0,0,0,59
"TGGATGTGTCCTTGTC",0,2,0,0,2,4,230
"TGGATGTGTCGCATGC",5,40,9,0,8,62,2212
"TGGATGTTCCACTTCG",1,20,6,3,7,37,589
"TGGCGTGAGCTGACAG",29,82,12,2,13,138,4311
"TGGCGTGCAACTGTGT",24,236,45,6,40,351,12440
"TGGCGTGGTCATCCCT",0,0,0,0,2,2,36
"TGGCGTGGTCGCACGT",1,5,0,0,0,6,63
"TGGCGTGGTCGTACTA",0,13,6,0,0,19,511
"TGGCGTGGTGTCTTCC",1,2,0,0,0,3,53
"TGGCGTGGTTCTCCTG",98,63,21,9,14,205,5471
"TGGGAAGCAACTGCCG",1,4,0,0,0,5,76
"TGGGAAGCAATCTGCA",0,0,0,0,0,0,100
"TGGGAAGCAGGGTTGA",1,0,0,0,2,3,23
"TGGGAAGCAGTTTCGA",1,4,0,0,0,5,161
"TGGGAAGGTAGGTAGC",1,11,2,0,0,14,334
"TGGGAAGTCCATAGAC",1,18,7,0,6,32,1194
"TGGGAAGTCGCCTCTA",0,0,0,0,0,0,26
"TGGGAGAAGATCACCT",1,9,2,0,4,16,184
"TGGGAGAAGGAATCGC",0,7,0,0,0,7,57
"TGGGAGAAGTTTGGCT",0,3,3,0,0,6,86
"TGGGAGACAGAGCGTA",37,292,93,11,120,553,19237
"TGGGAGAGTCAAGTTC",2,10,6,0,3,21,376
"TGGGAGAGTGCGGATA",0,3,3,0,0,6,65
"TGGGAGATCACCACAA",0,3,0,0,0,3,20
"TGGGATTGTCAACATC",0,3,0,0,0,3,84
"TGGGATTTCCCGAGGT",0,11,3,0,3,17,344
"TGGGATTTCGATGCTA",0,5,3,0,0,8,105
"TGGGATTTCGTTCCTG",1,6,4,0,17,28,1101
"TGGGATTTCTACCAGA",5,28,16,0,7,56,779
"TGGGATTTCTCTAGGA",0,2,0,0,0,2,29
"TGGGATTTCTGAATGC",12,30,50,0,9,101,3514
"TGGGATTTCTTCGGAA",3,12,3,0,4,22,360
"TGGGCGTCAATACGCT",0,0,0,0,0,0,5
"TGGGCGTCAATCGCAT",12,41,18,4,105,180,5092
"TGGGCGTCAATGGGTG",7,23,59,0,7,96,3526
"TGGGCGTCACTTCAGA",7,29,36,4,10,86,1676
"TGGGCGTGTACTTGTG",0,4,3,0,3,10,253
"TGGGCGTGTGAGATCG",2,69,10,3,10,94,3300
"TGGGCGTGTTTCGTAG",1,0,2,0,2,5,71
"TGGGCGTTCTACACAG",0,0,0,0,2,2,96
"TGGGCTGCAAGGACAC",0,2,0,0,0,2,100
"TGGGCTGCATGGATCT",37,21,9,0,7,74,2056
"TGGGCTGTCACGACTA",1,6,3,0,2,12,95
"TGGGCTGTCCACGTCT",0,0,0,0,0,0,36
"TGGGCTGTCTCGGTAA",0,7,2,0,2,11,303
"TGGGTTAAGCTTCATG",0,3,0,0,0,3,62
"TGGGTTAAGGACGGAG",0,0,0,0,0,0,9
"TGGGTTAAGTCAGCCC",21,44,17,5,142,229,7640
"TGGGTTACAAGTATCC",0,3,0,0,2,5,16
"TGGGTTACAGCCCACA",0,0,0,0,0,0,8
"TGGGTTAGTTGGTAGG",2,2,0,0,0,4,87
"TGGGTTATCCCGTTCA",0,4,2,0,0,6,62
"TGGGTTATCGCAATTG",1,13,4,0,5,23,569
"TGGGTTATCTGGGATT",8,25,36,3,12,84,2090
"TGGTACAAGCTTAGTC",0,0,0,0,0,0,32
"TGGTACACAATCTCTT",0,6,0,0,0,6,39
"TGGTACACACGCTGAC",0,3,0,0,0,3,46
"TGGTACACAGGATCTT",0,0,0,0,0,0,9
"TGGTACATCAACCTCC",6,26,44,0,15,91,2972
"TGGTACATCCAATCCC",2,13,14,0,6,35,827
"TGGTACATCCATAAGC",13,118,23,3,28,185,6856
"TGGTACATCCGTGCGA",0,3,0,0,0,3,113
"TGGTACATCGGACGTC",1,15,2,0,3,21,549
"TGGTACATCTACACAG",6,33,19,0,42,100,2942
"TGGTAGTAGGACATCG",32,225,52,10,49,368,13511
"TGGTAGTAGTCCTACA",1,5,3,0,0,9,110
"TGGTAGTAGTTCATCG",6,9,6,0,4,25,485
"TGGTAGTCAAGACGGT",6,27,39,2,12,86,2469
"TGGTAGTCAAGGAGTC",0,7,3,0,2,12,140
"TGGTAGTCAATAACGA",0,0,0,0,0,0,18
"TGGTAGTCACACGTGC",1,2,0,0,0,3,59
"TGGTAGTCAGCGCGTT",1,8,2,0,0,11,61
"TGGTAGTCATAGGCGA",41,151,377,26,84,679,27652
"TGGTAGTCATCTTTCA",0,5,0,0,0,5,82
"TGGTAGTGTTACGTAC",3,20,39,3,9,74,2958
"TGGTAGTTCTCAACGA",1,10,2,0,0,13,31
"TGGTGATAGCTGCGAA",3,12,2,0,5,22,346
"TGGTGATAGGCCTAGA",1,5,0,0,0,6,80
"TGGTGATCACTGCGTG",0,3,0,0,0,3,36
"TGGTGATGTTGTTGTG",2,65,13,5,12,97,2433
"TGGTGATTCGGCTGAC",0,0,0,0,2,2,107
"TGGTGATTCTCCGAGG",1,0,0,0,2,3,50
"TGGTGATTCTGGAAGG",0,6,0,0,2,8,152
"TGGTTAGAGCCTAACT",8,48,17,5,43,121,2930
"TGGTTAGCAAGTGACG",0,0,0,0,0,0,2
"TGGTTAGGTACATACC",1,9,0,0,3,13,73
"TGGTTAGGTACTGTTG",3,18,4,4,5,34,371
"TGGTTAGGTTTCGCTC",2,9,3,0,2,16,522
"TGGTTAGTCGGACTTA",0,0,0,0,0,0,25
"TGGTTAGTCTTCTGGC",2,2,0,0,0,4,52
"TGTAACGAGCCTCAAT",0,0,0,0,2,2,56
"TGTAACGAGCGTTCCG",30,296,64,12,43,445,11968
"TGTAACGAGGATGAGA",29,115,245,16,142,547,21018
"TGTAACGCATACCATG",1,4,2,0,0,7,248
"TGTAACGGTCTGTCAA",0,0,0,0,0,0,44
"TGTAACGGTGTCACAT",0,0,0,0,0,0,5
"TGTAACGGTTGCACGC",4,24,9,3,48,88,3671
"TGTAACGTCAAGATAG",0,4,0,0,0,4,128
"TGTAACGTCAAGGTGG",1,4,0,0,0,5,42
"TGTAACGTCACTGAAC",11,75,32,9,148,275,9526
"TGTAACGTCGAACACT",0,0,0,0,2,2,137
"TGTAAGCAGGACAGCT",9,19,60,2,12,102,4235
"TGTAAGCAGTTGCTGT",14,147,28,5,26,220,6891
"TGTAAGCGTAGGCAGT",5,37,7,0,6,55,2296
"TGTAAGCGTGACCGTC",2,8,0,0,4,14,61
"TGTAAGCTCCTTGGAA",0,6,3,0,2,11,140
"TGTAAGCTCTTGTGCC",1,4,0,0,2,7,39
"TGTACAGAGAGTATAC",144,53,29,10,22,258,8329
"TGTACAGAGGGATGTC",0,0,0,0,0,0,0
"TGTACAGCATCGTGCG",0,0,0,0,0,0,2
"TGTACAGCATGTTACG",5,19,8,0,5,37,492
"TGTACAGTCAGACATC",0,6,4,0,2,12,30
"TGTAGACAGAAGAGCA",1,4,0,0,0,5,51
"TGTAGACAGATACCAA",0,0,0,0,0,0,10
"TGTAGACCAGTCGCAC",1,0,0,0,0,1,75
"TGTAGACTCAAGTTGC",3,17,29,4,4,57,2124
"TGTAGACTCCACACCT",4,10,23,0,3,40,1718
"TGTAGACTCGGTTAGT",0,2,0,0,0,2,38
"TGTAGACTCTATTGTC",0,6,3,0,0,9,65
"TGTCAGAAGAATTCAG",0,0,0,0,0,0,1
"TGTCAGAAGTAGGATT",2,3,0,0,3,8,235
"TGTCAGATCCACCTCA",0,5,0,0,0,5,71
"TGTCCACCAGCAGTGA",1,2,0,0,0,3,42
"TGTCCACCATCGCCTT",0,0,0,0,0,0,22
"TGTCCACCATGCCATA",7,87,18,8,14,134,4240
"TGTCCACGTACTTCCC",0,6,0,0,0,6,273
"TGTCCACGTATGGTTC",0,0,2,0,2,4,79
"TGTCCACTCCATCCGT",7,28,70,3,14,122,3493
"TGTCCCAAGTCATGCT",2,22,6,3,3,36,1235
"TGTCCCAAGTCGTTAC",5,47,17,4,122,195,5301
"TGTCCCAAGTGCCAGA",3,22,15,2,47,89,2365
"TGTCCCACACCACATA",0,0,0,0,0,0,26
"TGTCCCACACCTGTCT",0,4,0,0,0,4,199
"TGTCCCATCAGTGCGC",2,15,2,0,0,19,281
"TGTCCCATCATTACCT",1,2,2,0,0,5,59
"TGTCCCATCGAAGCAG",0,2,0,0,0,2,19
"TGTCCCATCTTCCTAA",1,3,2,0,0,6,124
"TGTCCTGAGAATCCCT",0,6,0,0,0,6,78
"TGTCCTGAGCACCCAC",0,2,0,0,0,2,72
"TGTCCTGAGGACAGTC",1,8,0,0,0,9,83
"TGTCCTGAGGTTATAG",0,5,3,0,0,8,103
"TGTCCTGGTGATACAA",0,15,2,2,0,19,282
"TGTCCTGGTGGGCTTC",1,3,0,0,0,4,113
"TGTCCTGTCACAGAGG",0,7,0,0,3,10,298
"TGTCCTGTCGTGACTA",0,19,5,0,6,30,444
"TGTCCTGTCTCCGAGG",1,8,0,0,0,9,79
"TGTGAGTAGGTGCATG",1,3,0,0,0,4,58
"TGTGAGTCACTGCGTG",0,4,0,0,0,4,158
"TGTGAGTGTAGATTAG",2,4,0,0,0,6,88
"TGTGAGTGTGACCGAA",0,13,0,0,7,20,331
"TGTGAGTTCAAAGGAT",12,52,92,6,23,185,6776
"TGTGAGTTCCATACTT",76,196,60,151,58,541,16390
"TGTGAGTTCGATACTG",3,16,10,0,43,72,3224
"TGTGATGAGCCAAGGT",3,26,32,5,10,76,2941
"TGTGATGAGGAGCTGT",1,9,2,0,0,12,233
"TGTGATGCAGTAGTTC",1,3,2,0,3,9,67
"TGTGATGCATAAGATG",1,0,0,0,2,3,45
"TGTGATGGTCTCAAGT",0,11,5,0,2,18,52
"TGTGATGTCAAAGGTA",1,3,0,0,0,4,83
"TGTGATGTCGATGCAT",0,2,9,0,0,11,473
"TGTGATGTCTCGACGG",27,77,13,3,22,142,5297
"TGTGCGGAGCAGCCCT",2,2,2,0,0,6,135
"TGTGCGGAGCGTCAAG",0,7,0,0,2,9,108
"TGTGCGGAGCTTCATG",15,109,68,49,26,267,7598
"TGTGCGGCAAACTAGA",0,0,0,0,0,0,34
"TGTGCGGCACCGCTAG",1,5,0,0,0,6,80
"TGTGCGGCAGCATACT",1,2,0,0,0,3,91
"TGTGCGGCAGTATACC",1,5,0,0,2,8,146
"TGTGCGGCATGACGTT",0,0,0,0,0,0,16
"TGTGCGGGTGATAGAT",1,8,2,0,4,15,215
"TGTGCGGTCACGATCA",1,17,5,0,4,27,500
"TGTGCGGTCGACGTCG",23,266,34,10,24,357,5963
"TGTGCGGTCGGCACTG",225,563,128,25,89,1030,30790
"TGTGGCGAGACTAGAT",1,14,2,0,3,20,336
"TGTGGCGAGCGTACAG",4,2,0,0,0,6,122
"TGTGGCGAGCTAGAAT",92,877,169,41,150,1329,47836
"TGTGGCGAGTACGTCT",3,51,14,3,17,88,2408
"TGTGGCGAGTGAATAC",0,4,0,0,0,4,104
"TGTGGCGAGTGGTGAC",0,10,2,0,0,12,81
"TGTGGCGCACCCTAAA",43,140,451,25,67,726,25112
"TGTGGCGGTCCGATCG",2,6,2,0,0,10,79
"TGTGGCGGTTAAGTCC",18,47,28,8,151,252,8683
"TGTGGCGTCGCCGAAC",11,24,11,14,8,68,1126
"TGTGGCGTCGGCTGTG",0,0,0,0,0,0,27
"TGTGGCGTCTGAGCAT",2,9,3,0,0,14,249
"TGTGGCGTCTGTCGTC",1,2,0,0,0,3,62
"TGTGGCGTCTTCGTAT",0,3,0,0,0,3,45
"TGTGTGAAGAGGCGTT",99,446,80,22,69,716,15000
"TGTGTGAAGCTAATCC",2,0,0,0,0,2,76
"TGTGTGAAGGAATTAC",4,20,7,0,5,36,303
"TGTGTGAAGGCTGTAG",76,543,141,16,104,880,29661
"TGTGTGAAGTGCTACT",0,4,3,0,0,7,123
"TGTGTGAAGTTTCTTC",0,4,0,0,0,4,20
"TGTGTGACACTCAAGT",0,5,2,0,0,7,306
"TGTGTGACAGAATTCC",1,8,2,0,0,11,123
"TGTGTGACATACACCA",0,4,0,0,0,4,68
"TGTGTGACATCATTTC",1,8,6,0,16,31,1360
"TGTGTGAGTACCTGTA",44,404,210,50,312,1020,34547
"TGTGTGAGTCCAGGTC",17,84,278,8,45,432,17322
"TGTGTGAGTCGACGCT",1,8,2,0,0,11,382
"TGTGTGAGTCGCAGTC",0,2,0,0,0,2,87
"TGTGTGATCTAAGCGT",1,5,0,0,3,9,179
"TGTGTGATCTACCCAC",1,0,0,0,0,1,12
"TGTGTGATCTAGACAC",115,106,58,195,48,522,15238
"TGTTACTAGACTTCGT",0,12,4,0,2,18,243
"TGTTACTAGTGCAGCA",3,23,6,2,5,39,797
"TGTTACTCAAAGGCTG",1,0,0,0,0,1,27
"TGTTACTCAATGCAGG",75,233,421,30,365,1124,42861
"TGTTACTCACTACCGG",0,5,0,0,0,5,7
"TGTTACTTCAGCATTG",1,2,3,0,0,6,81
"TGTTACTTCTACTGCC",2,12,9,0,17,40,997
"TGTTCATAGAAATTCG",1,14,9,0,6,30,54
"TGTTCATAGATGAACT",0,0,0,0,0,0,11
"TGTTCATAGCTGCCTG",1,2,0,0,0,3,43
"TGTTCATAGTTACGAA",1,3,2,0,3,9,113
"TGTTCATCAACGACTT",0,7,12,0,3,22,667
"TGTTCATCAGAGTTGG",20,70,88,8,117,303,11602
"TGTTCATGTTTGGCTA",2,7,0,0,3,12,300
"TGTTCATTCGAGCCAC",4,9,3,0,2,18,394
"TGTTCATTCGGATACT",0,3,0,0,0,3,6
"TGTTCCGAGCGAGTAC",0,4,0,0,0,4,51
"TGTTCCGCATTGACTG",0,6,0,0,0,6,32
"TGTTCCGTCCATTGCC",1,17,2,0,5,25,717
"TGTTCCGTCCCAAGCG",1,9,3,0,0,13,213
"TGTTCTAAGAAGGGAT",0,0,0,0,0,0,38
"TGTTCTAAGCATGATA",47,148,412,14,88,709,28879
"TGTTCTAAGGGCAATC",0,0,0,0,0,0,25
"TGTTCTACATTGTAGC",0,8,3,0,0,11,461
"TGTTCTAGTTACGGAG",0,4,3,0,0,7,67
"TGTTCTAGTTTGTGGT",0,2,0,0,0,2,46
"TGTTCTATCTCCGAGG",0,3,0,0,0,3,110
"TGTTCTATCTCGACCT",0,2,0,0,3,5,158
"TGTTGAGAGATGCTTC",3,13,3,0,2,21,329
"TGTTGAGCAAGCTGCC",1,3,0,0,0,4,120
"TGTTGAGCATGACTCA",0,2,0,0,0,2,135
"TGTTGAGCATTGGGAG",2,14,3,0,3,22,382
"TGTTGAGGTTCAAAGA",0,0,0,0,0,0,31
"TGTTGAGGTTGGCCTG",0,7,0,0,3,10,280
"TGTTGGAAGACCTGGA",21,280,60,16,41,418,13644
"TGTTGGACAACACAGG",0,10,0,0,0,10,179
"TGTTGGACAACTTCTT",0,16,2,0,4,22,546
"TGTTGGACAAGGCTTT",0,0,0,0,0,0,19
"TGTTGGACACTTGAAC",1,16,5,2,8,32,777
"TGTTGGAGTAGAGGAA",0,5,0,0,3,8,157
"TGTTGGAGTATGTCCA",8,37,11,2,67,125,4581
"TGTTGGAGTTATAGAG",33,422,98,15,66,634,26315
"TGTTGGAGTTTCACAG",0,0,2,0,0,2,46
"TGTTGGATCGTCGATA",1,10,4,0,5,20,309
"TGTTGGATCTTTCAGT",10,34,71,4,26,145,5608
"TGTTTGTAGGGTCTTT",40,297,74,26,71,508,19615
"TGTTTGTAGGTAGCCA",8,37,45,5,14,109,3517
"TGTTTGTCAAATGCGG",1,7,0,0,0,8,136
"TGTTTGTCAGAGACTG",0,2,0,0,0,2,9
"TGTTTGTCAGCGGATA",1,6,0,0,0,7,144
"TGTTTGTTCACTCGAA",0,3,2,0,0,5,120
"TTAATCCAGACAGCGT",1,0,0,0,0,1,81
"TTAATCCCAATGGGTG",2,21,9,0,3,35,841
"TTAATCCCAATTAGGA",2,17,7,0,7,33,381
"TTAATCCCAGAGGTAC",1,6,0,0,0,7,71
"TTAATCCCATCGGAAG",2,6,0,0,3,11,161
"TTAATCCCATGTGGTT",1,3,0,0,0,4,80
"TTAATCCGTGACAGCA",1,8,2,0,3,14,269
"TTAATCCTCAGCCTTC",0,5,0,0,0,5,86
"TTAATCCTCCATTTGT",0,4,4,0,0,8,260
"TTAATCCTCCGATGCG",8,28,8,4,3,51,1450
"TTAATCCTCGCGCTGA",0,5,0,0,0,5,100
"TTAATCCTCTCCTGCA",50,438,118,28,93,727,20718
"TTAATCCTCTTGGATG",0,3,2,0,0,5,73
"TTACAGGAGAAGAGCA",0,10,2,0,3,15,49
"TTACAGGAGGACAGCT",1,9,3,0,6,19,370
"TTACAGGCAACCCTCT",32,266,50,9,44,401,14473
"TTACAGGCAGGGAATC",7,31,19,0,46,103,2990
"TTACAGGGTATCGATC",0,10,0,0,0,10,73
"TTACAGGGTCCGATCG",2,5,2,0,6,15,300
"TTACCATAGACCACGA",0,0,2,0,0,2,117
"TTACCATAGGAATTAC",21,249,44,11,40,365,13375
"TTACCATAGTACTCGT",3,18,8,0,4,33,648
"TTACCATAGTCTCGTA",8,36,11,2,47,104,4450
"TTACCATCATGTGACT",2,22,8,4,7,43,454
"TTACCATGTATAGGAT",0,0,2,0,0,2,14
"TTACCATTCAAGGAGC",18,46,68,2,84,218,7651
"TTACCATTCAGCATTG",7,87,25,3,17,139,3742
"TTACCATTCGCGTGAC",0,0,0,0,0,0,6
"TTACCGCAGCAGCAGT",0,10,2,2,2,16,509
"TTACCGCAGGCATCAG",1,3,0,0,0,4,143
"TTACCGCCAATCGCAT",0,0,2,2,0,4,71
"TTACCGCCAATCTGCA",1,6,0,0,0,7,152
"TTACCGCCACGCTATA",4,13,4,2,4,27,625
"TTACCGCCACGGTAGA",6,59,8,3,6,82,1541
"TTACCGCCAGCATTGT",0,10,3,0,4,17,447
"TTACCGCCAGCTTCCT",3,68,15,3,11,100,3420
"TTACCGCCATAGAATG",0,2,0,0,0,2,23
"TTACCGCCATGTACGT",1,3,0,0,0,4,28
"TTACCGCGTCCACGCA",0,3,0,0,0,3,62
"TTACCGCGTGAGGAAA",1,5,3,0,2,11,63
"TTACCGCTCCAGTTCC",1,5,0,0,0,6,311
"TTACGCCAGACTGGGT",0,0,0,0,0,0,49
"TTACGCCAGCACTCTA",2,0,0,0,0,2,150
"TTACGCCAGCCTCAGC",0,4,2,0,0,6,46
"TTACGCCAGGATGGCT",0,3,0,0,2,5,97
"TTACGCCCAAACCGGA",0,6,2,0,0,8,134
"TTACGCCCAGTTTGGT",63,633,111,25,111,943,36133
"TTACGCCGTCAAAGCG",14,70,78,4,156,322,13636
"TTACGCCTCCCGATCT",294,1675,385,154,318,2826,95223
"TTACGCCTCGAAGTGG",9,98,21,4,16,148,4746
"TTACGCCTCGCCAGTG",5,20,10,0,46,81,2188
"TTACGCCTCGCGCCAA",0,7,5,0,2,14,546
"TTACGTTGTTGCTCAA",2,15,11,0,3,31,267
"TTACGTTGTTGTGCCG",0,0,0,0,0,0,10
"TTACGTTTCTTAATCC",2,26,5,0,8,41,650
"TTACTGTCAATACAGA",0,4,0,0,0,4,151
"TTACTGTCACGCACCA",0,0,0,0,0,0,11
"TTACTGTGTACATACC",0,4,3,0,2,9,179
"TTACTGTGTCATTCCC",2,11,9,0,0,22,519
"TTACTGTGTCCCTGAG",0,4,0,0,0,4,93
"TTACTGTTCCCAACTC",0,5,0,0,0,5,73
"TTACTGTTCTGCTTAT",0,2,4,0,0,6,192
"TTAGGCAAGGATACGC",1,10,3,0,3,17,356
"TTAGGCAAGGTTACCT",3,83,14,0,16,116,4205
"TTAGGCAAGTATTGCC",0,0,0,0,0,0,72
"TTAGGCACAACGTATC",3,25,49,2,8,87,3441
"TTAGGCACACGCCAGT",0,2,0,0,0,2,76
"TTAGGCACACGTCTCT",0,5,0,0,0,5,147
"TTAGGCAGTATCACCA",1,2,3,0,0,6,240
"TTAGGCAGTTAGGCTT",4,11,5,2,5,27,820
"TTAGGCATCCTACCGT",0,4,0,0,0,4,50
"TTAGGCATCTCTCTTC",0,4,0,0,0,4,53
"TTAGGCATCTTGGTCC",4,29,9,0,9,51,2568
"TTAGGGTAGCAAATGT",1,0,0,0,0,1,5
"TTAGGGTAGCGTGCTC",0,4,0,0,0,4,55
"TTAGGGTAGGTCACCC",0,3,0,0,0,3,221
"TTAGGGTAGTAAGGGA",104,833,232,44,167,1380,55330
"TTAGGGTCACCAACAT",246,96,40,4,39,425,14087
"TTAGGGTGTCGTCAGC",0,4,2,0,0,6,144
"TTAGGGTGTCTTGCGG",0,0,0,0,0,0,67
"TTAGGGTGTGGGTATG",1,2,0,0,0,3,67
"TTAGGGTGTGTTGAGG",2,7,3,0,5,17,218
"TTAGGGTGTTGGAGAC",2,5,0,0,0,7,92
"TTAGGGTTCATGTCAG",5,24,37,2,36,104,5039
"TTAGGGTTCCTTCAGC",1,2,0,0,0,3,87
"TTAGGGTTCTCGAACA",3,9,5,0,3,20,659
"TTAGTCTAGCGAACTG",46,407,95,21,75,644,18528
"TTAGTCTCAGCTGCCA",0,0,0,0,0,0,4
"TTAGTCTCATGGAATA",10,26,9,2,57,104,3655
"TTAGTCTGTTCTTAGG",2,11,5,0,0,18,184
"TTAGTCTTCATTGAGC",0,0,0,0,0,0,27
"TTATTGCAGTCGGCAA",0,3,3,0,0,6,52
"TTATTGCCAATGGCCC",1,3,2,0,2,8,120
"TTATTGCCAGAGTAAT",2,14,6,2,3,27,450
"TTATTGCTCGCCTAGG",1,6,2,0,3,12,357
"TTCAATCAGAGTGAAG",3,21,28,0,4,56,1282
"TTCAATCAGATCCCGC",3,22,2,0,2,29,731
"TTCAATCCACAACGTT",15,67,98,7,101,288,10828
"TTCAATCCAGCAGATG",1,4,0,0,0,5,75
"TTCAATCCAGCAGTTT",1,0,0,0,0,1,1
"TTCAATCCAGTCAACT",2,3,0,0,0,5,349
"TTCAATCGTACTCGAT",10,71,14,3,22,120,4220
"TTCAATCGTCGGAACA",1,12,27,3,7,50,1313
"TTCAATCGTCGTGGTC",0,0,0,0,0,0,10
"TTCAATCGTGATTGGG",1,0,0,0,0,1,14
"TTCAATCGTTAATCGC",4,5,0,0,2,11,202
"TTCAATCGTTCTAACG",0,0,0,0,0,0,24
"TTCACCGCAGCGTATT",1,0,0,0,2,3,82
"TTCACCGCATAAGCGG",0,0,0,0,0,0,2
"TTCACCGCATACATCG",3,9,7,0,6,25,243
"TTCACCGGTCGTGATT",0,13,0,0,4,17,176
"TTCACCGTCCGATGTA",0,3,0,0,0,3,76
"TTCACCGTCTAGCCTC",12,74,17,0,18,121,3373
"TTCACGCAGGTTCACT",0,0,0,0,0,0,81
"TTCACGCCAAGGCCTC",0,12,3,0,4,19,34
"TTCACGCCAATGCAGG",0,0,0,0,0,0,26
"TTCACGCCACCCTAAA",2,9,4,0,7,22,735
"TTCACGCCAGGCTTGC",1,17,3,4,2,27,667
"TTCACGCCATCAGCAT",0,3,0,0,0,3,370
"TTCACGCCATCTGTTT",0,2,0,0,0,2,15
"TTCACGCGTCACTTCC",0,10,2,0,5,17,331
"TTCACGCGTTCCTAAG",1,0,0,0,0,1,11
"TTCACGCTCAAGTGTC",0,0,0,0,0,0,39
"TTCACGCTCATCGCCT",2,5,0,0,2,9,112
"TTCACGCTCGCTCATC",0,3,0,0,0,3,20
"TTCAGGAAGATCACTC",0,2,0,0,0,2,56
"TTCAGGACACAGAAGC",0,2,0,0,0,2,99
"TTCAGGACACCTCTAC",3,36,8,0,8,55,1722
"TTCAGGAGTACGCTAT",1,5,2,0,3,11,81
"TTCAGGAGTATAGCTC",0,2,0,0,0,2,56
"TTCAGGAGTGCGAGTA",5,30,8,0,28,71,1766
"TTCAGGATCATCGACA",0,3,0,0,0,3,54
"TTCAGGATCCATCTCG",0,5,2,0,0,7,146
"TTCAGGATCGCAAGAG",1,3,0,0,0,4,17
"TTCATGTAGAGGCTGT",0,0,0,2,0,2,59
"TTCATGTCAGGAATAT",0,2,0,0,0,2,6
"TTCATGTCAGGTTCGC",2,35,24,2,4,67,2034
"TTCATGTGTCTCGGAC",0,0,0,0,0,0,14
"TTCATGTGTGCATGAG",5,19,34,5,6,69,1804
"TTCATGTGTGCCTATA",0,4,0,0,0,4,158
"TTCATGTTCATATGGC",0,3,2,0,0,5,102
"TTCATTGAGAAGTCCG",0,14,2,0,3,19,323
"TTCATTGAGACCCTTA",9,100,23,3,17,152,4116
"TTCATTGCAACACGAG",1,2,0,0,0,3,80
"TTCATTGCAACTACGT",25,66,42,8,204,345,12671
"TTCATTGCACTAGAGG",1,3,0,0,0,4,101
"TTCATTGCATATCTGG",3,14,10,0,3,30,390
"TTCATTGCATGGTGGA",2,6,11,0,6,25,1395
"TTCATTGGTGAGACGT",0,3,0,0,0,3,83
"TTCATTGTCGCGTAGC",1,0,0,0,0,1,3
"TTCCAATAGCAGTCTT",2,3,0,0,5,10,313
"TTCCAATAGTAGAATC",2,16,2,0,0,20,344
"TTCCAATAGTCAATCC",40,123,42,6,37,248,8704
"TTCCAATCAAGGTCAG",2,9,3,0,0,14,273
"TTCCAATGTCCTGTTC",1,0,0,0,4,5,118
"TTCCAATGTGCCCAGT",0,3,3,0,0,6,122
"TTCCAATGTGCGAACA",0,4,0,0,0,4,114
"TTCCAATTCAGGACAG",0,2,0,0,0,2,87
"TTCCACGAGAAACTAC",4,23,3,0,5,35,473
"TTCCACGAGGCGTTAG",0,0,0,0,0,0,5
"TTCCACGCAAGTGGTG",0,16,4,0,0,20,317
"TTCCACGCAATCTAGC",55,266,83,14,53,471,18205
"TTCCACGCAGACCTGC",18,172,38,3,21,252,10315
"TTCCACGCAGCACAGA",10,35,109,2,13,169,5672
"TTCCACGCAGCTTCCT",5,13,4,0,13,35,1274
"TTCCACGCATACAGCT",26,17,5,0,10,58,1449
"TTCCACGGTACATTGC",1,14,2,0,0,17,535
"TTCCACGGTGGAAATT",0,0,0,0,0,0,2
"TTCCACGGTTTGTTCT",2,13,4,0,2,21,426
"TTCCACGTCCTCAGAA",0,0,0,0,0,0,36
"TTCCACGTCGTAATGC",0,0,0,0,0,0,21
"TTCCACGTCGTTCTGC",0,0,0,0,2,2,73
"TTCCACGTCTCTGAGA",0,7,3,0,3,13,323
"TTCCGGTAGCACTCCG",78,686,116,33,112,1025,38363
"TTCCGGTAGCTCCACG",0,0,0,0,0,0,4
"TTCCGGTCAAATCGGG",56,58,20,3,18,155,4796
"TTCCGGTCAACCGTGC",0,0,0,0,0,0,0
"TTCCGGTCAAGTTCCA",5,17,20,0,6,48,1262
"TTCCGGTCATACAGCT",0,2,0,0,0,2,97
"TTCCGGTCATCAGCTA",0,2,0,0,0,2,59
"TTCCGGTGTAACATGA",0,3,0,0,0,3,121
"TTCCGGTGTATTTCTC",0,5,0,0,0,5,101
"TTCCGGTGTGGGCTCT",102,55,31,7,23,218,6432
"TTCCGGTGTGTTGAGG",5,16,28,0,4,53,2588
"TTCCGGTGTTGCTAGT",23,89,135,10,129,386,15666
"TTCCGGTGTTTGCAGT",0,2,0,0,0,2,86
"TTCCGTGAGCTGTACT",130,1180,232,59,205,1806,58392
"TTCCGTGTCCGGGACT",0,4,0,0,0,4,27
"TTCCGTGTCTCCGAAA",1,2,0,0,2,5,94
"TTCCGTGTCTTGGTGA",0,4,3,0,2,9,135
"TTCCTAACAGACTGCC",4,4,3,0,0,11,388
"TTCCTAATCGGTCGGT",0,9,2,0,0,11,244
"TTCCTCTAGAGCAGAA",1,2,0,0,0,3,67
"TTCCTCTAGCTTAAGA",3,10,0,0,3,16,26
"TTCCTCTCAGTCAGAG",10,43,5,2,9,69,2116
"TTCCTCTGTAAGAACT",1,5,4,2,3,15,189
"TTCCTCTGTAAGATTG",0,5,0,0,2,7,71
"TTCCTCTGTAGAGACC",0,4,0,0,0,4,109
"TTCCTCTGTGTTGCCG",0,3,0,0,6,9,366
"TTCCTCTGTTCGTACA",0,0,0,0,0,0,35
"TTCCTCTTCCGTGGGT",0,0,0,0,0,0,49
"TTCCTCTTCGCGTAGC",0,7,3,0,0,10,418
"TTCCTTCAGGCAGCTA",0,6,3,0,0,9,470
"TTCCTTCAGTGACCTT",1,0,0,0,0,1,59
"TTCCTTCAGTTCGCAT",2,13,15,0,16,46,1466
"TTCCTTCCAACACGTT",0,3,0,0,0,3,69
"TTCCTTCCAAGTGATA",0,6,0,2,0,8,70
"TTCCTTCCAGTAGAGC",1,10,0,0,3,14,220
"TTCCTTCCATCCGATA",1,4,0,0,0,5,210
"TTCCTTCGTCAAATCC",0,0,0,0,0,0,197
"TTCCTTCTCGGTCACG",5,36,9,2,12,64,1676
"TTCCTTCTCTAGTCAG",0,5,0,0,0,5,152
"TTCCTTCTCTATACTC",1,20,5,0,8,34,1030
"TTCCTTCTCTCCCAAC",1,2,0,0,2,5,81
"TTCCTTCTCTTCTTCC",0,2,0,0,2,4,12
"TTCGATTCAAATGGTA",0,0,0,0,0,0,107
"TTCGATTCACGCTGAC",178,915,362,82,1279,2816,93763
"TTCGATTCACTCCTGT",37,142,52,12,213,456,17011
"TTCGATTCATGTGGCC",1,3,0,0,0,4,76
"TTCGATTCATGTTCGA",0,4,0,0,3,7,105
"TTCGATTGTGCCTATA",0,0,0,0,0,0,73
"TTCGATTGTTCTATCT",2,4,0,0,2,8,89
"TTCGATTTCAAAGACA",12,57,12,0,12,93,3109
"TTCGATTTCACCATAG",1,3,0,0,0,4,19
"TTCGATTTCACGAGGA",1,14,17,0,7,39,1106
"TTCGCTGAGTTGGAAT",0,3,0,0,0,3,33
"TTCGCTGCAAATAAGC",5,50,5,2,8,70,2641
"TTCGCTGCACCCAACG",8,84,7,4,11,114,4677
"TTCGCTGCATAGAATG",0,0,0,0,0,0,6
"TTCGCTGGTAGGTAGC",2,8,4,0,3,17,513
"TTCGCTGGTCTACAGT",1,0,0,0,0,1,148
"TTCGGTCAGCAAATGT",10,36,73,7,15,141,5303
"TTCGGTCCAAGTATAG",0,6,0,0,0,6,245
"TTCGGTCCACAAAGCG",3,26,8,0,4,41,1034
"TTCGGTCCACTGAGTT",9,31,23,2,94,159,5142
"TTCGGTCCATAGATGA",63,423,125,15,86,712,26125
"TTCGGTCCATCCGAAT",2,2,0,0,3,7,130
"TTCGGTCGTCCACTTC",0,0,0,0,0,0,7
"TTCGGTCGTGCGTCGT",0,0,0,0,0,0,1
"TTCGGTCGTTAGGGAC",11,12,7,0,6,36,314
"TTCTAACCACGGTGTC",4,66,10,4,16,100,3099
"TTCTAACCATCGGATT",11,67,11,0,11,100,3955
"TTCTAACGTAGACGGT",0,2,0,0,0,2,54
"TTCTAACGTGACACAG",3,16,4,0,3,26,424
"TTCTAACTCATCGACA",0,0,0,0,0,0,16
"TTCTAACTCATGGGAG",2,6,2,0,0,10,26
"TTCTAACTCCGCATAA",0,7,4,0,0,11,182
"TTCTAGTAGCGTATGG",0,0,0,0,0,0,8
"TTCTAGTCAATACGAA",0,0,2,0,0,2,125
"TTCTAGTTCGTACACA",0,0,0,0,2,2,65
"TTCTCTCAGACAGCTG",0,0,3,0,0,3,139
"TTCTCTCAGGGCGAGA",4,26,6,3,50,89,2315
"TTCTCTCCAAGTACCT",29,117,14,5,21,186,5965
"TTCTCTCCACAAGTTC",0,7,2,0,0,9,81
"TTCTCTCCACTAGAGG",10,52,123,6,17,208,6825
"TTCTCTCCATATGCGT",0,0,2,0,0,2,47
"TTCTCTCGTATCACCA",0,0,0,0,0,0,5
"TTCTCTCGTCACTACA",1,2,0,0,0,3,54
"TTCTCTCTCCCTGTTG",0,0,0,0,0,0,103
"TTCTCTCTCGCATAGT",5,30,32,5,5,77,2231
"TTCTCTCTCTCTATAC",0,12,7,0,2,21,436
"TTCTGTAAGTGATGGC",0,8,0,0,2,10,347
"TTCTGTAAGTGCACAG",1,0,0,0,0,1,17
"TTCTGTAAGTGCAGGT",0,2,0,0,0,2,103
"TTCTGTACAAGGTTGG",1,13,0,0,3,17,180
"TTCTGTAGTGCGTTTA",0,0,0,0,0,0,66
"TTCTGTAGTTATGTGC",0,7,3,0,0,10,81
"TTCTGTAGTTTGACAC",0,2,0,0,0,2,38
"TTCTGTATCAACACGT",0,0,0,0,0,0,44
"TTCTTCCCACCCTTAC",1,3,0,0,0,4,113
"TTCTTCCCAGTCGTTA",17,468,58,10,36,589,12367
"TTCTTCCCATTATGCG",1,0,3,0,0,4,145
"TTCTTCCCATTGAGCT",0,0,0,0,0,0,21
"TTCTTCCGTATCGCTA",0,4,0,0,0,4,105
"TTCTTCCGTCGAGTGA",2,6,0,0,0,8,149
"TTCTTCCGTTCGGTCG",40,805,142,39,112,1138,35906
"TTCTTCCTCCTATTTG",1,9,0,0,0,10,152
"TTCTTCCTCGCAGTCG",4,5,0,0,0,9,207
"TTCTTGAAGGGACAGG",31,57,13,5,12,118,2882
"TTCTTGAAGTGATTCC",15,77,20,9,45,166,4366
"TTCTTGAAGTGGAAAG",0,3,0,0,0,3,130
"TTCTTGAAGTTGTAAG",3,19,3,0,3,28,525
"TTCTTGACAGAACTCT",1,0,0,0,0,1,89
"TTCTTGATCCTAACAG",69,309,484,29,109,1000,42479
"TTCTTGATCTACACAG",0,2,0,0,0,2,66
"TTCTTGATCTTGGAAC",0,3,0,0,0,3,86
"TTGAACGAGAGGCGGA",1,4,2,0,0,7,67
"TTGAACGAGATGAACT",0,8,2,0,0,10,304
"TTGAACGAGCAGTACG",0,2,0,0,0,2,80
"TTGAACGAGCATCTTG",12,67,219,9,34,341,13172
"TTGAACGAGTCACGCC",6,65,13,3,10,97,2351
"TTGAACGCAGGAGACT",0,0,0,0,2,2,10
"TTGAACGGTCGAACAG",0,2,2,0,0,4,87
"TTGACCCAGAATCGTA",0,3,0,0,0,3,100
"TTGACCCCAGAGCTAG",0,2,0,0,0,2,129
"TTGACCCCAGAGTCTT",30,23,8,0,10,71,1392
"TTGACCCCAGCGAACA",0,0,0,0,0,0,64
"TTGACCCTCATCCCGT",0,5,0,0,0,5,88
"TTGACCCTCATGCATG",3,13,2,0,7,25,427
"TTGACCCTCGCCTCTA",31,180,78,17,306,612,20579
"TTGACCCTCTCAGTCC",0,11,3,0,0,14,416
"TTGAGTGAGTCGTTAC",1,0,0,0,0,1,20
"TTGAGTGCACCGAATT",0,5,4,0,0,9,439
"TTGAGTGCACCTTCGT",0,3,2,0,0,5,117
"TTGAGTGGTCTGTAGT",3,12,2,0,4,21,606
"TTGAGTGTCCAATGCA",0,10,2,0,5,17,201
"TTGAGTGTCGCAGAGA",0,0,0,0,0,0,19
"TTGATGGAGACTTGTC",2,8,7,0,3,20,439
"TTGATGGAGAGTGGCT",0,2,0,0,0,2,100
"TTGATGGAGTGGGAAA",11,82,25,7,30,155,5349
"TTGATGGAGTTCCAGT",1,15,4,0,6,26,435
"TTGATGGCAGCAATTC",0,0,0,0,0,0,22
"TTGATGGCAGGTGAGT",0,13,3,0,5,21,552
"TTGATGGGTACCCAGC",0,8,0,2,0,10,252
"TTGATGGGTTGGGACA",0,9,3,0,2,14,282
"TTGATGGTCACCTCGT",1,2,0,0,0,3,16
"TTGATGGTCATTACTC",0,0,0,0,0,0,65
"TTGATGGTCCACTTTA",1,0,0,0,0,1,16
"TTGATGGTCGAACGGA",0,2,2,0,0,4,126
"TTGCATTAGATTGGGC",0,3,0,0,0,3,98
"TTGCATTCAACAAGAT",2,17,7,0,5,31,726
"TTGCATTCAGCTACTA",0,2,0,0,0,2,83
"TTGCATTGTGCGGTAA",21,196,38,3,31,289,9101
"TTGCATTTCGCTATTT",7,35,9,0,10,61,1913
"TTGCATTTCTCCGATC",0,0,0,0,0,0,2
"TTGCCTGAGGATATAC",0,0,0,0,0,0,78
"TTGCCTGAGGGCTAAC",0,3,0,0,0,3,63
"TTGCCTGGTGAAGCGT",1,14,15,0,9,39,1022
"TTGCCTGTCAGGACAG",0,2,3,0,3,8,96
"TTGCCTGTCGGTCTAA",1,9,2,0,2,14,258
"TTGCCTGTCTAGGAAA",0,6,0,0,0,6,68
"TTGCCTGTCTGGCTGG",0,4,0,0,3,7,196
"TTGCGTCAGGGATCGT",0,5,0,0,0,5,58
"TTGCGTCCAGTATGAA",0,0,0,0,0,0,39
"TTGCGTCCATACCGTA",0,0,0,0,0,0,2
"TTGCGTCCATGGAATA",1,8,3,0,0,12,177
"TTGCGTCTCGACGCGT",0,3,0,0,0,3,18
"TTGCTGCAGACCAGAC",4,17,26,2,8,57,1283
"TTGCTGCAGGCTTTCA",0,0,0,0,0,0,24
"TTGCTGCAGGGCAACT",8,55,53,0,78,194,5807
"TTGCTGCCAACTTGGT",0,5,0,0,0,5,217
"TTGCTGCGTATTGAGA",0,2,0,3,0,5,287
"TTGCTGCGTCCAACGC",0,2,2,2,0,6,83
"TTGCTGCGTCGCGTCA",0,3,3,0,0,6,26
"TTGCTGCGTGGTAATA",1,2,4,0,0,7,59
"TTGCTGCGTTAGAAAC",12,131,21,6,60,230,8698
"TTGCTGCTCGTTCCCA",1,3,0,0,0,4,108
"TTGGATGAGCAACAAT",2,5,4,0,0,11,34
"TTGGATGAGCCACAAG",0,2,0,0,0,2,51
"TTGGATGAGTATCTGC",0,2,0,0,0,2,51
"TTGGATGGTCCGGCAT",0,0,0,0,0,0,72
"TTGGATGGTGAGATAT",2,10,2,0,3,17,196
"TTGGATGTCTGGTGGC",0,10,0,0,2,12,174
"TTGGGATAGGAAGTAG",0,7,0,0,0,7,203
"TTGGGATAGTCACTCA",2,22,0,2,3,29,588
"TTGGGATAGTGATCGG",0,9,0,0,2,11,131
"TTGGGATCACATGTTG",0,0,4,0,2,6,32
"TTGGGATCACCCTGAG",10,52,85,6,18,171,5472
"TTGGGATCAGTTAAAG",1,13,2,0,3,19,260
"TTGGGATCATCTATCT",0,0,0,0,0,0,32
"TTGGGATGTGCTTATG",0,2,0,0,0,2,110
"TTGGGATTCCATATGG",0,0,0,0,0,0,8
"TTGGGATTCGCGTCGA",0,0,0,0,0,0,3
"TTGGGCGAGCAGCCCT",0,4,0,0,2,6,124
"TTGGGCGAGTGTAGTA",1,2,0,0,0,3,114
"TTGGGCGCAGACTCTA",0,2,0,0,0,2,39
"TTGGGCGCAGCTCTGG",0,12,3,0,3,18,278
"TTGGGCGCAGGACTTT",17,111,24,6,21,179,6659
"TTGGGCGTCCCAGCGA",6,17,8,3,4,38,559
"TTGGGTAAGGAACGCT",20,154,100,9,39,322,12428
"TTGGGTAAGTGCCGAA",0,2,0,0,2,4,73
"TTGGGTAAGTTTCAGC",8,46,43,0,12,109,3568
"TTGGGTACAACTTGGT",1,0,0,0,0,1,41
"TTGGGTACAAGAAACT",0,4,2,0,0,6,58
"TTGGGTACAGACCAAG",2,21,2,0,9,34,334
"TTGGGTACAGCTCATA",4,43,56,5,53,161,6271
"TTGGGTACATGCAGGA",1,4,5,0,2,12,362
"TTGGGTAGTAGGACTG",2,41,10,2,8,63,2038
"TTGGGTAGTCTGCATA",3,8,0,0,2,13,291
"TTGGGTAGTGTAGTGG",0,9,2,0,0,11,494
"TTGGGTATCCAACTAG",1,10,0,0,0,11,224
"TTGGGTATCGCCAATA",1,4,2,0,0,7,76
"TTGGTTTAGCAGAAAG",0,0,0,0,0,0,84
"TTGGTTTAGCGGTAGT",2,9,3,0,0,14,236
"TTGGTTTAGTCATACC",18,270,47,9,56,400,15593
"TTGGTTTCAATGTCTG",1,2,0,0,0,3,166
"TTGGTTTCAGTGGGTA",2,5,0,0,0,7,64
"TTGGTTTGTGCATGTT",21,100,220,15,84,440,17327
"TTGGTTTGTTGGGATG",2,7,2,0,0,11,216
"TTGGTTTTCTTGTTAC",2,10,0,0,2,14,64
"TTGTGGAAGCTCCACG",0,12,2,0,4,18,348
"TTGTGGAAGTAGAGTT",1,10,3,0,3,17,172
"TTGTGGAAGTGTTCAC",0,4,3,0,0,7,76
"TTGTGGACAACACTAC",0,0,0,0,0,0,16
"TTGTGGACAACAGTGG",0,2,0,0,2,4,110
"TTGTGGACACTTCTCG",0,8,0,0,0,8,84
"TTGTGGACAGACAAGC",2,14,2,0,5,23,362
"TTGTGGACAGCAATTC",25,129,22,5,23,204,6670
"TTGTGGAGTCCGGTCA",23,138,25,6,24,216,9320
"TTGTGGATCCACCTCA",0,3,0,0,2,5,70
"TTGTGGATCCCAGCGA",0,0,0,0,0,0,3
"TTGTGGATCGTTAGAC",2,3,0,0,2,7,107
"TTGTGGATCTTACTGT",0,3,0,0,0,3,101
"TTGTGTTAGCCATGCC",1,6,2,0,0,9,142
"TTGTGTTAGGCTCACC",8,29,36,2,14,89,3369
"TTGTGTTCACAATGAA",0,0,0,0,0,0,3
"TTGTGTTCAGGGAGAG",5,8,6,0,6,25,542
"TTGTGTTCATTCGATG",2,13,6,0,2,23,658
"TTGTGTTGTTCCGCGA",1,3,2,0,0,6,51
"TTGTGTTGTTCCTAGA",0,5,2,0,0,7,36
"TTGTGTTTCATTGTGG",0,0,0,0,0,0,1
"TTGTGTTTCCCACAGG",1,4,2,0,0,7,86
"TTGTGTTTCGGAATGG",43,119,29,5,28,224,8640
"TTGTTCAAGACCGTTT",0,4,0,0,0,4,123
"TTGTTCAAGTATGAAC",1,21,10,2,46,80,2946
"TTGTTCAAGTCTGCAT",0,0,0,0,0,0,5
"TTGTTCACAAAGAACT",1,0,0,0,0,1,97
"TTGTTCACAACAGCCC",12,10,4,0,2,28,1059
"TTGTTCACATACATCG",1,3,0,0,0,4,184
"TTGTTCACATCTCCCA",0,0,0,0,0,0,1
"TTGTTCAGTAGGCTGA",0,5,0,0,0,5,92
"TTGTTCAGTGCCCGTA",3,20,3,0,3,29,339
"TTGTTCATCCGCTAGG",4,36,11,0,3,54,1132
"TTGTTCATCTTACCAT",0,4,2,0,0,6,162
"TTGTTGTCAGTCTTCC",0,0,0,0,0,0,87
"TTGTTGTGTTCTTAGG",24,65,78,6,144,317,13510
"TTGTTGTTCCTGTAAG",0,9,9,0,3,21,342
"TTGTTTGAGGAGCAAA",0,0,0,0,0,0,95
"TTGTTTGAGGCATCAG",0,6,2,0,0,8,150
"TTGTTTGAGTAGGCCA",1,0,0,0,0,1,128
"TTGTTTGCATCTGTTT",0,0,0,0,0,0,56
"TTGTTTGGTAGGCAAC",11,39,97,2,15,164,6587
"TTGTTTGGTCGTTGGC",0,0,0,0,0,0,53
"TTGTTTGGTGGCCTCA",0,3,0,0,3,6,170
"TTGTTTGTCGAGAAGC",13,50,78,4,68,213,7922
"TTTACCAAGCCAAGGT",3,12,3,0,5,23,213
"TTTACCACAATCCTAG",0,4,0,0,2,6,192
"TTTACCATCCCTTTGG",3,20,20,0,6,49,1423
"TTTACCATCTCATGGA",0,2,0,0,0,2,28
"TTTACGTAGCGACTGA",1,13,7,0,4,25,234
"TTTACGTCACTGCGAC",0,5,0,0,0,5,26
"TTTACGTGTACAGTAA",0,4,2,0,0,6,23
"TTTACGTGTGTTGATC",0,0,0,0,0,0,89
"TTTACGTGTTGACTAC",0,0,0,0,0,0,71
"TTTACGTTCAATGTCG",30,146,55,14,204,449,13466
"TTTACGTTCCAAACCA",0,7,0,0,3,10,191
"TTTACGTTCCAAAGGG",0,14,2,0,2,18,278
"TTTACGTTCGCACTCT",2,20,5,0,8,35,472
"TTTACGTTCGTGGCTG",2,10,0,0,0,12,273
"TTTACGTTCTATGTGG",0,2,0,0,0,2,30
"TTTACGTTCTGCTGAA",2,7,3,0,0,12,383
"TTTACTGAGCCGATTT",2,16,6,2,0,26,407
"TTTACTGAGTCCTACA",41,112,181,15,134,483,17005
"TTTACTGCATGAGAAT",1,3,3,0,2,9,81
"TTTACTGCATTCACAG",0,2,0,0,2,4,277
"TTTACTGTCTTCCGTG",449,1346,394,101,272,2562,80896
"TTTAGTCAGCATCGAG",0,4,0,0,0,4,88
"TTTAGTCGTTTGTTCT",3,18,2,0,7,30,254
"TTTAGTCTCTAGAGCT",1,6,0,0,0,7,139
"TTTATGCCAAGGTCGA",0,0,0,0,0,0,79
"TTTATGCCATCCCGTT",0,11,0,0,0,11,509
"TTTATGCTCCCAGGAC",1,3,0,0,3,7,190
"TTTATGCTCCTTATGT",0,2,0,0,0,2,46
"TTTCACACAAACTAGA",2,11,2,0,2,17,205
"TTTCACACAAAGGAGA",1,4,0,0,0,5,60
"TTTCACACAAATGGCG",0,0,0,0,0,0,32
"TTTCACACACCAGCCA",1,2,0,0,0,3,114
"TTTCACACATGACAAA",1,7,2,0,3,13,354
"TTTCACAGTACAAGCG",0,5,0,0,0,5,97
"TTTCACAGTAGACAGC",1,4,0,0,0,5,153
"TTTCACATCAAACTGC",0,3,0,0,2,5,61
"TTTCACATCGATACAC",0,3,2,0,0,5,56
"TTTCACATCGTTATCT",0,2,0,0,4,6,257
"TTTCACATCTAAACGC",0,10,2,0,5,17,270
"TTTCAGTAGAGTATAC",0,3,0,0,0,3,26
"TTTCAGTAGTAGCATA",1,0,0,0,2,3,65
"TTTCAGTAGTAGGGTC",1,5,0,0,0,6,72
"TTTCAGTGTAGCGTTT",0,6,0,0,0,6,99
"TTTCAGTTCACTGAAC",1,0,0,0,0,1,171
"TTTCAGTTCGGAGTGA",1,5,0,0,2,8,71
"TTTCATGAGCGATCGA",1,2,0,0,0,3,120
"TTTCATGAGTTCCAGT",0,0,0,0,0,0,2
"TTTCATGAGTTCGCAT",1,0,0,0,0,1,119
"TTTCATGCAACTAGAA",1,9,3,0,3,16,328
"TTTCATGCATAACTCG",1,3,0,0,0,4,144
"TTTCATGCATTAAAGG",1,5,0,0,0,6,110
"TTTCATGGTAGGATAT",3,6,2,0,0,11,56
"TTTCATGGTCACTCGG",0,0,0,0,0,0,116
"TTTCATGTCATTTACC",0,3,0,0,2,5,72
"TTTCATGTCTTCCCAG",0,3,0,0,0,3,75
"TTTCATGTCTTTCAGT",1,11,2,0,2,16,511
"TTTCCTCAGAGCCGTA",1,0,0,0,0,1,7
"TTTCCTCAGCGGGTTA",0,2,0,2,0,4,21
"TTTCCTCCACGTCGGT",0,0,0,0,0,0,44
"TTTCCTCGTATTCCTT",36,379,103,24,81,623,20017
"TTTCCTCGTGAAGCGT",1,5,2,0,0,8,372
"TTTCCTCGTGCCCAGT",0,5,0,0,2,7,67
"TTTCCTCGTGGTGATG",0,0,0,0,0,0,9
"TTTCCTCTCACACGAT",3,0,0,0,0,3,281
"TTTCGATAGACCCGCT",266,346,132,24,113,881,26447
"TTTCGATAGCGATGAC",0,2,0,0,0,2,114
"TTTCGATAGGATACCG",0,3,0,0,0,3,75
"TTTCGATAGGGAGGTG",4,8,7,2,4,25,273
"TTTCGATCAACACAGG",11,12,2,0,4,29,587
"TTTCGATCACGGGCTT",4,15,0,0,5,24,394
"TTTCGATCAGGGACTA",4,19,4,0,3,30,448
"TTTCGATCATATACCG",6,28,9,3,20,66,1281
"TTTCGATGTTGTGTAC",0,9,0,0,0,9,238
"TTTCGATTCTACGCAA",4,23,27,0,11,65,2791
"TTTCGATTCTATCGTT",1,15,6,2,5,29,665
"TTTGACTAGACCATTC",22,93,21,32,20,188,6785
"TTTGACTAGACCCGCT",0,0,0,0,0,0,4
"TTTGACTAGCGTGAAC",0,4,0,0,0,4,43
"TTTGACTCAAAGCACG",0,16,3,0,5,24,445
"TTTGACTGTCTGTAGT",0,2,2,0,0,4,154
"TTTGACTTCGCCTCTA",4,11,4,0,2,21,375
"TTTGACTTCGTGTTCC",0,5,4,0,0,9,170
"TTTGACTTCTCTCAAT",1,0,0,0,0,1,23
"TTTGACTTCTTCTGGC",0,0,0,0,0,0,52
"TTTGATCAGTAAGGGA",1,14,2,0,3,20,257
"TTTGATCCACCCAACG",0,2,0,0,0,2,9
"TTTGATCCAGCATACT",1,16,5,0,5,27,473
"TTTGATCCAGGAAGTC",0,2,0,0,0,2,46
"TTTGATCCATGAGTAA",0,0,0,0,0,0,14
"TTTGATCCATGGCCAC",12,171,96,12,78,369,14206
"TTTGATCGTAGTGATA",0,0,0,0,0,0,3
"TTTGATCGTATGCGGA",1,0,0,0,0,1,59
"TTTGATCTCGAATGCT",2,15,7,0,3,27,270
"TTTGATCTCGCAATGT",219,137,54,17,47,474,14556
"TTTGGAGAGTGCCTCG",9,107,35,3,80,234,7295
"TTTGGAGCAACGTAAA",2,11,3,0,5,21,33
"TTTGGAGGTCCCACGA",302,2731,680,174,516,4403,132369
"TTTGGAGGTCCTGTTC",0,2,0,0,0,2,122
"TTTGGAGGTGACTAAA",0,9,0,0,0,9,174
"TTTGGAGTCCGCGATG",1,2,0,0,0,3,47
"TTTGGAGTCGTTAGTG",5,25,7,0,152,189,978
"TTTGGTTAGTTCACTG",1,12,7,0,3,23,391
"TTTGGTTGTTTACGTG",0,6,2,0,0,8,366
"TTTGGTTTCCTATGGA",0,2,3,0,0,5,61
"TTTGGTTTCTCTGGTC",1,4,0,0,2,7,111
"TTTGTTGAGGCGAAGG",0,0,2,0,0,2,82
"TTTGTTGAGTTCGGTT",1,7,3,0,3,14,342
"TTTGTTGCATGATGCT",0,7,0,0,0,7,93
"TTTGTTGGTGGACCTC",0,0,0,0,0,0,34
"TTTGTTGTCAGCGGAA",0,3,0,0,0,3,92
"TTTGTTGTCTAAGCCA",14,55,134,7,38,248,10223
