"","Bar1","Bar2","Bar3","Bar4","Bar5","nUMI","nUMI_total"
"AAACCCAAGCGATTCT",2,23,0,0,4,29,767
"AAACCCACACTATGTG",0,13,5,2,5,25,160
"AAACCCATCTCGTCGT",1,2,0,0,0,3,87
"AAACGAAAGCGTGTTT",2,7,0,0,2,11,67
"AAACGAACACTCACTC",3,17,7,0,2,29,502
"AAACGAACATGGCCAC",0,11,0,0,0,11,181
"AAACGAAGTACTAACC",3,23,4,2,2,34,605
"AAACGAAGTTCAGTAC",0,5,2,0,0,7,67
"AAACGAATCAGCATTG",1,13,3,0,3,20,52
"AAACGAATCATAAGGA",122,1130,224,63,168,1707,74554
"AAACGAATCCAGGACC",3,24,5,0,0,32,1339
"AAACGAATCGAGAAGC",1,10,0,0,0,11,140
"AAACGAATCTCTCCGA",0,6,4,0,0,10,181
"AAACGCTCACGGTCTG",0,2,0,0,0,2,4
"AAACGCTCAGAAATTG",0,0,0,0,0,0,5
"AAACGCTCAGCCCAGT",0,0,0,0,0,0,36
"AAACGCTCAGCTCGGT",6,36,49,3,14,108,4381
"AAACGCTGTAATCAGA",1,5,2,0,0,8,93
"AAACGCTGTGTTTCTT",1,25,2,0,9,37,427
"AAACGCTTCTCACTCG",22,58,20,8,19,127,2912
"AAACGCTTCTGGGCCA",4,15,4,2,2,27,663
"AAAGAACCAAACCATC",37,406,86,21,64,614,28598
"AAAGAACCAATTCGTG",2,4,0,0,0,6,88
"AAAGAACCACATACGT",6,25,12,0,15,58,2154
"AAAGAACCAGTCCGTG",0,7,0,0,3,10,283
"AAAGAACCATGTGGCC",1,4,0,0,2,7,111
"AAAGAACGTAACCAGG",0,3,0,0,0,3,91
"AAAGAACGTTCTGACA",0,0,0,0,0,0,3
"AAAGAACTCTTCCCGA",4,23,3,0,4,34,735
"AAAGAACTCTTTCCGG",64,155,38,8,31,296,10970
"AAAGGATAGACGCCCT",0,5,0,0,2,7,82
"AAAGGATAGCCGAATG",1,26,11,0,0,38,704
"AAAGGATCAACTCGTA",5,14,3,0,7,29,1021
"AAAGGATCATAGAATG",16,61,47,4,73,201,6721
"AAAGGATGTCAGACGA",1,0,0,0,0,1,13
"AAAGGATTCCCAACTC",4,32,9,3,6,54,817
"AAAGGATTCGCCGTGA",0,6,2,0,2,10,97
"AAAGGATTCTCGCTTG",5,8,5,0,2,20,447
"AAAGGGCAGCGTGAAC",3,10,6,0,4,23,379
"AAAGGGCAGGATTTAG",145,1050,248,75,203,1721,95029
"AAAGGGCAGTCAGAGC",3,21,4,0,3,31,88
"AAAGGGCCATTGACTG",19,98,263,17,48,445,24574
"AAAGGGCTCTAGTTCT",5,32,13,4,5,59,831
"AAAGGTAAGTCTCTGA",2,17,4,0,2,25,78
"AAAGGTACAAGTCCCG",3,7,3,0,0,13,545
"AAAGGTAGTTTACTTC",1,11,7,0,3,22,379
"AAAGGTAGTTTCGTAG",5,5,3,0,0,13,326
"AAAGTCCAGCAGAAAG",0,0,0,0,0,0,24
"AAAGTCCAGGCTGAAC",25,69,203,15,45,357,19210
"AAAGTCCAGTTGGCTT",0,8,0,0,3,11,208
"AAAGTCCGTCCCTAAA",1,10,3,0,0,14,573
"AAAGTCCGTGTACGCC",0,5,0,0,2,7,180
"AAAGTCCTCAAGTGTC",3,22,8,0,7,40,768
"AAAGTCCTCACATTGG",0,7,3,0,0,10,117
"AAAGTCCTCGTGGGAA",0,4,0,0,0,4,60
"AAAGTCCTCTCGGGAC",1,18,6,2,6,33,878
"AAAGTGAAGGCATGGT",1,27,11,2,6,47,1113
"AAAGTGAAGTAGTCCT",17,53,24,3,59,156,7736
"AAAGTGACAATGGCCC",2,24,18,0,11,55,1315
"AAAGTGACATCCCGTT",0,0,0,0,0,0,11
"AAAGTGAGTGGCTAGA",2,14,6,0,3,25,45
"AAAGTGATCACAATGC",0,0,0,0,0,0,63
"AAAGTGATCATCTGTT",0,6,0,0,0,6,225
"AAAGTGATCGATTGGT",3,20,8,2,2,35,739
"AAAGTGATCTTAGCTT",0,5,0,0,3,8,70
"AAATGGACACCTCGTT",0,7,0,0,2,9,62
"AAATGGACACTGGATT",17,85,179,19,67,367,19053
"AAATGGACATCCGAAT",2,24,6,2,3,37,489
"AAATGGAGTAACTAAG",4,26,6,0,3,39,180
"AAATGGATCCATTGCC",0,4,0,2,2,8,158
"AAATGGATCTGGAAGG",0,15,4,0,2,21,47
"AACAAAGAGCCGATTT",0,0,0,0,0,0,6
"AACAAAGCAGACGCTC",7,29,9,2,29,76,2400
"AACAAAGGTACCCAGC",3,22,11,0,6,42,544
"AACAAAGGTCCCTGAG",0,3,2,0,0,5,54
"AACAAAGGTTGTCTAG",1,0,0,0,0,1,20
"AACAAAGGTTTGTGGT",0,11,7,0,0,18,133
"AACAACCAGGAACATT",0,4,0,0,2,6,71
"AACAACCAGGGTGAGG",4,34,12,0,12,62,2651
"AACAACCCAACTTGCA",5,37,39,0,11,92,3449
"AACAACCCACTCCGAG",1,7,0,0,0,8,216
"AACAACCCATCTGTTT",5,41,8,4,11,69,1065
"AACAACCGTAATTAGG",9,67,17,8,16,117,4453
"AACAACCTCACTCGAA",1,12,2,0,4,19,310
"AACAACCTCGTAGAGG",2,21,7,0,3,33,198
"AACAAGAAGAGGGTGG",3,21,5,3,6,38,576
"AACAAGAAGCGATGAC",2,21,9,0,6,38,220
"AACAAGACAACTCGAT",18,78,172,10,30,308,14998
"AACAAGACAAGACCGA",5,28,6,2,3,44,862
"AACAAGACACAAATAG",3,18,3,0,5,29,58
"AACAAGACACCAACAT",535,422,172,50,153,1332,63129
"AACAAGACAGACGATG",15,55,28,7,111,216,6180
"AACAAGACATCCTATT",0,6,0,0,2,8,249
"AACAAGAGTAGTCTGT",1,4,4,0,0,9,114
"AACAAGAGTGCAAGAC",0,0,0,0,0,0,7
"AACAAGAGTGTGCTTA",1,4,0,0,0,5,224
"AACAAGAGTTCTCTCG",2,26,5,0,4,37,589
"AACAAGATCGCCTTGT",1,25,2,0,6,34,547
"AACACACAGAAGCCTG",10,64,13,2,12,101,3223
"AACACACAGAATCGTA",1,3,0,0,0,4,137
"AACACACAGCCAAGTG",23,53,17,5,9,107,3583
"AACACACAGTTAGTAG",0,4,0,0,0,4,12
"AACACACCACCTGTCT",81,160,44,23,36,344,13439
"AACACACGTCTGTGTA",0,2,0,2,0,4,134
"AACACACTCTCAACCC",0,7,2,0,0,9,180
"AACAGGGAGACCACGA",1,20,6,0,3,30,491
"AACAGGGCAACATCGT",477,380,162,43,127,1189,53262
"AACAGGGCACTAGGTT",3,13,11,0,6,33,505
"AACAGGGCATGTTCAG",25,86,130,18,80,339,15430
"AACAGGGGTCTTAGTG",0,13,3,0,4,20,418
"AACAGGGGTTCGGGTC",0,2,0,3,2,7,242
"AACAGGGGTTGGGAAC",3,17,13,0,2,35,585
"AACAGGGTCGCTGATA",0,0,0,0,0,0,51
"AACAGGGTCTTCGATT",2,0,0,0,0,2,151
"AACCAACAGCTGCCTG",0,2,0,0,0,2,48
"AACCAACAGGGAGGGT",80,269,125,464,113,1051,48143
"AACCAACCACATTCGA",0,3,0,0,2,5,278
"AACCAACCACCATATG",19,179,37,12,36,283,13385
"AACCAACGTAGGTTTC",6,7,2,0,2,17,536
"AACCAACGTCTTACTT",12,51,33,6,21,123,3744
"AACCAACGTTAGGCTT",1,0,0,0,0,1,7
"AACCAACTCCATCTCG",3,39,5,5,6,58,1918
"AACCAACTCTCACCCA",3,54,9,0,9,75,2675
"AACCACAAGTGGCAGT",112,1142,227,47,187,1715,82556
"AACCACACAAGATGGC",0,5,0,0,0,5,95
"AACCACAGTATCGATC",4,24,6,2,15,51,1868
"AACCACAGTCTACGAT",4,21,10,2,6,43,805
"AACCACATCCACAGGC",2,2,0,0,0,4,71
"AACCACATCTTGTTAC",6,30,11,3,4,54,1067
"AACCATGAGTATGTAG",0,16,8,0,2,26,500
"AACCATGCAGGAGGAG",0,8,2,0,0,10,135
"AACCATGCATCTCATT",0,10,2,0,0,12,235
"AACCATGGTCCATACA",1,26,2,0,3,32,605
"AACCATGGTCGAGATG",4,27,7,0,5,43,896
"AACCATGGTCTAGATC",0,9,2,0,0,11,106
"AACCATGGTGTTTGCA",0,0,0,0,0,0,44
"AACCATGTCCAAGCAT",3,14,4,2,3,26,428
"AACCATGTCTGTCCCA",1,3,0,2,0,6,198
"AACCCAACAGAGAATT",15,59,24,7,83,188,6497
"AACCCAAGTACAGTAA",9,34,20,4,67,134,7240
"AACCCAAGTATGCTAC",0,10,3,0,0,13,342
"AACCCAATCTGACGCG",0,2,0,0,0,2,30
"AACCTGAAGAAGTATC",6,38,46,5,19,114,4207
"AACCTGAAGCTAAATG",1,9,0,2,2,14,190
"AACCTGAAGCTGTCCG",0,3,0,0,0,3,73
"AACCTGACAAACTCGT",0,5,0,0,0,5,219
"AACCTGACACTTCCTG",2,3,0,0,0,5,148
"AACCTGAGTACAGTAA",3,34,4,0,2,43,766
"AACCTGAGTACCGCGT",0,4,0,0,0,4,112
"AACCTGAGTCCACTTC",23,177,39,6,33,278,18425
"AACCTGATCACTACTT",0,0,0,0,0,0,7
"AACCTGATCAGCTCTC",1,5,2,0,0,8,188
"AACCTGATCCGGACGT",0,4,0,0,0,4,45
"AACCTGATCTGAGTCA",66,171,336,33,192,798,34601
"AACCTGATCTTTGCAT",0,4,5,0,2,11,173
"AACCTTTAGAAGAGCA",0,0,0,0,0,0,12
"AACCTTTAGACCACGA",0,0,3,0,0,3,227
"AACCTTTAGGTCGTGA",0,22,5,0,3,30,378
"AACCTTTCAAGAGAGA",0,8,2,0,0,10,129
"AACCTTTCAGCGTGAA",0,8,5,0,0,13,218
"AACCTTTCATGGTACT",3,7,4,0,0,14,89
"AACCTTTCATGTTACG",121,963,272,64,211,1631,86593
"AACCTTTGTATTGCCA",0,11,0,0,2,13,140
"AACCTTTGTGTGGTCC",2,12,3,0,2,19,232
"AACCTTTTCGTAATGC",13,133,27,11,27,211,8929
"AACGAAAAGGCTTCCG",17,9,7,3,5,41,1448
"AACGAAACATACTGTG",15,140,52,10,29,246,10567
"AACGAAAGTATGCGTT",1,8,3,0,0,12,115
"AACGAAAGTGGTGATG",256,93,58,21,45,473,19011
"AACGAAAGTGTGTCCG",1,3,0,0,0,4,114
"AACGAAATCACACCGG",0,8,0,0,0,8,256
"AACGAAATCAGTAGGG",2,30,12,2,6,52,866
"AACGAAATCCGGACTG",0,6,0,0,0,6,117
"AACGAAATCCTCGATC",209,90,46,10,38,393,17648
"AACGGGAAGGTCCGAA",18,119,30,5,25,197,9148
"AACGGGATCCAAACCA",1,7,0,0,2,10,372
"AACGGGATCGTCAGAT",0,0,2,0,0,2,69
"AACGGGATCGTTCTAT",0,5,2,0,0,7,235
"AACGTCAAGAGCACTG",0,3,0,0,0,3,29
"AACGTCAAGATAACAC",8,54,11,0,8,81,3538
"AACGTCAAGTTCACTG",3,0,2,0,0,5,156
"AACGTCACAACGGCCT",1,0,2,0,0,3,79
"AACGTCACAGAATGTA",1,15,11,2,4,33,627
"AACGTCACAGAGATGC",2,2,0,0,0,4,17
"AACGTCAGTCGGCACT",2,0,0,0,0,2,169
"AACGTCAGTCTTCTAT",0,22,6,3,6,37,693
"AACGTCAGTGTAAACA",4,28,11,0,13,56,1566
"AACGTCATCAAGCCCG",0,4,0,0,0,4,57
"AACGTCATCAGCGTCG",7,23,99,2,8,139,2142
"AACGTCATCGAGCACC",1,2,0,0,0,3,28
"AACGTCATCGCATTGA",0,0,0,0,0,0,100
"AACGTCATCTCGTCAC",21,49,91,2,49,212,10271
"AACTTCTAGAAGCGAA",16,66,91,11,24,208,10826
"AACTTCTAGCACACCC",0,2,0,0,0,2,32
"AACTTCTCATGTGACT",6,26,6,4,4,46,1225
"AACTTCTGTAGTATAG",1,12,3,0,3,19,375
"AACTTCTGTTATGTCG",1,8,0,0,0,9,121
"AACTTCTTCCCGAGTG",2,5,2,0,0,9,108
"AACTTCTTCTCAGAAC",0,3,0,0,0,3,48
"AAGAACAAGAATACAC",1,8,0,0,4,13,146
"AAGAACAAGCTTGTTG",0,20,3,0,5,28,533
"AAGAACAAGGTATCTC",0,9,0,0,2,11,89
"AAGAACAAGGTGCGAT",4,35,7,2,10,58,1181
"AAGAACACAACCGATT",3,2,0,0,0,5,204
"AAGAACAGTAGCGAGT",2,17,2,0,0,21,597
"AAGAACAGTGGATCAG",0,7,2,0,2,11,62
"AAGAACAGTTACGATC",3,40,8,0,9,60,105
"AAGAACATCCATAGGT",0,7,2,0,4,13,227
"AAGAACATCGACACTA",10,76,21,10,20,137,4772
"AAGAACATCTAGAGCT",0,4,0,0,0,4,7
"AAGACAACACGTAGAG",0,3,0,0,0,3,81
"AAGACAACACTGCGAC",0,8,2,0,0,10,184
"AAGACAACACTGGCCA",1,15,2,0,4,22,493
"AAGACAACAGCGTATT",7,36,18,0,9,70,1727
"AAGACAAGTACGAGTG",0,0,0,0,0,0,3
"AAGACAAGTGACAACG",0,7,0,0,2,9,97
"AAGACAAGTGTTGACT",0,0,3,0,0,3,89
"AAGACAATCAGACAAA",1,17,6,0,4,28,255
"AAGACAATCCGTGTAA",1,21,7,0,4,33,566
"AAGACTCAGCCATTCA",0,0,0,0,0,0,27
"AAGACTCAGTCTGGAG",1,7,2,0,0,10,34
"AAGACTCAGTGAGTGC",1,2,2,0,0,5,145
"AAGACTCCAGAGGACT",1,3,0,0,0,4,132
"AAGACTCCATGATAGA",2,2,3,0,0,7,122
"AAGACTCGTCGAACAG",2,10,2,0,0,14,155
"AAGACTCGTCTGCATA",1,5,2,0,0,8,153
"AAGACTCTCATTTGGG",1,6,0,0,0,7,134
"AAGACTCTCGTGTCAA",0,6,0,0,2,8,83
"AAGATAGAGGAACTAT",5,12,0,0,0,17,84
"AAGATAGAGGTTCATC",5,35,40,6,15,101,4274
"AAGATAGCAGCCCAGT",1,14,0,0,2,17,106
"AAGATAGCAGTAACGG",0,0,0,0,0,0,39
"AAGATAGGTAGGGTAC",111,837,199,55,153,1355,73238
"AAGATAGGTGACCTGC",0,0,0,0,0,0,3
"AAGATAGGTTCGGTAT",207,1401,392,95,306,2401,117574
"AAGCATCAGCAACAAT",109,802,229,58,168,1366,59885
"AAGCATCAGCCGCACT",0,2,0,0,0,2,159
"AAGCATCAGCGTCTGC",0,5,0,0,0,5,173
"AAGCATCCAACTTCTT",1,5,2,0,3,11,109
"AAGCATCCAATGTTGC",12,42,21,5,70,150,5431
"AAGCATCCAGAGATGC",233,2032,451,125,345,3186,143740
"AAGCATCGTATCGAAA",2,21,5,0,4,32,446
"AAGCATCTCCACACCT",2,23,2,0,5,32,808
"AAGCATCTCCGAAATC",7,86,25,15,12,145,3639
"AAGCCATAGCCTTTGA",0,2,3,0,0,5,214
"AAGCCATAGCGTCTGC",2,5,4,0,5,16,302
"AAGCCATAGGTTGTTC",5,31,36,0,6,78,2801
"AAGCCATGTGGACCAA",0,4,2,0,3,9,122
"AAGCCATGTTTACTTC",0,8,5,0,7,20,509
"AAGCCATTCTAGTACG",1,8,0,0,0,9,271
"AAGCGAGAGCCAGAGT",1,31,12,0,5,49,1014
"AAGCGAGAGCTGTCCG",1,0,0,0,0,1,5
"AAGCGAGAGTCATGAA",4,22,10,2,6,44,559
"AAGCGAGAGTGCCTCG",2,0,0,0,0,2,178
"AAGCGAGCACAGGATG",2,9,2,0,2,15,198
"AAGCGAGCACCGTACG",0,10,0,0,0,10,122
"AAGCGAGCAGAAGTGC",2,4,0,0,0,6,102
"AAGCGAGGTAAGCGGT",24,171,75,14,40,324,12180
"AAGCGAGGTAGAATAC",0,12,4,0,2,18,173
"AAGCGAGGTCTTAGTG",8,19,5,0,4,36,1720
"AAGCGAGGTGTGTGGA",1,5,2,0,0,8,249
"AAGCGAGTCCAGTTCC",24,45,18,35,29,151,6130
"AAGCGTTAGAATCGCG",0,0,0,0,0,0,186
"AAGCGTTAGGATACGC",0,12,7,0,2,21,419
"AAGCGTTAGGGTAATT",2,33,10,2,8,55,801
"AAGCGTTAGTACCCTA",4,26,5,2,4,41,473
"AAGCGTTAGTTGCCCG",39,321,69,19,64,512,25813
"AAGCGTTCATACACCA",1,7,2,0,0,10,275
"AAGCGTTGTCGACGCT",4,29,7,0,7,47,902
"AAGCGTTGTCGCTTAA",1,10,5,0,0,16,361
"AAGCGTTGTGTCTTAG",0,0,0,0,0,0,6
"AAGCGTTTCAAGCTTG",0,4,0,0,2,6,90
"AAGCGTTTCCTACAAG",1,4,2,0,0,7,54
"AAGGAATAGAAGCCTG",87,68,19,9,23,206,7760
"AAGGAATAGTGGACGT",0,0,0,0,0,0,15
"AAGGAATCACAGTGTT",26,216,49,13,51,355,17202
"AAGGAATCAGACAAGC",1,17,4,5,7,34,662
"AAGGAATCAGTTGGTT",0,8,2,0,0,10,124
"AAGGAATTCAACACGT",0,3,0,0,0,3,15
"AAGGAATTCACAAGAA",1,18,4,0,7,30,160
"AAGGAATTCGAGAATA",0,3,3,0,0,6,22
"AAGGTAAAGAGCAGAA",4,17,10,3,6,40,748
"AAGGTAAAGGGACACT",2,2,0,0,0,4,43
"AAGGTAAAGGTTCCGC",9,59,84,10,83,245,14509
"AAGGTAAAGTTTCGGT",12,47,25,8,41,133,4749
"AAGGTAACAGCACAGA",2,15,5,2,2,26,305
"AAGGTAAGTCGCGTCA",2,16,8,2,4,32,652
"AAGGTAAGTGACTGAG",0,0,0,0,0,0,3
"AAGGTAAGTGGCATCC",2,17,12,2,3,36,845
"AAGGTAAGTTGCATTG",1,2,0,0,0,3,90
"AAGGTAATCTGCTCTG",0,10,3,0,2,15,240
"AAGTACCAGCAAATCA",45,330,56,24,61,516,22859
"AAGTACCAGCCATCCG",1,18,2,2,2,25,60
"AAGTACCAGGTCCAGA",79,581,111,33,90,894,44104
"AAGTACCCAACCGCTG",0,6,0,0,2,8,108
"AAGTACCCACCAGACC",120,47,25,8,22,222,9890
"AAGTACCCACTTGAGT",1,28,9,2,6,46,504
"AAGTACCTCATGGTAC",2,9,2,0,0,13,124
"AAGTACCTCTTTCAGT",1,11,0,0,0,12,100
"AAGTCGTAGCAACTTC",1,2,2,0,0,5,56
"AAGTCGTCATTCTCTA",0,2,2,0,0,4,409
"AAGTCGTGTCACGTGC",1,0,2,0,0,3,24
"AAGTCGTGTGGTAATA",3,15,4,0,2,24,378
"AAGTCGTTCACGACTA",3,13,2,0,5,23,181
"AAGTCGTTCATACGAC",7,38,19,3,38,105,4125
"AAGTCGTTCGTTCCTG",0,2,0,0,4,6,14
"AAGTCGTTCTTTCAGT",4,36,6,2,5,53,1097
"AAGTGAAAGAGCATAT",0,0,0,0,0,0,6
"AAGTGAAAGTATGACA",19,209,50,12,41,331,14220
"AAGTGAAAGTTGCGCC",3,8,4,0,0,15,476
"AAGTGAACATCGTTCC",0,12,0,0,0,12,66
"AAGTGAACATGTCGTA",0,0,0,0,0,0,30
"AAGTGAACATTCGGGC",0,5,2,0,0,7,94
"AAGTGAAGTAAGAACT",0,5,2,0,0,7,260
"AAGTGAAGTAGCTGTT",0,2,0,0,0,2,184
"AAGTGAAGTCCGGACT",6,20,6,0,2,34,466
"AAGTGAATCTAAGGAA",2,17,3,0,3,25,195
"AAGTTCGAGGCTAGCA",2,17,9,0,3,31,190
"AAGTTCGAGGTGCGAT",15,56,76,4,23,174,7060
"AAGTTCGAGTATGTAG",0,4,2,0,0,6,60
"AAGTTCGAGTCGGCAA",1,18,4,2,2,27,1131
"AAGTTCGAGTTACGGG",5,18,5,0,0,28,344
"AAGTTCGCAAAGACTA",0,5,0,0,3,8,175
"AAGTTCGCAACTAGAA",1,4,0,0,0,5,180
"AAGTTCGCAAGTACCT",3,19,4,0,2,28,663
"AAGTTCGCACCATATG",1,8,0,0,0,9,145
"AAGTTCGCATAACAGA",0,3,0,0,0,3,36
"AAGTTCGCATTCCTAT",1,13,5,0,4,23,642
"AAGTTCGGTCCTCCAT",1,4,0,0,0,5,45
"AAGTTCGGTCGTCTCT",2,14,7,0,0,23,448
"AAGTTCGGTTTGTTCT",0,0,0,0,0,0,52
"AAGTTCGTCCGTATGA",0,7,3,0,0,10,390
"AATAGAGAGCCATTCA",0,5,3,0,0,8,220
"AATAGAGCAAGAGGCT",0,7,0,0,0,7,250
"AATAGAGCACCAACAT",0,0,0,0,0,0,10
"AATAGAGCACCGTCGA",40,184,301,18,84,627,21822
"AATAGAGCACTACCCT",1,4,3,0,0,8,150
"AATAGAGCACTGCATA",0,0,0,0,0,0,183
"AATAGAGGTATCCTCC",0,20,5,2,4,31,86
"AATAGAGGTTAGGCCC",2,34,3,2,2,43,636
"AATAGAGTCACCTTGC",0,5,2,0,2,9,235
"AATCACGAGAGAGAAC",0,2,0,0,0,2,91
"AATCACGAGAGTGGCT",0,3,0,0,0,3,83
"AATCACGAGATTAGTG",0,10,3,0,2,15,120
"AATCACGAGCGAGTAC",35,99,236,13,47,430,20699
"AATCACGAGCTTACGT",4,17,3,2,2,28,58
"AATCACGAGTCATAGA",1,16,6,4,6,33,641
"AATCACGCACAGAGCA",0,0,0,0,0,0,3
"AATCACGCAGCCCAGT",0,7,3,0,0,10,89
"AATCACGGTACCGCGT",2,12,5,0,5,24,418
"AATCACGGTATGCAAA",1,5,4,0,3,13,247
"AATCACGTCAGTGTCA",2,25,10,12,3,52,1726
"AATCACGTCTGTCGTC",0,0,0,0,0,0,8
"AATCGACAGAATAGTC",241,153,65,20,66,545,19444
"AATCGACAGAGCATAT",1,3,3,0,0,7,118
"AATCGACAGTTGGCGA",0,3,0,0,0,3,20
"AATCGACCAACTTCTT",1,9,2,0,0,12,203
"AATCGACCACCGAATT",0,7,2,0,0,9,154
"AATCGACCACTGAGTT",0,0,0,0,0,0,27
"AATCGACGTCCGGCAT",4,12,2,0,2,20,496
"AATCGACGTCTACTGA",1,9,0,0,0,10,351
"AATCGACTCAAGGAGC",17,94,31,95,26,263,10910
"AATCGACTCACCTCAC",0,18,4,0,0,22,560
"AATCGACTCAGTCATG",0,0,0,0,0,0,74
"AATCGACTCCTATTGT",2,9,3,0,2,16,351
"AATCGACTCCTTGACC",0,6,0,0,0,6,126
"AATCGACTCTCTCGCA",8,30,9,5,2,54,1008
"AATCGTGAGCAGCCTC",14,35,37,10,57,153,4468
"AATCGTGAGTCCGCGT",1,26,6,0,4,37,592
"AATCGTGCATCCGCGA",0,5,5,0,0,10,151
"AATCGTGCATGAGTAA",0,9,0,0,0,9,204
"AATCGTGGTACCTAAC",2,5,2,0,0,9,65
"AATCGTGGTAGTGCGA",9,42,42,4,54,151,8200
"AATCGTGGTTAAGTCC",2,3,3,0,3,11,149
"AATCGTGGTTCAACGT",4,40,7,4,11,66,1765
"AATCGTGTCCCATGGG",1,0,0,0,0,1,165
"AATGAAGAGACGAGCT",6,20,6,0,7,39,397
"AATGAAGAGAGTTCGG",14,48,99,9,27,197,8138
"AATGAAGAGTGCACCC",1,5,2,0,0,8,66
"AATGAAGAGTGCGACA",0,28,13,2,7,50,825
"AATGAAGCAAGACGAC",1,5,2,0,0,8,179
"AATGAAGCAAGATGTA",3,41,12,3,6,65,731
"AATGAAGCAATCGCCG",2,20,0,0,4,26,153
"AATGAAGGTCGCAACC",2,21,6,2,10,41,1369
"AATGAAGGTCGCTCGA",0,2,0,0,0,2,22
"AATGAAGTCGAGGCAA",0,9,3,0,5,17,181
"AATGAAGTCGCAAGAG",0,11,4,0,3,18,112
"AATGAAGTCTCCTGCA",180,1373,291,78,216,2138,94258
"AATGACCAGTACTGTC",206,354,188,807,173,1728,69546
"AATGACCAGTAGGTTA",1,27,6,0,2,36,574
"AATGACCGTACTGGGA",3,4,0,0,2,9,640
"AATGACCGTCCGAAGA",2,29,4,2,3,40,762
"AATGACCGTCCGTACG",8,51,14,0,11,84,6090
"AATGACCGTGGTCTCG",10,46,18,2,64,140,5831
"AATGACCTCTTCTGGC",0,4,2,0,0,6,429
"AATGCCAAGAGGCCAT",0,5,0,0,0,5,160
"AATGCCAAGCTTTCTT",0,3,0,0,0,3,17
"AATGGAAAGCGTTCAT",0,0,0,0,0,0,9
"AATGGAACAATAACGA",2,22,4,2,3,33,672
"AATGGAACACGACAGA",0,11,2,0,0,13,357
"AATGGAATCAAACCTG",34,50,20,19,15,138,5599
"AATGGAATCAAGAGTA",2,20,5,0,8,35,469
"AATGGAATCATCGCCT",0,5,0,0,0,5,46
"AATGGCTAGCAGTCTT",1,0,0,0,0,1,2
"AATGGCTCACGCGTGT",0,5,0,0,0,5,290
"AATGGCTCATAATCGC",0,0,2,0,2,4,180
"AATGGCTGTAAGAACT",0,3,3,0,4,10,179
"AATGGCTGTCACAGTT",1,5,0,0,2,8,147
"AATGGCTGTTCACCGG",1,6,3,0,0,10,196
"AATTCCTAGGTTTGAA",5,25,25,3,7,65,2621
"AATTCCTCACAGTCGC",0,5,0,0,0,5,136
"AATTCCTCACATATCG",1,9,0,0,0,10,194
"AATTCCTCAGGGAATC",1,4,2,0,0,7,290
"AATTCCTGTGCATTAC",359,165,98,49,90,761,29293
"AATTCCTGTTTACACG",1,2,0,0,5,8,163
"AATTCCTTCAAAGCCT",220,661,182,60,155,1278,71073
"AATTCCTTCATAGCAC",0,24,7,3,5,39,679
"AATTCCTTCCCATAGA",2,12,2,0,4,20,384
"AATTTCCAGATACATG",4,36,15,4,39,98,3686
"AATTTCCAGGAACGAA",0,0,0,0,0,0,110
"AATTTCCAGGCACAAC",0,7,5,0,2,14,168
"AATTTCCAGGCTCCCA",2,14,0,2,4,22,489
"AATTTCCGTGCGGCTT",0,5,0,0,0,5,124
"AATTTCCGTGGAACCA",4,31,6,0,0,41,709
"ACAAAGAAGACGACGT",1,20,9,0,0,30,565
"ACAAAGAAGAGGTCGT",0,0,0,0,0,0,4
"ACAAAGAAGTAAGAGG",0,11,0,0,0,11,137
"ACAAAGACAAGAGTAT",0,7,0,0,0,7,41
"ACAAAGACACAACGTT",18,54,94,6,71,243,12108
"ACAAAGACAGCCGTTG",0,6,4,2,2,14,302
"ACAACCAAGATGTTGA",3,25,5,0,0,33,273
"ACAACCACATTCCTCG",2,6,3,0,2,13,343
"ACAACCAGTATGTCAC",5,26,7,0,0,38,1144
"ACAACCAGTTTCACAG",4,37,7,3,7,58,152
"ACAACCATCAACCGAT",0,6,2,0,0,8,161
"ACAACCATCTAGAACC",2,8,5,0,3,18,150
"ACAAGCTAGACATGCG",0,6,0,0,0,6,81
"ACAAGCTAGTACAGCG",5,34,14,7,30,90,3209
"ACAAGCTCATACCAGT",138,619,159,42,111,1069,52316
"ACAAGCTCATGGGTTT",1,5,4,0,0,10,154
"ACAAGCTGTAGAGACC",6,27,5,0,3,41,816
"ACAAGCTGTAGCTGCC",0,0,0,0,3,3,26
"ACAAGCTTCAATGCAC",4,24,3,0,0,31,627
"ACAAGCTTCCTTATGT",31,126,305,18,62,542,28996
"ACAAGCTTCGGCCTTT",218,1463,469,122,328,2600,123386
"ACAAGCTTCGGTTAGT",24,92,32,13,99,260,10250
"ACACAGTAGACGGAAA",2,10,2,0,5,19,374
"ACACAGTCAAATCAGA",0,5,2,0,0,7,206
"ACACAGTCATGATCTG",1,19,12,0,6,38,1043
"ACACAGTGTATCGCTA",3,32,9,0,6,50,963
"ACACAGTGTCTGCCTT",8,35,48,6,9,106,4327
"ACACAGTGTGCATACT",5,16,5,2,6,34,2394
"ACACAGTTCATGAGTC",1,20,4,0,6,31,547
"ACACAGTTCGGCGATC",0,2,0,0,0,2,87
"ACACCAAAGGTTGCCC",0,5,2,0,0,7,148
"ACACCAACAATCGAAA",1,4,0,0,0,5,28
"ACACCAACATAGGTAA",0,8,4,0,0,12,198
"ACACCAATCATTGTTC",249,1972,509,130,396,3256,114406
"ACACCAATCGTGCATA",36,113,293,15,50,507,28322
"ACACGCGAGACAGCGT",3,26,12,2,6,49,1008
"ACACGCGAGACCAAGC",17,101,29,7,25,179,5937
"ACACGCGAGTCGAAGC",0,6,0,0,0,6,101
"ACACGCGAGTGTGTTC",0,23,3,0,3,29,91
"ACACGCGCAAACAGGC",1,0,0,0,0,1,259
"ACACGCGCACAAGCTT",24,251,75,17,49,416,17976
"ACACGCGGTAATTGGA",2,14,5,0,2,23,410
"ACACGCGGTGAATGAT",3,17,6,0,3,29,372
"ACACGCGGTGACGTCC",3,41,8,3,5,60,828
"ACACGCGGTGGCGTAA",0,6,5,0,0,11,108
"ACACGCGTCCAACTGA",25,69,166,11,31,302,12052
"ACACGCGTCTCTCAAT",0,6,0,0,0,6,110
"ACACTGAAGCAGAAAG",0,0,2,0,0,2,129
"ACACTGAAGCCAAGTG",3,5,3,0,3,14,442
"ACACTGACAAAGTGTA",2,15,5,3,5,30,623
"ACACTGAGTGGTTCTA",0,2,3,0,0,5,42
"ACACTGATCCACCTCA",2,24,6,0,3,35,760
"ACACTGATCCAGTGTA",10,43,31,5,13,102,3264
"ACACTGATCCCTAGGG",0,2,0,0,0,2,53
"ACACTGATCGATGGAG",244,1829,406,133,360,2972,150850
"ACAGAAAAGATCACCT",1,25,6,0,8,40,779
"ACAGAAAAGGATTTAG",0,3,2,0,0,5,276
"ACAGAAACAACCGTGC",0,3,0,0,0,3,58
"ACAGAAACAATTGAAG",13,58,24,9,112,216,11624
"ACAGAAACACCTTCCA",115,893,208,63,171,1450,72809
"ACAGAAACAGCTCTGG",11,43,76,4,19,153,7871
"ACAGAAAGTATCACCA",2,0,0,0,2,4,156
"ACAGAAAGTTGACGGA",1,6,0,0,0,7,68
"ACAGAAATCAGGAACG",0,9,0,0,0,9,149
"ACAGAAATCATAGAGA",0,3,2,0,0,5,22
"ACAGAAATCCATTCGC",0,5,2,0,0,7,143
"ACAGAAATCGAGATGG",1,0,0,0,0,1,4
"ACAGCCGAGGCGAAGG",0,0,0,0,0,0,15
"ACAGCCGCAGACAATA",1,5,0,0,0,6,402
"ACAGCCGCATACCAGT",0,0,0,0,0,0,7
"ACAGCCGCATAGACTC",0,2,2,0,2,6,110
"ACAGCCGCATTGAGCT",0,6,0,0,2,8,85
"ACAGCCGGTTAGGAGC",2,4,0,0,0,6,140
"ACAGCCGGTTCCTAAG",3,21,5,3,4,36,113
"ACAGCCGTCACGTCCT",106,691,188,58,138,1181,58813
"ACAGCCGTCAGCGGAA",0,4,3,0,2,9,156
"ACAGCCGTCATGCCGG",3,26,23,4,7,63,2276
"ACAGGGAAGCGGATCA",0,4,0,0,0,4,54
"ACAGGGAAGCGTGAAC",0,0,0,0,0,0,18
"ACAGGGAAGCTTCATG",4,29,8,3,23,67,3193
"ACAGGGACAGCAGTGA",0,9,0,0,2,11,66
"ACAGGGACATCCCACT",1,5,0,0,0,6,92
"ACAGGGACATGGCGCT",0,0,0,0,0,0,61
"ACAGGGATCCGCGATG",0,5,0,0,2,7,220
"ACATCCCAGCACGTCC",0,3,0,0,0,3,33
"ACATCCCCAAGAATGT",0,4,0,0,2,6,319
"ACATCCCCACATACTG",5,17,7,2,7,38,715
"ACATCCCGTGCTCTCT",0,0,0,0,0,0,3
"ACATCCCTCAGGAACG",1,0,0,0,0,1,41
"ACATCCCTCCAAGCAT",2,20,9,2,0,33,604
"ACATCCCTCTCTAAGG",0,3,0,0,0,3,72
"ACATCGAAGAGCCGAT",3,15,2,2,2,24,405
"ACATCGACATGCAGGA",1,13,0,0,3,17,630
"ACATCGACATTCGATG",0,13,0,0,2,15,659
"ACATCGAGTCGTCGGT",0,0,0,0,0,0,24
"ACATCGATCGTAGTGT",0,0,0,0,0,0,111
"ACATCGATCTAACGGT",3,9,3,0,2,17,166
"ACATCGATCTGATGGT",0,5,3,0,0,8,202
"ACATGCAAGTCATTGC",0,6,0,0,0,6,91
"ACATGCACAACACACT",3,28,4,0,3,38,737
"ACATGCAGTGTTAACC",28,49,27,6,8,118,5508
"ACATGCAGTTCGGGTC",2,16,4,0,3,25,537
"ACATGCATCACAATGC",22,143,43,96,41,345,13961
"ACATGCATCACCGACG",1,19,3,0,5,28,471
"ACATTTCTCGCTACGG",2,20,6,0,5,33,1132
"ACATTTCTCGTGTGAT",0,3,2,0,0,5,31
"ACCAAACAGTGGACTG",1,22,0,3,5,31,805
"ACCAAACCAATGAACA",2,65,15,2,8,92,4554
"ACCAAACCAGGCACAA",0,0,0,0,0,0,5
"ACCAAACCATCTTCGC",0,4,0,0,0,4,89
"ACCAAACCATTGACTG",1,5,0,0,0,6,156
"ACCAAACGTATCTTCT",11,90,25,2,26,154,198
"ACCAAACGTATGTCCA",136,286,87,27,80,616,26652
"ACCAAACTCATCCCGT",0,7,2,0,0,9,145
"ACCAAACTCATTGCTT",0,3,0,0,2,5,138
"ACCAACAAGCCAGAGT",6,38,58,4,21,127,5562
"ACCAACAAGCGGGTAT",0,5,2,0,2,9,83
"ACCAACAAGTCGGGAT",1,4,2,0,3,10,169
"ACCAACAGTTACCCAA",0,3,0,0,0,3,145
"ACCAACATCCTGTACC",1,10,2,0,0,13,454
"ACCAACATCTAGCATG",7,43,6,3,4,63,1405
"ACCAACATCTTTGGAG",0,7,0,0,0,7,87
"ACCACAAAGTGATCGG",1,10,0,0,0,11,170
"ACCACAACAACATACC",1,3,0,0,0,4,83
"ACCACAACAACTGGTT",4,19,8,0,4,35,923
"ACCACAACACTGGACC",15,48,84,7,23,177,8477
"ACCACAACAGGCATGA",0,0,0,0,2,2,13
"ACCACAAGTCGGCACT",5,14,3,2,4,28,935
"ACCACAAGTGAGCTCC",0,3,0,0,0,3,71
"ACCACAAGTTAAGTCC",16,60,27,5,91,199,10249
"ACCATTTAGAGTCTTC",160,446,1274,71,243,2194,113036
"ACCATTTAGATCACCT",13,34,22,0,8,77,1351
"ACCATTTAGATGTTAG",2,7,4,0,2,15,197
"ACCATTTCACAGTGTT",4,30,7,3,6,50,813
"ACCATTTGTAAGGCTG",0,19,6,0,4,29,370
"ACCATTTGTTAGCTAC",60,442,95,35,77,709,29851
"ACCATTTTCATTCGGA",2,26,5,0,5,38,522
"ACCATTTTCGCTCATC",1,5,0,0,0,6,132
"ACCCAAAAGATTGCGG",1,7,0,0,2,10,122
"ACCCAAAAGGCTAACG",21,44,17,2,44,128,3392
"ACCCAAACAAACCGGA",1,11,2,0,0,14,240
"ACCCAAACAACGACAG",0,2,0,0,0,2,38
"ACCCAAACAGAAATCA",0,5,0,0,3,8,126
"ACCCAAACAGACCCGT",1,7,0,0,0,8,444
"ACCCAAAGTCAGACGA",4,20,33,2,8,67,2463
"ACCCAAATCCTCACGT",0,4,0,0,0,4,212
"ACCCTCAAGAGTGTGC",5,65,12,2,15,99,3428
"ACCCTCAAGCAACAAT",0,0,0,0,0,0,30
"ACCCTCACAGCAGTGA",1,7,0,0,3,11,370
"ACCCTCACAGCCTATA",6,40,73,5,18,142,7443
"ACCCTCAGTCGTGGAA",2,29,4,2,2,39,715
"ACCCTCAGTCTAATCG",1,2,0,0,0,3,51
"ACCCTCAGTGAATTGA",0,8,3,0,0,11,100
"ACCCTCAGTTGCATTG",1,6,0,0,0,7,465
"ACCCTTGAGATACCAA",1,11,4,0,4,20,151
"ACCCTTGAGGCAGTCA",0,3,3,0,0,6,95
"ACCCTTGCACCGTGGT",0,15,4,0,13,32,1869
"ACCCTTGCAGAACCGA",1,5,0,0,0,6,119
"ACCCTTGCAGATCATC",0,8,3,0,0,11,70
"ACCCTTGCATCATCCC",1,17,2,0,6,26,613
"ACCCTTGGTAGACACG",15,62,36,8,127,248,15548
"ACCCTTGTCGCCGTGA",4,23,28,0,10,65,2459
"ACCGTTCCATGGCACC",0,4,0,0,2,6,324
"ACCGTTCGTGCCGTAC",2,8,5,0,0,15,289
"ACCGTTCTCATGAGTC",0,7,0,0,0,7,249
"ACCGTTCTCGCTGACG",1,2,3,0,3,9,361
"ACCTACCAGGCAGCTA",1,6,2,0,0,9,118
"ACCTACCCACGTTGGC",1,4,0,0,0,5,106
"ACCTACCCACTGTGTA",19,82,17,8,17,143,5907
"ACCTACCGTGTCGCTG",0,0,0,0,0,0,3
"ACCTGAACACAATGTC",5,27,14,4,57,107,5417
"ACCTGAACACCTGAAT",3,27,10,0,6,46,796
"ACCTGAAGTACAGGTG",0,21,10,0,4,35,542
"ACCTGAAGTCCGCAGT",4,37,17,0,41,99,3670
"ACCTGTCAGCCTCTTC",5,31,17,3,59,115,6465
"ACCTGTCAGGAGGGTG",3,3,0,0,0,6,48
"ACCTGTCAGTGCAAAT",2,13,4,0,2,21,404
"ACCTGTCAGTTACGAA",1,13,2,0,0,16,604
"ACCTGTCAGTTGAAGT",6,41,78,5,11,141,7501
"ACCTGTCCACGCTGCA",1,17,2,0,3,23,166
"ACCTGTCCATGCAGCC",1,22,2,0,2,27,337
"ACCTGTCGTGAGATAT",10,59,146,8,30,253,11559
"ACCTGTCTCACATTGG",0,5,0,0,0,5,143
"ACCTGTCTCATGCCCT",1,8,3,0,0,12,265
"ACGATCAAGTAATTGG",4,17,8,0,5,34,690
"ACGATCACAACTTCTT",55,430,95,26,87,693,42832
"ACGATCACATCGGCCA",2,17,0,0,6,25,519
"ACGATCACATCTGCGG",4,19,4,0,5,32,546
"ACGATCACATGTGACT",0,0,0,0,0,0,30
"ACGATCAGTACCGGAA",156,205,56,24,63,504,26402
"ACGATCAGTCGATTCA",1,4,8,0,3,16,683
"ACGATCAGTCGGTAAG",77,592,129,42,111,951,51781
"ACGATCAGTGTCCAAT",0,5,2,0,0,7,610
"ACGATCATCGTTCATT",1,9,3,0,0,13,215
"ACGATGTCACACGTGC",0,7,6,0,4,17,807
"ACGATGTCACCTGTCT",1,3,2,0,0,6,123
"ACGATGTTCTCTTAAC",9,72,28,6,56,171,5163
"ACGCACGAGCTCGTGC",2,17,4,3,3,29,499
"ACGCACGCAAAGAACT",6,24,11,0,0,41,1257
"ACGCACGCATATCTGG",0,0,0,0,0,0,175
"ACGCACGCATCGTGGC",12,46,33,6,94,191,6902
"ACGCACGGTTGTCCCT",0,3,0,0,0,3,48
"ACGCACGTCACAATGC",8,29,12,0,37,86,3986
"ACGCACGTCTCTAGGA",0,0,0,0,0,0,22
"ACGGAAGCACGCTGAC",0,5,0,0,0,5,77
"ACGGAAGCAGTTCACA",0,9,0,0,2,11,101
"ACGGAAGTCCATTGCC",1,13,0,0,3,17,908
"ACGGAAGTCTCGTCAC",2,2,0,0,0,4,8
"ACGGGTCAGAGAATCT",0,10,2,0,0,12,111
"ACGGGTCAGTTGAATG",0,0,0,0,0,0,24
"ACGGGTCCAAAGTGTA",59,497,114,37,110,817,35869
"ACGGGTCCACTTTATC",5,7,3,0,3,18,586
"ACGGGTCCAGTAGAGC",1,25,7,0,6,39,458
"ACGGTCGAGAGACAAG",0,2,2,0,0,4,107
"ACGGTCGAGCTTCGTA",0,0,0,0,0,0,6
"ACGGTCGAGGAGAGTA",6,29,34,2,6,77,2254
"ACGGTCGAGTACAGAT",0,4,2,0,0,6,44
"ACGGTCGCACAGTCGC",3,18,10,0,2,33,817
"ACGGTCGCAGCCGTTG",0,9,0,0,0,9,298
"ACGGTCGGTAATGTGA",1,5,0,0,0,6,88
"ACGGTCGGTGTAAATG",1,10,0,0,0,11,227
"ACGGTCGTCTAGAGCT",1,2,0,0,0,3,11
"ACGGTCGTCTCGGTAA",0,5,3,0,0,8,119
"ACGGTTAAGAACAGGA",13,47,61,3,15,139,6553
"ACGGTTAAGATCGACG",4,12,3,2,3,24,325
"ACGGTTACACCAATTG",0,8,0,0,3,11,289
"ACGGTTACACCAGCTG",1,3,0,0,4,8,209
"ACGGTTACACTCAAGT",0,2,2,0,0,4,67
"ACGGTTACATCCTCAC",0,9,0,0,2,11,360
"ACGGTTAGTCGCATTA",0,4,3,0,0,7,97
"ACGGTTAGTTTGGGTT",4,28,8,2,5,47,445
"ACGGTTATCATCGACA",1,7,0,0,2,10,113
"ACGGTTATCCGACGGT",2,25,8,0,9,44,954
"ACGGTTATCGGTAACT",2,2,2,0,0,6,83
"ACGTAACAGATGTTGA",1,4,0,0,0,5,102
"ACGTAACAGCTCCGAC",112,42,26,14,18,212,7105
"ACGTAACAGGCAGCTA",49,134,334,30,93,640,33274
"ACGTAACAGGGACCAT",0,4,0,0,2,6,229
"ACGTAACCAACAAGAT",0,11,2,0,0,13,124
"ACGTAACCAAGAGTGC",3,18,3,0,4,28,73
"ACGTAACCACACTGGC",5,22,6,0,2,35,583
"ACGTAACCATATGCGT",0,3,2,0,0,5,111
"ACGTAACCATTGCTTT",2,14,8,0,0,24,608
"ACGTAACGTACAGCGA",4,22,6,0,4,36,560
"ACGTAACGTCGAGCAA",0,0,0,0,0,0,19
"ACGTACAAGTCCCAGC",1,2,0,0,0,3,66
"ACGTACACACACCGAC",5,28,6,0,10,49,1832
"ACGTACACATGATAGA",2,25,6,0,0,33,389
"ACGTACATCCATTGCC",0,4,3,0,0,7,254
"ACGTAGTAGACCATTC",30,153,33,10,30,256,10345
"ACGTAGTAGCCTTTGA",20,131,30,8,30,219,10876
"ACGTAGTCACGACTAT",1,15,5,0,0,21,468
"ACGTAGTGTCGGTAAG",6,30,38,5,10,89,4142
"ACGTAGTGTTCCTAAG",9,83,23,38,23,176,4827
"ACGTCCTAGCCGTTAT",126,484,390,66,844,1910,86143
"ACGTCCTAGTTCACTG",1,15,5,0,5,26,469
"ACGTCCTCAGATCCAT",3,14,10,0,6,33,1226
"ACGTCCTGTATTTCGG",0,0,0,0,0,0,3
"ACGTCCTGTCTGTAAC",24,82,203,14,34,357,16490
"ACGTCCTTCCGTATGA",0,5,2,0,3,10,191
"ACGTCCTTCCTACACC",15,197,43,11,31,297,11647
"ACGTCCTTCGGTCTGG",23,19,8,7,6,63,3067
"ACGTTCCAGCGGCTCT",1,11,7,0,3,22,581
"ACGTTCCAGTACCCTA",0,5,2,0,0,7,189
"ACGTTCCCAAACTCTG",0,4,0,0,2,6,82
"ACGTTCCCACAATGAA",3,16,11,2,5,37,111
"ACGTTCCCACCCAAGC",0,2,0,0,4,6,189
"ACGTTCCCACGAGAAC",9,49,31,6,18,113,2083
"ACGTTCCCATGTACGT",0,7,0,0,2,9,126
"ACGTTCCGTCTCGGAC",5,31,48,0,12,96,4321
"ACGTTCCTCGACATCA",1,3,0,0,0,4,100
"ACGTTCCTCGCACGAC",1,4,0,0,0,5,90
"ACGTTCCTCGGCATAT",53,194,193,35,306,781,40210
"ACTACGAAGACATAAC",3,27,9,0,8,47,515
"ACTACGAAGGGCAGGA",2,17,3,0,2,24,368
"ACTACGACAAGAAATC",1,2,0,0,0,3,43
"ACTACGACAAGAGGCT",75,489,122,45,110,841,35632
"ACTACGACATTAGGAA",0,7,0,0,0,7,148
"ACTACGACATTCCTCG",1,7,0,0,0,8,142
"ACTATCTCAGAAGCTG",138,424,125,33,98,818,35787
"ACTATCTCATTCTCCG",0,3,0,0,0,3,193
"ACTATCTGTATTTCGG",5,18,8,2,4,37,448
"ACTATCTTCCGCGGAT",0,0,0,0,0,0,134
"ACTATGGAGACCATAA",0,16,2,0,3,21,89
"ACTATGGCAAGGGTCA",68,480,192,38,123,901,46045
"ACTATGGCAATCGCGC",0,2,0,0,0,2,53
"ACTATGGCACAGTGTT",0,8,0,0,2,10,143
"ACTATGGGTCCAGAAG",13,39,60,9,23,144,6131
"ACTATGGGTCTTGCTC",1,6,3,0,4,14,152
"ACTATGGTCCAAGCTA",4,19,5,2,6,36,665
"ACTATGGTCTACCACC",0,5,2,2,0,9,143
"ACTATTCAGTACTCGT",4,19,7,0,6,36,603
"ACTATTCCAATTCGTG",2,29,2,0,7,40,597
"ACTATTCGTCAAGTTC",6,36,14,4,18,78,2829
"ACTCCCAAGATGTTGA",55,221,93,25,298,692,35111
"ACTCCCAAGCCGAATG",2,25,6,0,10,43,1077
"ACTCCCACAAATACGA",1,12,6,0,5,24,779
"ACTCCCACACAAGGTG",1,3,0,0,0,4,73
"ACTCCCAGTACCCAGC",21,71,197,10,31,330,16240
"ACTCCCAGTACGGTTT",0,10,0,0,3,13,113
"ACTCCCAGTCGCCACA",0,4,0,0,0,4,207
"ACTCCCAGTTGTGTAC",1,17,6,2,4,30,645
"ACTCCCATCAGTGTTG",0,0,0,0,0,0,7
"ACTCCCATCGAGCCTG",0,6,3,0,0,9,96
"ACTCTCGAGACAGTCG",3,4,0,0,0,7,42
"ACTCTCGAGCTAGCCC",2,11,0,0,0,13,27
"ACTCTCGAGGGCAGGA",0,3,0,0,0,3,71
"ACTCTCGAGGTAATCA",87,521,135,45,121,909,43858
"ACTCTCGCACAACGCC",2,3,0,0,0,5,226
"ACTCTCGCACTCGATA",0,3,0,0,0,3,233
"ACTCTCGCAGTAACCT",4,34,8,2,7,55,2364
"ACTCTCGGTGGCATCC",250,135,68,21,55,529,18662
"ACTCTCGTCAAGTGGG",12,42,24,6,82,166,8178
"ACTCTCGTCACATTGG",2,8,4,0,0,14,165
"ACTCTCGTCCGTGCGA",0,6,0,0,4,10,251
"ACTCTCGTCTACTATC",4,8,3,0,4,19,625
"ACTCTCGTCTATGCCC",0,0,0,0,0,0,10
"ACTGATGAGACGGAAA",3,30,8,2,4,47,780
"ACTGATGAGTCCCGAC",3,18,9,2,3,35,527
"ACTGATGAGTGTACCT",0,3,0,0,0,3,60
"ACTGATGCATGATCTG",1,8,0,0,0,9,162
"ACTGATGGTCACGACC",0,2,0,0,0,2,46
"ACTGATGGTCCAGAAG",3,28,8,0,7,46,597
"ACTGATGGTGCTATTG",42,284,86,35,72,519,23548
"ACTGATGTCGAGAGAC",0,0,8,0,0,8,97
"ACTGCAAAGCATTGTC",1,6,4,0,0,11,95
"ACTGCAAGTATACAGA",0,4,0,0,0,4,39
"ACTGCAAGTTGCCGCA",0,9,3,0,0,12,123
"ACTGCAATCCAGTTCC",10,49,17,2,43,121,5304
"ACTGCAATCCTGCTAC",295,2329,591,168,464,3847,194655
"ACTGCAATCGGAATTC",1,20,6,0,4,31,623
"ACTGCAATCGTCCTTG",0,2,0,0,0,2,11
"ACTGCAATCTCGTGAA",0,0,0,0,0,0,106
"ACTGTCCAGAGCCGAT",124,547,204,842,180,1897,71820
"ACTGTCCGTTGATCGT",6,22,3,0,4,35,1931
"ACTGTCCTCAAATGCC",3,8,0,0,0,11,348
"ACTGTCCTCATAAGGA",69,609,123,39,113,953,50125
"ACTGTCCTCCTCTAAT",4,39,12,29,14,98,3500
"ACTGTGAAGCGGCTCT",44,337,82,19,66,548,25555
"ACTGTGAAGGTCGTAG",0,0,0,0,0,0,18
"ACTGTGACAAAGAGTT",1,11,5,0,3,20,209
"ACTGTGAGTACGGCAA",2,17,6,0,3,28,737
"ACTGTGAGTCTACTGA",1,10,3,0,3,17,138
"ACTGTGATCCATTGTT",2,25,11,4,3,45,920
"ACTGTGATCCGTTGAA",0,5,0,0,0,5,137
"ACTTAGGAGACATATG",5,17,0,0,7,29,239
"ACTTAGGCAAACAGGC",0,7,0,0,2,9,296
"ACTTAGGCAAAGCACG",8,44,15,9,36,112,3447
"ACTTAGGCAATCGTCA",1,10,3,0,2,16,231
"ACTTAGGGTCCGAAAG",1,3,2,0,4,10,136
"ACTTAGGTCCACGAAT",0,0,0,0,0,0,12
"ACTTAGGTCTCTTCAA",24,96,164,9,28,321,18541
"ACTTATCAGGGACTGT",84,669,153,41,119,1066,51701
"ACTTATCGTATAATGG",4,23,7,0,5,39,429
"ACTTATCGTCCACATA",2,3,0,0,2,7,160
"ACTTATCTCAACACGT",5,37,5,2,9,58,1124
"ACTTCCGAGGAGGGTG",46,281,95,14,54,490,27860
"ACTTCCGAGGCCACCT",4,12,5,0,2,23,703
"ACTTCCGAGGTTGCCC",7,60,13,2,12,94,4574
"ACTTCCGAGTGTTCCA",1,8,0,0,0,9,264
"ACTTCCGCACGCGCAT",1,3,3,0,0,7,206
"ACTTCCGGTGTGGACA",4,13,9,0,4,30,624
"ACTTCCGGTGTGTGGA",2,11,2,0,0,15,283
"ACTTCCGTCCAGCTCT",0,0,2,0,0,2,49
"ACTTCCGTCTACTTCA",21,22,10,2,9,64,2237
"ACTTCCGTCTAGAGCT",2,28,7,0,5,42,988
"ACTTCGCTCTGCAGCG",1,5,6,0,4,16,808
"ACTTTCAAGCTGGCCT",1,10,0,0,2,13,434
"ACTTTCAAGGCATTTC",1,8,0,2,2,13,23
"ACTTTCAAGGCTCACC",3,11,5,2,0,21,340
"ACTTTCAGTCAATCTG",0,3,0,0,0,3,144
"ACTTTCAGTCGAACGA",0,2,0,0,0,2,35
"ACTTTCAGTGCACATT",9,37,16,3,58,123,5224
"ACTTTCAGTTGACTAC",248,341,119,30,101,839,39342
"ACTTTCAGTTGCCAAT",0,12,2,0,0,14,324
"ACTTTCATCATCCTGC",18,199,46,10,36,309,13899
"ACTTTCATCATTCACT",58,240,77,15,81,471,16448
"ACTTTCATCGGCCCAA",0,2,2,0,0,4,36
"ACTTTCATCGTGGGAA",5,41,10,0,9,65,784
"ACTTTGTAGACGGATC",0,0,0,0,0,0,56
"ACTTTGTAGTATGATG",1,8,0,0,2,11,125
"ACTTTGTCACGACTAT",2,18,6,0,5,31,568
"ACTTTGTGTGACCGAA",0,2,0,0,0,2,84
"ACTTTGTTCGTTAGTG",0,7,0,0,0,7,113
"ACTTTGTTCTCCCTAG",1,5,2,0,0,8,62
"ACTTTGTTCTGTAACG",0,4,0,0,0,4,17
"AGAAATGCACAGCTGC",6,50,9,3,9,77,3168
"AGAAATGCAGCGAGTA",0,3,4,0,0,7,214
"AGAAATGGTTGGCCGT",0,0,0,0,0,0,2
"AGAAATGTCGCAATGT",3,12,3,0,0,18,218
"AGAACAACATAGGTAA",0,0,0,0,0,0,27
"AGAACAAGTGCCTATA",0,4,0,0,0,4,44
"AGAACAATCATTGTTC",0,2,0,0,0,2,42
"AGAACAATCCCTGGTT",163,703,318,671,526,2381,98931
"AGAACAATCCGCGATG",2,2,3,0,0,7,99
"AGAACAATCCTACGGG",0,9,0,0,0,9,319
"AGAACAATCGTTCCTG",7,5,2,0,0,14,1117
"AGAACCTAGGCCACTC",0,5,2,0,0,7,99
"AGAACCTCAATCTCTT",5,43,13,2,5,68,1132
"AGAACCTCAGAGGACT",53,489,117,44,98,801,41088
"AGAACCTCAGAGTGTG",0,3,2,0,0,5,95
"AGAACCTCAGATTTCG",0,7,2,0,2,11,162
"AGAACCTGTGCTGATT",4,15,3,0,7,29,684
"AGAACCTGTTGTATGC",5,11,0,0,3,19,434
"AGAACCTTCTATCGTT",3,23,4,0,5,35,1503
"AGAAGCGAGACGCAGT",3,22,8,2,3,38,690
"AGAAGCGCAAGGCTTT",1,11,4,0,0,16,169
"AGAAGCGCACGGTAGA",1,10,0,0,2,13,413
"AGAAGCGGTAGTCGGA",0,6,0,0,0,6,121
"AGAAGCGGTGACCTGC",0,0,0,0,0,0,17
"AGAAGCGGTTCTTAGG",42,266,60,12,45,425,16413
"AGAAGCGTCAGGACAG",1,3,0,0,0,4,27
"AGAAGCGTCCTTTAGT",23,80,16,2,11,132,4653
"AGAAGCGTCTCCCATG",1,15,0,0,0,16,54
"AGAAGCGTCTCTCGAC",1,6,0,0,0,7,125
"AGAAGTAAGTACAGCG",0,7,0,0,0,7,62
"AGAAGTAAGTCGTCTA",1,12,4,0,2,19,70
"AGAAGTAAGTGCTCGC",20,45,23,79,21,188,8051
"AGAAGTAGTATCGTGT",7,33,6,0,8,54,816
"AGAAGTAGTCTGTGAT",0,3,0,0,0,3,112
"AGAAGTAGTGGTTTGT",1,0,2,0,0,3,13
"AGAAGTATCGGTAGAG",0,6,3,0,0,9,98
"AGACAAAAGACGAAGA",5,20,9,2,9,45,627
"AGACAAAAGCGCATCC",4,34,39,2,8,87,2259
"AGACAAAAGGTGAGAA",1,0,0,0,0,1,26
"AGACAAACAATGTTGC",0,5,0,2,2,9,183
"AGACAAACATTAGGCT",0,5,4,2,0,11,247
"AGACAAACATTCTCTA",1,30,3,0,4,38,570
"AGACAAAGTAAGGCTG",8,37,9,2,14,70,3467
"AGACAAAGTATAATGG",0,6,0,0,0,6,48
"AGACAAAGTCACTCAA",0,15,3,2,3,23,723
"AGACAAAGTCCTTTGC",2,3,0,0,0,5,211
"AGACAAAGTCGTCGGT",14,88,199,16,88,405,17381
"AGACAAAGTTCCGCTT",3,3,2,0,2,10,464
"AGACAAATCAACCCGG",2,26,11,0,2,41,623
"AGACAAATCCAAGCCG",3,33,7,0,3,46,885
"AGACAAATCGGAGTAG",0,0,0,0,0,0,42
"AGACACTAGTACTGGG",11,57,31,8,79,186,7099
"AGACACTAGTCATAGA",112,605,127,40,109,993,48744
"AGACACTGTCTGTTAG",0,9,2,0,0,11,108
"AGACACTTCCTCAGGG",1,9,3,0,0,13,558
"AGACAGGAGGACTGGT",8,51,76,7,20,162,8108
"AGACAGGCACATGTTG",0,5,2,0,0,7,148
"AGACAGGCATGGGCAA",0,3,2,0,2,7,77
"AGACAGGGTTACAGCT",1,4,0,0,0,5,68
"AGACAGGTCGCACGAC",0,2,0,0,0,2,4
"AGACAGGTCGTTATCT",1,5,0,0,0,6,35
"AGACCATAGAGTCAGC",4,24,9,4,4,45,856
"AGACCATAGCTCGAAG",2,5,0,0,3,10,162
"AGACCATCAGAGTCAG",6,4,3,0,2,15,292
"AGACCCGAGCGTCTGC",0,0,0,0,0,0,42
"AGACCCGAGGGAGGCA",3,13,5,2,8,31,791
"AGACCCGCAAATGGTA",6,27,10,0,5,48,1143
"AGACCCGCAGACCATT",3,24,7,0,2,36,442
"AGACCCGCAGCCTATA",0,0,0,0,0,0,12
"AGACCCGGTAAGGTCG",4,28,16,2,53,103,4586
"AGACCCGTCCCTTTGG",0,7,0,0,0,7,159
"AGACTCACACTCAGAT",34,205,124,19,100,482,25875
"AGACTCACAGTCTTCC",1,21,2,0,11,35,358
"AGACTCACATCCTCAC",0,12,3,0,4,19,606
"AGACTCAGTGACAACG",3,28,5,3,5,44,625
"AGACTCATCGGTAAGG",4,37,3,0,5,49,945
"AGACTCATCTACTCAT",20,102,64,12,68,266,15581
"AGAGAATCAAATCGGG",5,43,12,2,20,82,1733
"AGAGAATCACAATTCG",0,13,2,0,0,15,103
"AGAGAATCAGACCGCT",3,26,12,3,6,50,794
"AGAGAATGTAGAGACC",0,0,0,0,0,0,4
"AGAGAATTCAGCTTGA",3,9,3,0,0,15,288
"AGAGAATTCGTTAGAC",3,13,40,0,6,62,4075
"AGAGAATTCTATCGCC",1,6,0,0,0,7,14
"AGAGAATTCTCTGGTC",20,63,127,12,40,262,12264
"AGAGAGCAGCTGCCAC",1,6,0,0,0,7,103
"AGAGAGCAGTGGGAAA",32,133,132,15,49,361,19207
"AGAGAGCAGTTACGGG",0,3,0,0,0,3,123
"AGAGAGCCAACCCTCT",60,451,153,20,73,757,37027
"AGAGAGCCAATCGCCG",0,2,2,0,0,4,224
"AGAGAGCCACCTGAAT",21,157,44,15,26,263,11075
"AGAGAGCTCCCGAAAT",2,15,7,0,5,29,455
"AGAGAGCTCCGGTAGC",3,24,5,0,5,37,942
"AGAGAGCTCGGCCCAA",32,133,65,15,176,421,19771
"AGAGAGCTCGTGCACG",0,0,0,0,0,0,11
"AGAGAGCTCTACTCAT",15,45,26,4,74,164,9375
"AGAGCAGAGATGGTCG",2,4,4,0,4,14,69
"AGAGCAGAGGTGCTTT",5,11,3,2,4,25,233
"AGAGCAGCATGGACAG",68,37,15,6,14,140,6575
"AGAGCAGGTACGGTTT",0,8,0,0,4,12,668
"AGAGCAGGTATGGTAA",2,8,4,0,0,14,104
"AGAGCAGGTCGAACGA",2,6,5,0,2,15,452
"AGAGCAGTCAGCTTGA",0,0,0,0,0,0,30
"AGAGCAGTCGACACCG",1,6,5,0,4,16,148
"AGAGCAGTCTGCTTTA",0,4,3,2,0,9,156
"AGAGCAGTCTTCCTAA",5,24,5,0,6,40,541
"AGAGCCCAGACCATTC",2,4,0,0,0,6,251
"AGAGCCCAGCTGTCCG",0,0,0,2,0,2,11
"AGAGCCCAGGCCTTCG",61,536,120,34,87,838,39287
"AGAGCCCAGTAGAATC",87,302,159,605,134,1287,48774
"AGAGCCCAGTTGGAGC",86,223,589,46,219,1163,58927
"AGAGCCCCACGATTCA",0,7,0,0,2,9,204
"AGAGCCCCAGACCATT",4,31,11,0,4,50,482
"AGAGCCCCAGCGAGTA",1,3,4,2,0,10,122
"AGAGCCCGTTCAACGT",0,0,0,0,0,0,21
"AGAGCCCTCACCCATC",0,2,0,0,0,2,20
"AGAGCCCTCACTGTCC",0,5,0,0,0,5,111
"AGAGCCCTCCACGGAC",0,3,0,0,0,3,199
"AGAGCCCTCCGGGACT",2,4,2,0,2,10,166
"AGAGCCCTCTGTACAG",6,22,10,5,6,49,917
"AGAGCCCTCTTTACAC",0,8,0,0,0,8,176
"AGATAGAGTACAGGTG",13,69,18,5,11,116,5517
"AGATAGAGTCACCACG",7,42,25,7,64,145,5300
"AGATAGAGTCTGCATA",1,5,3,0,0,9,220
"AGATAGAGTCTGGTTA",1,0,0,0,0,1,270
"AGATAGATCGACGACC",5,22,10,3,28,68,2717
"AGATCCAAGAAGTGTT",0,2,0,0,0,2,6
"AGATCCAAGCACCAGA",0,3,0,0,0,3,64
"AGATCCAAGCCTCGTG",0,0,0,0,0,0,40
"AGATCCACACCAGCTG",0,8,5,0,0,13,355
"AGATCCACATCACGGC",2,14,3,2,3,24,67
"AGATCCAGTAGTATAG",4,36,11,0,9,60,784
"AGATCCATCCATCTCG",0,5,0,0,0,5,92
"AGATCCATCGCTGTCT",0,6,0,0,0,6,266
"AGATCGTAGAAACCAT",68,532,152,45,117,914,47350
"AGATCGTAGGTCATTC",6,15,7,0,4,32,826
"AGATCGTCAATTGTGC",0,3,3,0,0,6,187
"AGATCGTCACCGAATT",0,8,0,0,0,8,241
"AGATCGTCACGCGCTA",2,21,5,0,8,36,673
"AGATCGTGTGAGATAT",0,7,2,0,0,9,193
"AGATCGTGTGGCACTC",0,8,2,0,3,13,250
"AGATCGTGTTGCTGAT",23,78,84,11,89,285,14549
"AGATCGTTCAGCAATC",2,9,0,0,0,11,203
"AGATCGTTCTCTCCGA",3,17,6,0,7,33,772
"AGATGAACAAGCGAGT",0,7,2,0,0,9,108
"AGATGAAGTAGGCTCC",6,37,6,0,24,73,2736
"AGATGAAGTTCCACGG",2,25,5,0,7,39,485
"AGATGAAGTTCGGTAT",3,24,9,5,8,49,1005
"AGATGAATCAACCTTT",6,40,7,4,7,64,811
"AGATGCTAGCACACCC",50,142,32,8,21,253,10540
"AGATGCTCACAACGTT",0,3,0,0,0,3,74
"AGCATCAAGCGTACAG",2,6,0,0,0,8,173
"AGCATCAAGTGTTGTC",0,4,2,0,3,9,106
"AGCATCACAAATTGCC",2,7,0,0,0,9,586
"AGCATCACAAGAGATT",2,26,7,2,6,43,410
"AGCATCAGTACCCGAC",1,6,0,0,0,7,259
"AGCATCAGTAGCTGAG",0,3,0,0,0,3,4
"AGCATCAGTATGTCTG",1,3,3,0,0,7,238
"AGCATCAGTCTTACAG",64,172,157,29,397,819,35656
"AGCATCATCAATCTTC",1,4,2,0,0,7,146
"AGCATCATCGACGATT",0,4,0,0,0,4,63
"AGCCAATAGCACTCAT",9,59,16,6,11,101,4344
"AGCCAATAGCCACAAG",0,3,0,0,0,3,63
"AGCCAATCACAGACGA",0,5,0,0,2,7,233
"AGCCAATGTCATAGTC",28,90,133,15,92,358,17467
"AGCCAATGTGTGGACA",2,3,2,0,0,7,136
"AGCCAATGTTAGGCCC",3,22,5,4,4,38,1017
"AGCCAATTCATCACAG",0,16,5,0,3,24,144
"AGCCAATTCGAACCAT",2,34,6,0,5,47,666
"AGCCACGAGAGCTGCA",3,18,7,0,5,33,135
"AGCCACGAGATTGACA",0,9,0,0,0,9,253
"AGCCACGAGGTCGTCC",1,2,5,0,0,8,427
"AGCCACGAGTCATCGT",1,8,0,0,0,9,271
"AGCCACGCAAAGACTA",0,2,0,0,0,2,31
"AGCCACGCAACCGATT",13,47,23,4,72,159,7696
"AGCCACGCACAAATGA",2,21,5,0,10,38,1543
"AGCCACGGTAATACCC",0,5,2,0,4,11,162
"AGCCACGTCTCTATAC",0,4,0,0,0,4,132
"AGCCAGCCAAGATGTA",1,12,11,0,4,28,382
"AGCCAGCCAAGCCCAC",0,4,0,0,0,4,133
"AGCCAGCCACTTGGCG",2,35,8,0,10,55,2404
"AGCCAGCCATATGAAG",1,3,0,0,0,4,177
"AGCCAGCGTAGGTAGC",0,5,0,0,0,5,174
"AGCCAGCGTGAATGTA",1,5,0,0,3,9,314
"AGCCAGCGTGTCTTCC",0,2,2,0,0,4,252
"AGCCAGCTCACTTCTA",1,13,3,2,0,19,529
"AGCCAGCTCCGCAGTG",3,13,5,0,6,27,555
"AGCGATTCAGACCTAT",1,12,4,2,4,23,557
"AGCGATTCAGTACTAC",3,13,6,2,5,29,179
"AGCGATTCATGCGGTC",3,19,5,2,23,52,1564
"AGCGATTGTAGGAAAG",0,3,0,0,0,3,59
"AGCGATTGTATGCTAC",35,278,88,21,58,480,19095
"AGCGATTGTGGAGAAA",0,0,0,0,0,0,17
"AGCGATTGTTACGATC",1,4,0,0,0,5,46
"AGCGATTTCATGGCCG",0,14,7,2,2,25,784
"AGCGCCAAGAGGTTTA",0,6,0,0,0,6,187
"AGCGCCAAGCTCGTGC",122,171,48,12,46,399,20005
"AGCGCCACAGAAACCG",1,3,3,0,0,7,201
"AGCGCCACAGGGTTGA",4,21,7,2,2,36,1063
"AGCGCCACAGTAGTGG",2,20,13,0,4,39,1086
"AGCGCCACAGTGCGCT",0,3,0,0,0,3,14
"AGCGCCAGTATGTCCA",0,8,0,0,0,8,150
"AGCGCCAGTCGTTTCC",350,4758,590,1084,506,7288,169070
"AGCGCCATCTGTAACG",0,2,0,0,2,4,96
"AGCGCTGAGTAACGAT",15,159,33,12,25,244,13022
"AGCGCTGAGTGAGCCA",58,439,128,33,95,753,37621
"AGCGCTGCAACAACAA",3,22,5,0,7,37,611
"AGCGCTGGTCACGCTG",1,4,0,0,3,8,212
"AGCGCTGTCCATTCAT",1,16,7,0,5,29,469
"AGCGCTGTCGTGCATA",0,2,0,0,0,2,16
"AGCGCTGTCTAACGCA",0,19,5,0,3,27,700
"AGCGTATCAAAGCTAA",1,0,0,0,0,1,69
"AGCGTATCATGGAATA",1,20,9,0,3,33,518
"AGCGTATGTACGATTC",706,334,190,53,176,1459,66122
"AGCGTATGTCAGCTTA",32,80,141,10,106,369,18765
"AGCGTATGTGGTCAAG",0,5,3,0,2,10,91
"AGCGTATTCCAAGCAT",0,7,0,0,0,7,145
"AGCGTATTCCTCTCGA",1,18,5,0,2,26,562
"AGCGTATTCTGCCTCA",0,3,0,0,0,3,79
"AGCGTCGAGGTCACCC",0,0,0,0,0,0,1
"AGCGTCGAGTGGAAGA",0,0,0,0,0,0,15
"AGCGTCGCAGGCACTC",28,125,134,10,280,577,9783
"AGCGTCGTCACACCCT",0,0,0,0,0,0,0
"AGCGTCGTCTCGGTAA",0,0,0,0,0,0,2
"AGCGTCGTCTCTCAAT",0,3,23,0,6,32,139
"AGCTACAAGGCGCTTC",0,3,0,0,0,3,211
"AGCTACAAGTGACCTT",13,96,22,7,17,155,5297
"AGCTACACAGTCTTCC",3,27,5,4,5,44,1205
"AGCTACAGTACAGTTC",0,0,0,0,0,0,51
"AGCTACAGTATTGAGA",2,6,2,0,2,12,298
"AGCTACAGTATTTCGG",2,14,4,0,3,23,564
"AGCTACAGTCATCCCT",1,5,0,2,0,8,280
"AGCTACAGTCCACATA",1,3,0,0,0,4,156
"AGCTACAGTGCGGTAA",0,29,10,2,0,41,776
"AGCTACAGTGGACCTC",8,66,14,4,16,108,4671
"AGCTACATCCCATACC",1,3,0,0,3,7,132
"AGCTACATCCGAAATC",0,31,6,0,8,45,827
"AGCTACATCCGCTGTT",0,4,0,0,0,4,142
"AGCTCAAAGCTAAGTA",3,17,2,0,3,25,906
"AGCTCAAAGGTCCCGT",160,72,35,12,24,303,12305
"AGCTCAAGTGACAACG",1,0,0,0,2,3,234
"AGCTTCCCAAGTTGGG",4,28,5,0,5,42,896
"AGCTTCCCAGAAGCGT",27,35,12,2,7,83,3228
"AGCTTCCGTACGTAGG",4,20,8,3,6,41,588
"AGCTTCCGTCGTAATC",0,0,0,0,0,0,2
"AGCTTCCGTTCCGTTC",6,36,17,0,5,64,1963
"AGCTTCCGTTCTCCAC",0,2,2,0,0,4,99
"AGCTTCCTCCACCTGT",23,148,24,2,24,221,9178
"AGGAAATAGAAGAGCA",3,31,15,4,20,73,2360
"AGGAAATAGTCATACC",0,4,0,0,0,4,73
"AGGAAATCAATTGTGC",1,7,0,0,0,8,177
"AGGAAATCACTTGGCG",0,2,0,0,0,2,33
"AGGAAATGTCACAGAG",9,34,53,0,13,109,4903
"AGGAAATGTCCCTGTT",1,22,4,0,0,27,550
"AGGAAATGTGTTAAAG",5,20,2,3,2,32,507
"AGGAAATGTTCGTAAC",1,15,3,0,5,24,656
"AGGAATAAGGAGAGTA",3,25,4,3,5,40,447
"AGGAATAAGTTGCGCC",0,0,2,0,0,2,173
"AGGAATACACAAGCCC",1,7,0,0,2,10,32
"AGGAATACACTTGGGC",0,5,0,0,0,5,255
"AGGAATAGTATGAGGC",31,196,52,17,40,336,14361
"AGGAATATCCGTATAG",0,4,4,0,0,8,113
"AGGAATATCGGAATTC",59,381,85,23,76,624,28578
"AGGAATATCGTCGATA",1,2,0,0,0,3,28
"AGGAATATCTGTCCCA",0,0,0,0,0,0,9
"AGGACGAAGATGCTGG",5,19,8,0,0,32,107
"AGGACGACAAATGAAC",0,2,0,0,0,2,14
"AGGACGAGTCACGACC",345,1564,493,110,360,2872,130236
"AGGACGAGTCCATAGT",0,4,0,0,0,4,130
"AGGACGAGTGTGTGTT",1,3,2,0,0,6,153
"AGGACGATCACCTACC",2,28,6,0,6,42,937
"AGGACGATCGCTAATG",5,16,0,0,6,27,67
"AGGACGATCTGGTTGA",1,29,11,0,7,48,737
"AGGACTTAGAGCCCAA",1,7,3,0,0,11,181
"AGGACTTAGGTCCTGC",0,2,0,0,0,2,11
"AGGACTTGTGGATACG",129,326,100,30,103,688,31819
"AGGACTTTCCAGCCTT",10,64,18,3,16,111,3026
"AGGACTTTCCCAGGAC",18,156,43,6,18,241,12036
"AGGACTTTCCTTTAGT",20,137,41,12,30,240,14330
"AGGAGGTAGCCTGTCG",0,0,0,0,0,0,47
"AGGAGGTAGGCCGCTT",2,7,0,0,3,12,233
"AGGAGGTAGGTAGTAT",0,0,0,0,2,2,17
"AGGAGGTCACTGATTG",0,6,0,0,0,6,218
"AGGAGGTCAGACCCGT",0,7,0,0,2,9,127
"AGGAGGTTCGTGGAAG",1,6,0,0,2,9,149
"AGGAGGTTCTTCCCGA",0,0,0,0,0,0,5
"AGGATAAAGGTCTACT",1,3,0,0,0,4,90
"AGGATAAAGTGCGACA",0,10,3,0,0,13,198
"AGGATAACAAACCGGA",0,4,0,0,2,6,146
"AGGATAAGTTTCCCAC",2,30,6,0,5,43,640
"AGGATAATCCCGATCT",26,89,210,10,39,374,17719
"AGGATCTAGAGTCTTC",0,4,2,0,0,6,192
"AGGATCTCAACAGTGG",2,6,4,0,2,14,542
"AGGATCTCACAATGCT",2,8,0,0,0,10,56
"AGGATCTCAGAACATA",0,4,0,0,0,4,142
"AGGATCTCAGTCTTCC",0,2,0,0,0,2,17
"AGGATCTGTCGTTGCG",0,6,3,0,0,9,119
"AGGATCTGTTAGGGAC",0,18,2,0,4,24,98
"AGGATCTTCACTAGCA",3,31,6,4,6,50,935
"AGGATCTTCCAGTGTA",0,0,0,0,0,0,7
"AGGATCTTCGCGCCAA",4,15,0,0,2,21,559
"AGGATCTTCGGCTTGG",0,9,16,2,3,30,1393
"AGGCATTAGGGCAACT",3,12,3,0,7,25,1003
"AGGCATTCATCGTGCG",0,3,2,0,2,7,163
"AGGCATTGTAACAGGC",2,22,7,2,4,37,592
"AGGCATTGTTACACTG",0,12,2,0,2,16,386
"AGGCATTGTTCGGGTC",0,4,4,0,0,8,84
"AGGCATTTCTGCCCTA",145,76,41,14,24,300,13474
"AGGCCACAGATCCCAT",30,174,68,20,40,332,12613
"AGGCCACAGGTTACAA",2,28,5,0,6,41,971
"AGGCCACAGTCTTCGA",0,0,0,0,0,0,4
"AGGCCACGTTCAGCGC",4,25,9,5,35,78,3213
"AGGCCACTCGTTTACT",130,1030,218,52,161,1591,85249
"AGGCTGCCACGGATCC",0,5,0,0,0,5,24
"AGGCTGCCATGTTTGG",4,17,4,0,3,28,617
"AGGCTGCCATTGCCTC",2,11,7,0,0,20,376
"AGGCTGCGTTTCGACA",2,19,10,0,8,39,454
"AGGCTGCTCCCGAGGT",1,6,4,0,0,11,73
"AGGGAGTAGCATGCAG",0,0,0,0,0,0,14
"AGGGAGTAGGATACCG",1,14,7,0,3,25,406
"AGGGAGTCAGCAGAAC",0,8,0,0,0,8,194
"AGGGAGTCAGTAGATA",1,7,2,0,2,12,85
"AGGGAGTCATCGCTCT",0,5,3,0,2,10,79
"AGGGAGTGTAGGTCAG",2,14,4,0,2,22,284
"AGGGAGTGTGACATCT",2,16,3,3,2,26,364
"AGGGAGTGTGCAACAG",1,12,4,3,5,25,293
"AGGGCCTAGCCGTTGC",1,7,6,0,4,18,585
"AGGGCCTAGTCAGCGA",2,23,7,3,3,38,842
"AGGGCCTCACTCCACT",5,10,6,0,3,24,944
"AGGGCCTCATTCTCCG",0,5,3,0,2,10,370
"AGGGCCTGTGTGGTCC",0,9,4,2,2,17,456
"AGGGCCTTCCTTCACG",2,6,2,0,0,10,742
"AGGGCTCAGCCTATTG",5,5,5,2,2,19,411
"AGGGCTCAGTGAGGTC",1,22,5,0,3,31,661
"AGGGCTCCAATCGCGC",3,22,10,2,5,42,1040
"AGGGCTCGTATTTCTC",4,20,4,0,5,33,458
"AGGGCTCGTGATATAG",3,21,8,2,4,38,373
"AGGGCTCGTGCACATT",6,46,11,0,8,71,3339
"AGGGCTCTCAGTGATC",0,4,0,0,0,4,53
"AGGGCTCTCCCGTTCA",6,21,7,0,5,39,1084
"AGGGTCCAGGTTCATC",2,20,11,0,4,37,433
"AGGGTCCCAATTCTCT",0,10,2,0,2,14,127
"AGGGTCCCATCGCTGG",2,17,6,0,5,30,567
"AGGGTCCTCAACTGAC",1,4,2,0,0,7,135
"AGGGTCCTCCCTGTTG",3,16,5,0,3,27,132
"AGGGTCCTCGAGAAGC",1,18,6,2,4,31,918
"AGGGTGAAGCCTTTGA",2,24,8,3,3,40,140
"AGGGTGACACACACGC",2,22,6,0,6,36,672
"AGGGTGACATCGCTAA",0,2,0,0,0,2,58
"AGGGTGATCGAGAGCA",0,3,2,0,0,5,15
"AGGGTTTCAATTCGTG",5,5,0,0,2,12,173
"AGGGTTTCACACTTAG",3,30,4,0,3,40,531
"AGGGTTTGTATAGCTC",0,0,0,0,0,0,11
"AGGGTTTGTGTTACAC",1,6,3,0,0,10,181
"AGGGTTTTCAAAGCCT",1,5,0,0,0,6,104
"AGGGTTTTCAGACCCG",0,4,0,0,0,4,240
"AGGGTTTTCGATTGGT",2,8,0,0,0,10,120
"AGGGTTTTCTAGCATG",21,52,33,4,110,220,9632
"AGGGTTTTCTCGTGGG",0,6,0,0,0,6,100
"AGGTAGGAGAGAAGGT",0,3,0,0,2,5,169
"AGGTAGGAGATAGCTA",12,42,23,6,49,132,4968
"AGGTAGGCAGTTTCGA",51,452,97,26,78,704,33571
"AGGTAGGGTGACAGGT",0,5,3,0,0,8,113
"AGGTAGGGTGGAACAC",0,2,0,0,0,2,107
"AGGTAGGGTTAAGGAT",12,35,41,4,17,109,5041
"AGGTCATAGATGCTGG",18,79,207,13,35,352,15674
"AGGTCATGTCGGAACA",162,852,689,77,647,2427,117817
"AGGTCATGTGATTGGG",0,2,2,0,3,7,67
"AGGTCATTCCACTTTA",0,0,0,0,0,0,8
"AGGTCATTCCTATTTG",1,11,4,0,2,18,326
"AGGTCATTCGACCTAA",0,3,3,7,2,15,518
"AGGTCATTCTTTGCAT",0,7,0,0,0,7,140
"AGGTCTAAGTGAGGCT",0,0,0,2,0,2,5
"AGGTCTACAAGCGCAA",1,2,0,0,0,3,35
"AGGTCTATCCACACAA",1,19,4,0,0,24,432
"AGGTCTATCTCGAGTA",1,6,3,0,0,10,164
"AGGTGTTAGACAACTA",3,25,5,0,6,39,548
"AGGTGTTAGACAAGCC",0,16,3,0,6,25,588
"AGGTGTTAGAGAGGGC",13,94,56,7,23,193,10299
"AGGTGTTAGTGCTAGG",15,77,27,5,24,148,4188
"AGGTGTTCACACTTAG",3,22,7,0,3,35,587
"AGGTGTTCATGTGGTT",510,912,281,80,258,2041,96242
"AGGTTACAGAGGTTAT",2,3,0,0,2,7,91
"AGGTTACAGGCGTTGA",1,7,8,0,3,19,460
"AGGTTACAGTTGGCTT",1,5,0,0,0,6,99
"AGGTTACGTAGAGCTG",3,6,0,0,3,12,97
"AGGTTGTAGGTCCTGC",52,362,111,104,77,706,33259
"AGGTTGTAGTGCACAG",16,49,39,6,111,221,11570
"AGGTTGTAGTTCACTG",1,3,0,0,4,8,163
"AGGTTGTCAAGAATAC",7,53,22,4,98,184,7998
"AGGTTGTCACCTCTAC",0,3,0,0,2,5,136
"AGGTTGTCAGAAATCA",0,6,2,0,0,8,119
"AGGTTGTCAGGATGAC",2,14,2,3,3,24,117
"AGGTTGTGTAGGCTGA",2,18,2,4,3,29,608
"AGGTTGTGTCCACTTC",0,8,4,0,4,16,573
"AGGTTGTTCGATGCAT",3,8,9,0,8,28,1296
"AGGTTGTTCGCGTGAC",1,0,0,0,0,1,95
"AGTAACCAGGAACTAT",1,6,0,2,0,9,181
"AGTAACCAGGATTCCT",9,36,15,42,14,116,4164
"AGTAACCCAATACAGA",1,8,2,0,2,13,72
"AGTAACCCACTACCGG",3,58,8,0,6,75,2571
"AGTAACCGTTTACCAG",2,19,0,0,0,21,298
"AGTAACCTCAAACCCA",1,2,0,2,0,5,117
"AGTACCAAGCTAATGA",0,2,2,0,0,4,90
"AGTACCAAGTGCTACT",1,5,0,0,0,6,269
"AGTACCACACTCCGAG",0,2,0,0,0,2,10
"AGTACCAGTGCTAGCC",1,7,2,0,4,14,219
"AGTACCAGTGTCCACG",2,21,9,2,4,38,678
"AGTACCATCCGTGACG",1,3,0,0,0,4,97
"AGTACTGAGCGCATCC",0,0,0,0,0,0,8
"AGTACTGGTAGCGAGT",0,8,0,0,0,8,113
"AGTACTGGTAGGCAGT",55,57,27,9,17,165,6206
"AGTACTGGTCCAGTTA",1,28,10,0,8,47,745
"AGTACTGGTCGTGGTC",3,18,4,0,8,33,534
"AGTACTGTCGACATAC",1,7,0,0,2,10,186
"AGTAGCTAGCTACAAA",22,63,39,11,137,272,13323
"AGTAGCTGTAGCGCTC",1,6,0,0,0,7,225
"AGTAGCTGTGGCACTC",1,9,3,0,0,13,300
"AGTAGCTGTTCAGCTA",3,24,5,0,4,36,1544
"AGTAGCTTCATCGCTC",2,16,7,0,5,30,455
"AGTAGCTTCATTGGTG",2,3,2,0,0,7,147
"AGTAGCTTCGACCCAG",1,7,2,0,4,14,102
"AGTAGTCAGCGCACAA",1,5,0,0,0,6,209
"AGTAGTCCACATGTTG",0,5,0,0,2,7,214
"AGTAGTCCATGGCTAT",1,4,0,0,0,5,279
"AGTAGTCGTACAAGTA",0,3,0,0,0,3,171
"AGTAGTCGTAGGCTGA",3,25,13,2,9,52,1574
"AGTAGTCGTCACTAGT",0,2,0,0,0,2,32
"AGTAGTCGTTGCATTG",1,0,2,0,0,3,66
"AGTAGTCTCATAGCAC",1,3,0,0,0,4,24
"AGTAGTCTCCATTTCA",0,4,2,0,2,8,141
"AGTAGTCTCTTGGCTC",12,64,31,5,129,241,8970
"AGTCAACAGACCTCCG",9,43,83,0,12,147,6851
"AGTCAACAGTGCAAAT",3,11,3,3,4,24,652
"AGTCAACCAATAGAGT",1,3,0,0,0,4,253
"AGTCAACCAGATTTCG",0,6,2,0,0,8,42
"AGTCAACTCTTGGGCG",0,0,0,0,0,0,2
"AGTCACAAGATAGTGT",1,3,0,0,0,4,43
"AGTCACACAACAAGTA",2,29,9,2,0,42,470
"AGTCACACAATACGCT",1,0,0,0,0,1,16
"AGTCACACACGAGGTA",3,39,6,0,9,57,2485
"AGTCACACAGACACCC",0,18,4,0,2,24,734
"AGTCACAGTCCTCATC",56,318,115,21,339,849,42714
"AGTCACATCCGGCAGT",0,5,3,0,0,8,498
"AGTCACATCGAAACAA",1,9,0,0,2,12,437
"AGTCACATCGTTCTCG",1,3,0,0,0,4,150
"AGTCATGAGAATCGAT",0,7,0,0,2,9,171
"AGTCATGAGCACCGTC",0,14,5,0,2,21,476
"AGTCATGCAACAACAA",0,2,2,0,0,4,73
"AGTCATGCAAGTGACG",0,2,0,0,0,2,13
"AGTCATGCACCAATTG",2,16,8,0,5,31,581
"AGTCATGCACTGGATT",1,0,0,0,0,1,19
"AGTCATGGTTCAGCGC",0,5,0,0,0,5,186
"AGTCATGTCCGTCAAA",4,38,9,2,5,58,2137
"AGTCATGTCCTGTTGC",343,234,94,77,91,839,26914
"AGTCATGTCGCACGGT",0,0,0,0,0,0,5
"AGTCATGTCTTGCGCT",1,3,4,0,0,8,90
"AGTCTCCAGCTTCGTA",0,3,0,0,0,3,180
"AGTCTCCGTAATTGGA",0,21,3,2,2,28,432
"AGTCTCCGTTCCTACC",0,0,0,0,0,0,21
"AGTCTCCTCAAATGAG",18,81,82,12,134,327,17800
"AGTCTCCTCGGACCAC",5,41,11,4,9,70,3035
"AGTGACTAGCATGGGT",1,4,2,0,0,7,42
"AGTGACTAGTCTGGAG",1,2,0,0,2,5,20
"AGTGACTCAAGGTCGA",1,0,0,0,0,1,17
"AGTGACTCAATACGCT",1,20,7,0,2,30,163
"AGTGACTCAGAGTTGG",11,41,59,8,44,163,6415
"AGTGACTCAGCCCAGT",12,29,8,5,9,63,1906
"AGTGACTGTATCGCAT",2,4,2,0,2,10,318
"AGTGACTGTGAACCGA",0,6,0,0,0,6,89
"AGTGACTTCGGCAGTC",10,39,63,5,15,132,5002
"AGTGATCAGATCGACG",24,73,145,15,35,292,12729
"AGTGATCAGTCGCCAC",4,15,21,3,9,52,1567
"AGTGATCAGTGCAACG",12,66,37,10,120,245,13089
"AGTGATCCACCTAAAC",0,0,0,0,0,0,6
"AGTGATCCACCTATCC",0,3,0,0,4,7,73
"AGTGATCCAGAGGGTT",49,504,113,38,100,804,42619
"AGTGATCCATGACAGG",2,15,2,0,2,21,112
"AGTGATCGTAGGCTCC",2,18,2,0,3,25,787
"AGTGATCTCAAAGCCT",0,0,0,0,0,0,9
"AGTGATCTCGCAATGT",1,0,0,0,0,1,46
"AGTGCCGAGCGCAATG",0,4,0,0,2,6,190
"AGTGCCGAGGTAGGCT",2,28,9,4,4,47,726
"AGTGCCGAGTACAACA",0,0,2,0,0,2,57
"AGTGCCGAGTGCAGCA",1,3,2,0,0,6,23
"AGTGCCGAGTTGGCGA",1,4,0,0,0,5,144
"AGTGCCGCAGACCTGC",0,0,0,0,0,0,11
"AGTGCCGCATTCTCTA",17,166,27,8,33,251,10441
"AGTGCCGGTCCCTGAG",4,25,7,0,6,42,488
"AGTGCCGTCATTACTC",2,26,10,0,5,43,620
"AGTGCCGTCGAGAGAC",1,0,0,0,10,11,422
"AGTGCCGTCTACCTTA",0,9,2,0,0,11,152
"AGTGCCGTCTGCTTAT",4,31,10,5,42,92,3066
"AGTGTTGAGGCGAACT",0,0,0,0,0,0,7
"AGTGTTGAGGTTAGTA",5,28,7,0,15,55,1175
"AGTGTTGCAAATGATG",0,19,8,2,5,34,691
"AGTGTTGCATATCGGT",0,0,0,0,0,0,5
"AGTGTTGCATCACGGC",0,6,3,0,0,9,135
"AGTGTTGCATCATCCC",0,0,2,0,0,2,9
"AGTGTTGCATCCTAAG",16,125,27,9,17,194,7095
"AGTGTTGGTACAGTTC",1,6,0,0,2,9,53
"AGTGTTGTCACCATCC",12,102,21,11,18,164,6296
"AGTGTTGTCGGTAGGA",30,44,17,2,9,102,4784
"AGTGTTGTCTCTATAC",1,4,0,2,2,9,166
"AGTGTTGTCTTGGAAC",1,27,3,3,10,44,526
"AGTTAGCAGCAAATCA",3,14,4,0,5,26,358
"AGTTAGCAGTCATACC",109,654,201,497,174,1635,65088
"AGTTAGCCAATAGGAT",1,8,3,0,0,12,645
"AGTTAGCCACGAGAAC",0,3,0,0,0,3,92
"AGTTAGCCAGCAGGAT",0,3,0,0,0,3,234
"AGTTAGCGTCGCTTGG",1,14,96,2,6,119,1438
"AGTTAGCGTGCCTACG",2,0,0,0,0,2,171
"AGTTAGCGTGCCTGAC",29,206,47,13,29,324,12949
"AGTTAGCGTTGATGTC",0,0,0,0,0,0,7
"AGTTAGCTCCACATAG",5,9,9,0,4,27,770
"AGTTCCCAGCACCGAA",0,4,0,0,0,4,95
"AGTTCCCCACCTTCGT",1,21,7,0,4,33,118
"AGTTCCCCAGGAACCA",11,51,35,2,19,118,3349
"AGTTCCCGTTGATCGT",15,58,137,13,40,263,14191
"AGTTCCCTCCAAGCTA",24,233,87,18,53,415,21945
"AGTTCGAAGACCATGG",25,53,33,8,115,234,13202
"AGTTCGAAGATACATG",1,10,3,0,0,14,132
"AGTTCGAAGCACAAAT",0,7,6,0,2,15,246
"AGTTCGAAGCAGATAT",0,2,0,0,2,4,6
"AGTTCGAAGGGCAGGA",2,20,4,0,5,31,544
"AGTTCGACAGCATACT",1,10,2,0,0,13,272
"AGTTCGAGTATTGACC",0,5,0,0,0,5,122
"AGTTCGAGTTAAGCAA",43,299,161,22,74,599,31476
"AGTTCGATCAAGTCGT",0,0,0,0,2,2,55
"ATACCGAAGGCCACCT",0,2,0,0,0,2,2
"ATACCGAAGGGATCGT",1,6,6,2,0,15,328
"ATACCGAAGGTCGTGA",2,21,8,0,6,37,690
"ATACCGAAGTTGCTGT",1,2,0,0,0,3,87
"ATACCGACAACTCGAT",34,114,57,27,259,491,19608
"ATACCGACACATACGT",9,35,55,4,12,115,4626
"ATACCGAGTAGGAAAG",1,8,2,0,0,11,135
"ATACCGAGTCCACATA",4,24,12,2,4,46,1636
"ATACCGAGTTCAATCG",1,7,6,0,0,14,283
"ATACCGATCACGTAGT",32,271,58,24,50,435,20723
"ATACCGATCCGTAGTA",0,6,3,0,2,11,139
"ATACCGATCGCATAGT",0,10,0,0,2,12,67
"ATACCGATCTAGCAAC",3,16,6,0,6,31,524
"ATACCGATCTTCCACG",4,16,3,0,5,28,645
"ATACCTTAGAGCAAGA",2,23,8,2,8,43,790
"ATACCTTAGCTTAAGA",2,18,4,0,2,26,194
"ATACCTTGTCGATTAC",2,36,13,3,49,103,3410
"ATACTTCAGACTTCAC",0,0,2,0,0,2,18
"ATACTTCAGAGAACCC",2,29,9,0,10,50,824
"ATACTTCAGATTAGAC",1,4,0,0,0,5,115
"ATACTTCTCATCTACT",2,3,0,0,0,5,66
"ATACTTCTCCAGGACC",17,203,49,9,37,315,13599
"ATAGACCCAAATGGTA",0,2,0,0,0,2,23
"ATAGACCCAATGCAAA",3,0,0,0,0,3,15
"ATAGACCGTTCGGTTA",1,4,0,0,0,5,132
"ATAGACCTCGCTGACG",0,19,3,0,2,24,908
"ATAGACCTCTACCAGA",3,6,6,0,2,17,230
"ATAGACCTCTTCGTAT",4,25,4,2,2,37,572
"ATAGAGAAGATGCTAA",5,16,7,0,9,37,650
"ATAGAGAAGTGGATTA",30,182,57,20,124,413,16181
"ATAGAGACAAGCTGTT",5,29,2,3,5,44,683
"ATAGAGAGTCGTATGT",0,14,0,0,2,16,412
"ATAGAGAGTCTTACAG",34,144,60,12,31,281,12920
"ATAGAGAGTTACACAC",4,8,3,0,5,20,372
"ATAGAGAGTTGTAAAG",3,35,5,3,12,58,649
"ATAGAGATCGAGGCAA",1,11,4,0,0,16,164
"ATAGAGATCTGGGAGA",0,0,0,0,0,0,4
"ATAGGCTAGTAATACG",2,4,3,0,5,14,220
"ATAGGCTAGTTCCTGA",4,22,7,3,6,42,64
"ATAGGCTCATCCTGTC",1,12,3,0,3,19,635
"ATAGGCTGTATCATGC",2,19,6,0,3,30,570
"ATAGGCTTCGGCTGTG",24,208,59,21,46,358,18196
"ATAGGCTTCGTCGCTT",0,2,0,0,0,2,30
"ATAGGCTTCTCTGCTG",1,14,4,0,0,19,440
"ATATCCTAGCTCGTGC",1,13,8,0,0,22,433
"ATATCCTAGCTGGCTC",0,0,0,0,0,0,8
"ATATCCTAGGCCTGAA",20,79,36,11,121,267,12841
"ATATCCTAGGGCGAAG",0,6,0,0,0,6,61
"ATATCCTCATGTGGCC",2,2,2,0,0,6,120
"ATATCCTGTGTCTTAG",1,12,4,0,2,19,579
"ATATCCTGTTGCCATA",31,118,50,15,191,405,19686
"ATATCCTTCACCATAG",0,11,2,0,0,13,316
"ATCACAGAGTAGGATT",5,23,7,0,5,40,475
"ATCACAGAGTCATTGC",0,4,0,0,3,7,144
"ATCACAGCAACTGGTT",3,11,2,0,0,16,191
"ATCACAGCAAGGCAAC",0,10,4,0,4,18,116
"ATCACAGTCATTACGG",90,701,142,45,142,1120,50828
"ATCACAGTCCACTGAA",2,25,3,2,6,38,551
"ATCACAGTCCGAGAAG",1,4,3,0,3,11,100
"ATCACGAAGACTTAAG",0,4,2,0,0,6,59
"ATCACGAAGATAGTCA",216,359,80,29,85,769,32353
"ATCACGACAACCTATG",1,8,0,0,0,9,302
"ATCACGACACAAGCCC",13,89,18,4,21,145,5971
"ATCACGACACGGTGTC",15,68,140,10,27,260,11319
"ATCACGACAGGCTACC",1,41,8,0,10,60,812
"ATCACGAGTACGGCAA",1,10,0,2,0,13,244
"ATCACGAGTCCGGACT",0,8,0,2,0,10,252
"ATCACGAGTCGAGTGA",1,9,0,0,2,12,162
"ATCACGAGTTGGCTAT",2,20,4,0,0,26,611
"ATCACGATCAAGGTGG",0,3,0,0,0,3,132
"ATCACGATCAGCTGTA",1,8,3,0,0,12,120
"ATCACGATCATATGGC",0,2,0,0,0,2,20
"ATCACGATCGTAGTCA",3,37,21,3,16,80,2920
"ATCACGATCTCTTCAA",1,2,0,0,0,3,213
"ATCACGATCTTACCAT",2,10,0,0,0,12,285
"ATCACTTAGAGGTTAT",3,28,9,2,7,49,896
"ATCACTTAGTGGACGT",2,3,2,0,2,9,239
"ATCACTTCAAGCAATA",0,5,2,0,0,7,237
"ATCACTTCAGACCGCT",0,18,3,2,3,26,443
"ATCACTTCAGCAGATG",4,26,10,0,2,42,807
"ATCACTTGTGATGTAA",1,9,0,0,0,10,184
"ATCACTTGTTATGACC",4,28,8,3,12,55,830
"ATCACTTTCAACACCA",0,11,2,0,2,15,415
"ATCACTTTCAGCGCAC",0,2,0,0,0,2,115
"ATCACTTTCTTAAGGC",1,5,0,0,0,6,121
"ATCAGGTAGGCTTTCA",0,4,3,0,3,10,170
"ATCAGGTAGTAAGAGG",3,31,8,0,5,47,1072
"ATCAGGTCAAATAAGC",0,0,0,0,0,0,6
"ATCAGGTGTAAGACCG",1,5,0,0,0,6,57
"ATCAGGTGTTAAGGAT",115,566,151,64,142,1038,47992
"ATCAGGTGTTTCGATG",0,3,5,0,2,10,162
"ATCAGGTTCCATTGCC",8,19,2,0,3,32,806
"ATCATTCCAGCATACT",26,126,91,15,74,332,14252
"ATCATTCGTGGAACAC",45,132,66,14,348,605,28802
"ATCATTCTCCATTGTT",0,6,3,0,0,9,284
"ATCATTCTCTAGCCTC",1,3,0,0,0,4,113
"ATCCACCAGACCACGA",129,989,198,66,166,1548,70955
"ATCCACCAGCGTGAAC",0,3,0,0,0,3,158
"ATCCACCAGTGTTCCA",2,20,10,0,6,38,743
"ATCCACCCAAGGAGTC",3,19,18,0,6,46,1332
"ATCCACCCAGTTACCA",0,0,0,0,0,0,1
"ATCCACCGTACTAACC",1,3,3,0,2,9,180
"ATCCACCGTCCGTTTC",0,3,0,0,2,5,155
"ATCCACCGTCGAATGG",0,5,0,0,0,5,186
"ATCCACCGTTTAGTCG",14,38,20,4,51,127,4752
"ATCCACCTCCACTGAA",0,6,0,0,0,6,227
"ATCCACCTCCATGAGT",0,3,0,0,0,3,7
"ATCCATTAGACATATG",17,142,37,52,32,280,10116
"ATCCATTAGACCAGCA",0,0,0,0,0,0,1
"ATCCATTAGCGTTACT",5,44,15,0,5,69,1020
"ATCCATTCAGCGTACC",1,5,0,0,3,9,77
"ATCCATTGTCTCTCTG",1,2,0,0,0,3,139
"ATCCATTGTGACTCGC",26,81,188,7,50,352,19094
"ATCCATTGTGGCTCTG",0,3,0,0,0,3,62
"ATCCATTTCCCATAAG",173,560,140,28,94,995,46394
"ATCCATTTCCTTGACC",2,7,2,6,0,17,398
"ATCCATTTCGGCATTA",29,67,17,34,11,158,5275
"ATCCATTTCTAACGGT",2,16,2,2,0,22,715
"ATCCCTGAGTCATGGG",0,3,2,0,0,5,78
"ATCCCTGAGTCTCGTA",0,2,0,0,0,2,46
"ATCCCTGCAAGAGTTA",0,3,0,0,0,3,121
"ATCCCTGGTGGAGGTT",64,456,124,30,93,767,42289
"ATCCCTGGTTGACTAC",0,8,0,0,2,10,233
"ATCCCTGTCACTTGTT",1,4,2,0,0,7,189
"ATCCCTGTCAGAGCAG",15,79,44,8,16,162,5634
"ATCCGTCAGGCTTTCA",5,54,47,6,13,125,4539
"ATCCGTCAGGTTGCCC",0,8,0,0,0,8,174
"ATCCGTCCAACAGAGC",1,20,0,0,2,23,550
"ATCCGTCCAACCGGAA",0,4,0,0,0,4,123
"ATCCGTCCACGGGCTT",1,8,3,0,3,15,165
"ATCCGTCCAGACGATG",0,2,0,0,2,4,95
"ATCCGTCGTACGACTT",0,2,0,0,0,2,47
"ATCCGTCGTCTGTCAA",2,19,4,0,4,29,578
"ATCCGTCGTCTGTGGC",3,21,5,0,5,34,427
"ATCCGTCGTGAGCTCC",0,3,0,0,0,3,25
"ATCCGTCTCAGGACGA",1,4,2,0,2,9,253
"ATCCTATAGACATCAA",4,28,14,2,11,59,920
"ATCCTATAGGAAGTGA",32,95,238,13,45,423,26206
"ATCCTATCAGCCGTTG",0,6,3,0,0,9,544
"ATCCTATCAGCGCGTT",0,6,0,0,0,6,56
"ATCCTATCAGCGTTGC",4,62,13,2,11,92,5988
"ATCCTATCATGTGGTT",3,3,0,0,0,6,233
"ATCCTATGTCCTTAAG",4,16,3,0,3,26,473
"ATCCTATGTGCATTAC",0,6,0,0,0,6,163
"ATCCTATGTTCCTTGC",1,10,0,0,2,13,250
"ATCCTATTCAGTGTGT",4,23,5,2,8,42,656
"ATCCTATTCCAAGCCG",1,6,3,0,4,14,308
"ATCGATGAGCAGTCTT",0,4,0,0,0,4,30
"ATCGATGAGGGTTAAT",0,0,0,0,0,0,12
"ATCGATGCAACTTGGT",7,20,6,0,4,37,660
"ATCGATGCACGTGAGA",1,0,0,0,0,1,55
"ATCGATGCACTATCCC",3,30,4,0,6,43,1421
"ATCGATGGTACCGGAA",0,6,4,0,3,13,719
"ATCGATGGTGTGCCTG",0,3,0,0,2,5,143
"ATCGATGGTTCTTGTT",2,20,8,2,13,45,1837
"ATCGATGTCAAGTGTC",4,29,4,0,2,39,897
"ATCGATGTCGAAGGAC",0,2,2,0,0,4,58
"ATCGATGTCGCGTAGC",1,4,0,0,0,5,137
"ATCGATGTCGTTAGTG",3,15,0,0,0,18,332
"ATCGCCTAGAGCTGCA",13,48,9,3,12,85,3243
"ATCGCCTAGTCACACT",4,22,7,7,15,55,2526
"ATCGCCTCAAAGCTCT",2,23,9,0,5,39,1180
"ATCGCCTTCGAAACAA",1,9,0,0,0,10,187
"ATCGGATAGAAGTCTA",0,3,0,0,0,3,105
"ATCGGATAGCCTGACC",0,15,5,0,4,24,730
"ATCGGATAGGATATGT",3,33,8,2,6,52,923
"ATCGGATCACCTGAAT",4,18,6,0,2,30,848
"ATCGGATCATGCCGAC",0,4,5,0,2,11,273
"ATCGGATGTCGTCAGC",0,0,0,0,0,0,67
"ATCGGATTCACCATCC",4,19,4,0,5,32,749
"ATCGGATTCCTACTGC",5,30,10,0,6,51,1166
"ATCGGATTCGAAGCAG",0,6,0,0,0,6,126
"ATCGGATTCTCATTAC",1,3,0,0,0,4,98
"ATCGGCGAGGGATCTG",9,39,8,3,8,67,1262
"ATCGGCGAGGTCGAGT",0,0,0,0,0,0,17
"ATCGGCGCAACCCGCA",3,16,6,2,8,35,747
"ATCGGCGTCAGCATTG",34,46,16,42,16,154,5490
"ATCGGCGTCCACTTCG",0,12,2,0,2,16,373
"ATCGGCGTCCGTAGGC",0,0,0,0,0,0,9
"ATCGGCGTCTAGGCAT",36,288,76,15,47,462,15978
"ATCGTAGAGCTCAGAG",1,13,2,0,0,16,308
"ATCGTAGAGCTGTCCG",0,16,2,0,5,23,364
"ATCGTAGCACAGCCAC",0,4,0,0,0,4,23
"ATCGTAGCATGTACGT",0,6,0,0,0,6,37
"ATCGTAGCATTCGGGC",0,6,2,0,3,11,86
"ATCGTAGCATTGACTG",2,16,4,0,0,22,594
"ATCGTAGGTGCTATTG",0,2,0,0,2,4,50
"ATCGTAGGTGTACAGG",0,0,0,0,0,0,7
"ATCGTAGTCACACCGG",1,3,3,0,0,7,436
"ATCGTAGTCCCTCGAT",1,5,2,0,0,8,258
"ATCGTCCAGCACTTTG",1,8,0,0,2,11,162
"ATCGTCCCACCCAACG",6,39,9,2,10,66,1079
"ATCGTCCCACGGTGTC",2,20,2,0,3,27,695
"ATCGTCCCACTACCCT",2,25,8,2,8,45,679
"ATCGTCCCAGTCTGGC",0,5,2,0,2,9,240
"ATCGTCCGTTATAGAG",1,0,0,0,0,1,37
"ATCGTCCGTTGGGAAC",1,7,0,0,2,10,180
"ATCGTCCTCAAGATAG",1,8,3,0,0,12,206
"ATCGTCCTCCCAGTGG",0,7,0,2,0,9,135
"ATCGTCCTCCTGTTGC",0,6,0,0,0,6,385
"ATCGTCCTCTATGCCC",1,22,6,0,3,32,265
"ATCGTGAAGCGAGTCA",29,113,274,12,47,475,16303
"ATCGTGAAGGATATGT",1,8,2,0,4,15,171
"ATCGTGAAGTCCGCCA",0,2,0,0,0,2,109
"ATCGTGACAGAAGTGC",0,2,3,0,2,7,144
"ATCGTGACAGAGGACT",0,3,0,0,0,3,140
"ATCGTGACATTGGCAT",0,10,2,0,0,12,70
"ATCGTGAGTCAGATTC",1,16,3,4,2,26,441
"ATCGTGAGTGTTGATC",7,43,47,2,13,112,5539
"ATCTCTAAGGATATGT",0,3,0,0,0,3,16
"ATCTCTAAGGGCCTCT",0,0,0,0,0,0,11
"ATCTCTACAGCTACCG",2,15,5,3,9,34,1023
"ATCTCTACAGCTTCGG",4,4,3,0,2,13,215
"ATCTCTAGTGTCTCCT",1,2,0,0,0,3,131
"ATCTCTATCATACAGC",3,8,3,0,0,14,757
"ATCTTCAAGCAGGGAG",1,4,0,0,3,8,68
"ATCTTCAAGGTTGACG",3,18,6,2,10,39,850
"ATCTTCACACACACGC",2,18,3,0,8,31,1223
"ATCTTCACAGCCTATA",5,31,10,0,7,53,111
"ATCTTCACATTGACTG",0,3,0,0,2,5,214
"ATCTTCAGTGCTCTCT",2,16,5,0,2,25,226
"ATCTTCAGTTCTCGTC",0,6,0,0,2,8,176
"ATCTTCATCCATGAGT",0,6,0,0,0,6,259
"ATCTTCATCGGTAACT",3,12,4,0,0,19,205
"ATCTTCATCTTCCACG",0,7,0,0,0,7,174
"ATGAAAGAGACAACAT",2,4,0,0,3,9,91
"ATGAAAGAGACTAAGT",0,11,0,0,0,11,81
"ATGAAAGAGCTTAAGA",0,0,0,0,0,0,18
"ATGAAAGAGGTAGTAT",10,55,13,2,10,90,3679
"ATGAAAGCATGGCCCA",3,15,5,5,4,32,768
"ATGAAAGGTAGAGGAA",1,6,6,0,0,13,153
"ATGAAAGTCACCTCGT",5,41,11,2,9,68,2226
"ATGAAAGTCCTACCGT",14,50,93,4,23,184,7186
"ATGAAAGTCGAAGGAC",2,7,2,0,0,11,87
"ATGACCAAGAAGATCT",0,5,2,0,2,9,93
"ATGACCAAGTCGCGAA",1,5,0,0,0,6,179
"ATGACCACACTTGGCG",0,3,0,0,0,3,18
"ATGACCACAGACCTAT",41,114,133,21,241,550,29738
"ATGACCAGTACGTACT",0,0,0,0,0,0,30
"ATGACCAGTACTGACT",39,144,96,27,360,666,35820
"ATGACCAGTATTGACC",0,0,0,0,0,0,7
"ATGACCAGTCGTCATA",13,47,92,6,17,175,7494
"ATGACCATCGGTAACT",24,89,136,18,76,343,18640
"ATGACCATCGTGAGAG",0,3,0,0,5,8,163
"ATGAGGGCACAACGTT",1,4,0,0,0,5,44
"ATGAGGGCACGACGCT",0,6,2,0,0,8,134
"ATGAGGGGTAGCACAG",1,21,8,0,3,33,923
"ATGAGGGGTCAATGGG",0,9,2,0,4,15,148
"ATGAGGGGTCCAGAAG",0,4,0,0,0,4,166
"ATGAGGGGTCGAGATG",13,61,13,5,36,128,5236
"ATGAGGGGTGTGTGGA",10,50,12,3,15,90,3946
"ATGAGGGGTTATGTGC",0,5,2,0,0,7,41
"ATGAGGGTCCATACAG",2,19,3,0,2,26,365
"ATGAGTCAGCATGAAT",2,6,2,0,3,13,250
"ATGAGTCCAAGCGGAT",0,2,6,0,2,10,81
"ATGAGTCCAGAACCGA",0,9,2,0,2,13,255
"ATGAGTCCATCAGTCA",10,31,51,2,10,104,5138
"ATGAGTCGTAGGAAAG",5,9,0,0,0,14,659
"ATGAGTCGTCAGTCCG",0,0,0,0,0,0,20
"ATGAGTCGTTGCCTAA",1,8,0,0,0,9,84
"ATGAGTCGTTGTGTTG",1,6,0,0,0,7,55
"ATGAGTCTCCCTATTA",0,9,6,0,0,15,975
"ATGAGTCTCCGCAGTG",11,46,104,4,25,190,8419
"ATGAGTCTCGCGTTTC",0,5,0,0,0,5,148
"ATGATCGAGAGTAACT",0,4,0,0,0,4,11
"ATGATCGAGCCTCATA",2,19,4,0,6,31,559
"ATGATCGCACACCTGG",78,208,623,54,112,1075,58775
"ATGATCGGTATTCCGA",109,905,234,59,165,1472,78769
"ATGATCGGTGGGTTGA",3,15,4,0,4,26,544
"ATGATCGGTTAGGCCC",2,16,5,0,0,23,420
"ATGATCGGTTATTCTC",3,25,6,0,5,39,732
"ATGATCGTCTGAACGT",0,0,0,0,0,0,176
"ATGATCGTCTTACCAT",121,924,252,52,178,1527,68335
"ATGATCGTCTTTGCTA",6,22,2,2,3,35,799
"ATGCATGAGCGTTCAT",99,73,29,10,31,242,7944
"ATGCATGCAAGACGGT",1,0,0,0,0,1,17
"ATGCATGCACGTATAC",1,0,0,0,0,1,14
"ATGCATGCACTAGGTT",8,17,14,2,6,47,2109
"ATGCATGCATCAGCGC",6,61,19,5,15,106,4782
"ATGCATGGTGGTCCGT",1,19,7,0,5,32,1565
"ATGCATGGTGTTTGCA",2,14,0,0,5,21,71
"ATGCATGTCCTGTTGC",4,9,0,0,0,13,368
"ATGCCTCGTTGCTTGA",4,50,11,2,8,75,2786
"ATGCCTCTCATTTCGT",8,33,17,2,43,103,4890
"ATGCCTCTCCGTGGCA",1,2,0,0,0,3,179
"ATGCCTCTCGTACACA",0,3,0,0,0,3,78
"ATGCGATAGCGAATGC",3,25,4,0,6,38,664
"ATGCGATAGTCCTGCG",1,4,2,0,0,7,245
"ATGCGATAGTGCACAG",2,25,4,0,6,37,837
"ATGCGATCAAACCGGA",0,4,3,0,0,7,136
"ATGCGATCAGCGATTT",1,11,0,3,0,15,152
"ATGCGATCAGCTTTGA",3,11,3,0,2,19,482
"ATGCGATCAGTTACCA",2,2,2,0,2,8,165
"ATGCGATCATCCTGTC",2,27,3,0,3,35,903
"ATGCGATTCAACCTCC",0,6,3,0,5,14,216
"ATGCGATTCAACGTGT",1,3,0,0,0,4,129
"ATGCGATTCAATGCAC",0,4,0,0,0,4,153
"ATGCGATTCAGACTGT",9,67,42,0,12,130,4953
"ATGCGATTCGGAGATG",0,3,0,0,2,5,128
"ATGGAGGAGTTACTCG",0,0,0,0,0,0,30
"ATGGAGGAGTTCATGC",0,0,0,0,0,0,36
"ATGGAGGCACCCTCTA",0,8,3,0,0,11,228
"ATGGAGGCACGGTGTC",1,4,0,0,2,7,184
"ATGGAGGCAGCAGTCC",1,5,0,0,0,6,598
"ATGGAGGCATCATCCC",0,5,0,0,0,5,118
"ATGGAGGCATGGCCCA",1,4,0,0,0,5,76
"ATGGAGGGTAGGTACG",4,23,13,5,19,64,2021
"ATGGAGGGTCAACACT",131,94,40,14,37,316,15812
"ATGGAGGGTCAGACTT",3,24,3,3,2,35,497
"ATGGAGGGTCGAATGG",0,0,0,0,0,0,44
"ATGGAGGGTGGATGAC",1,16,5,0,3,25,380
"ATGGATCAGCCTCGTG",0,3,0,0,0,3,13
"ATGGATCAGTTGTAGA",5,8,11,0,6,30,694
"ATGGATCCAAGTAGTA",13,89,19,5,20,146,5550
"ATGGATCCACAAGCAG",4,32,9,0,7,52,840
"ATGGATCGTCCCAAAT",4,15,5,2,8,34,363
"ATGGATCGTCCCTGAG",1,5,0,0,0,6,43
"ATGGATCTCCTTCAGC",23,62,64,6,80,235,9171
"ATGGATCTCGAAGTGG",48,172,208,23,349,800,44859
"ATGGATCTCTATACGG",0,3,0,0,0,3,60
"ATGGATCTCTTGCGCT",0,8,3,0,0,11,279
"ATGGGAGAGAACGCGT",0,5,3,0,0,8,124
"ATGGGAGAGCGACAGT",6,33,16,2,43,100,3180
"ATGGGAGAGCGCCGTT",0,0,0,0,0,0,5
"ATGGGAGAGGATCACG",0,10,0,0,0,10,122
"ATGGGAGCACAAAGTA",1,4,3,0,0,8,112
"ATGGGAGCAGAGGTAC",0,0,0,0,0,0,11
"ATGGGAGCAGCGACCT",0,0,0,0,0,0,1
"ATGGGAGGTAACATAG",50,133,273,24,135,615,31504
"ATGGGAGGTACTCGCG",2,11,6,2,5,26,681
"ATGGGAGGTATTCCTT",1,23,3,0,4,31,198
"ATGGGAGGTCGCTGCA",0,8,2,0,2,12,255
"ATGGGAGGTTCTCAGA",0,2,0,0,0,2,17
"ATGGGAGTCAGGGTAG",2,14,3,2,7,28,816
"ATGGGAGTCGTCGGGT",0,6,0,0,0,6,75
"ATGGGAGTCTGAATGC",0,2,0,0,0,2,40
"ATGGGTTAGCGCCTAC",0,10,2,0,0,12,128
"ATGGGTTAGTGGTCAG",10,49,12,4,13,88,5479
"ATGGGTTAGTTGGAGC",7,31,27,5,13,83,3404
"ATGGGTTCAAAGCACG",1,4,3,0,3,11,187
"ATGGGTTCACAGTATC",4,23,10,3,4,44,694
"ATGGGTTGTAGCTTTG",0,7,2,0,3,12,179
"ATGGGTTGTCCAAGAG",0,2,0,0,0,2,131
"ATGGGTTGTTGTCCCT",0,0,2,0,0,2,53
"ATGGGTTGTTTGAAAG",1,7,3,0,0,11,149
"ATGGGTTTCGCAATGT",2,22,3,0,6,33,475
"ATGGGTTTCTACACAG",36,165,37,41,37,316,12043
"ATGGTTGAGATGATTG",0,0,0,0,0,0,21
"ATGGTTGAGGCTAACG",1,3,2,0,2,8,149
"ATGGTTGCAGGAATCG",1,13,4,0,3,21,433
"ATGGTTGGTCTCGGAC",2,29,16,2,9,58,2583
"ATGGTTGTCCTCACCA",2,32,6,3,3,46,1173
"ATGTCCCAGCTAGCCC",0,0,0,0,0,0,10
"ATGTCCCAGGCTGTAG",3,22,5,0,4,34,601
"ATGTCCCAGTAGGCCA",5,36,5,0,6,52,1037
"ATGTCCCCAGAGTAAT",2,2,0,0,0,4,15
"ATGTCCCCATCCTATT",11,29,9,3,10,62,2349
"ATGTCCCGTCTTACAG",0,17,12,0,2,31,763
"ATGTCCCGTTAAACAG",19,73,169,10,84,355,17425
"ATGTCCCGTTAAGACA",2,23,9,0,4,38,544
"ATGTCCCTCCGATTAG",0,0,0,0,0,0,1
"ATGTCCCTCTTCTAAC",1,5,0,0,0,6,182
"ATGTCTTAGAAGCGGG",1,10,2,0,2,15,153
"ATGTCTTAGCTAGAAT",6,41,12,3,13,75,944
"ATGTCTTAGGTAACTA",5,9,0,0,0,14,260
"ATGTCTTCAAGCGAGT",0,3,0,0,2,5,94
"ATGTCTTCACAGTACT",8,26,9,0,7,50,912
"ATGTCTTGTCAAGTTC",5,12,2,0,4,23,264
"ATGTCTTGTTTGGGAG",2,9,0,0,4,15,588
"ATGTCTTTCACAACCA",7,26,2,0,11,46,1040
"ATGTCTTTCACGGACC",1,27,4,0,4,36,583
"ATGTCTTTCGAAGCCC",2,6,0,3,0,11,163
"ATGTCTTTCGACGAGA",52,289,92,202,68,703,34585
"ATGTCTTTCTGTGCAA",1,9,3,4,5,22,260
"ATTACCTAGAGGCGGA",14,121,32,5,30,202,11369
"ATTACCTCAGAGAAAG",1,11,3,0,2,17,116
"ATTACCTCATGACTAC",21,56,87,3,76,243,10713
"ATTACCTGTTTGAAAG",2,3,0,0,0,5,97
"ATTACCTTCCGCGGAT",19,142,45,11,36,253,13240
"ATTACCTTCGATCCAA",1,7,2,0,3,13,74
"ATTACCTTCGGAGATG",2,4,5,0,3,14,133
"ATTACCTTCGGTATGT",0,7,0,0,0,7,70
"ATTACTCAGATTACCC",46,157,109,27,360,699,38772
"ATTACTCCAATCCTAG",1,8,0,0,4,13,149
"ATTACTCCAGAGCGTA",15,48,94,10,24,191,4782
"ATTACTCCATGACGGA",0,9,0,0,0,9,101
"ATTACTCGTCGCACAC",23,75,172,3,29,302,12487
"ATTACTCGTTGACGGA",185,559,141,57,137,1079,50292
"ATTACTCTCAAGTGTC",3,49,7,0,10,69,838
"ATTACTCTCGTCAGAT",9,95,25,11,19,159,5949
"ATTACTCTCTCTATAC",0,0,0,0,0,0,13
"ATTATCCAGTCACTCA",0,0,0,0,0,0,33
"ATTATCCCAACACAGG",0,12,3,0,0,15,176
"ATTATCCCACTATGTG",1,8,3,0,4,16,579
"ATTATCCCAGGAGGTT",2,27,10,2,9,50,510
"ATTATCCCATCCGTTC",12,47,30,9,14,112,4007
"ATTATCCCATGACCCG",21,60,20,7,16,124,3653
"ATTATCCCATGGGTCC",46,336,111,23,80,596,30983
"ATTATCCGTCGGTAAG",6,38,7,2,0,53,825
"ATTATCCGTGTCTTGA",2,10,3,0,4,19,307
"ATTATCCTCGGACTGC",4,27,4,0,4,39,627
"ATTCACTAGGTAATCA",36,299,76,13,61,485,25360
"ATTCACTCACCATTCC",0,6,4,0,0,10,122
"ATTCACTCACGCCACA",1,2,0,0,0,3,113
"ATTCACTTCATTGTGG",142,227,85,101,70,625,26505
"ATTCACTTCGCATAGT",19,129,45,58,34,285,13958
"ATTCAGGAGAATTTGG",0,5,0,0,0,5,119
"ATTCAGGAGCGTTCAT",1,12,2,0,3,18,431
"ATTCAGGAGCTGTCCG",2,30,7,2,7,48,1007
"ATTCAGGAGGAGTACC",1,7,2,0,2,12,212
"ATTCAGGAGTGAACAT",19,123,25,9,23,199,10738
"ATTCAGGCAACCCTCT",1,30,3,0,4,38,811
"ATTCAGGCACACCGAC",92,533,115,34,91,865,37409
"ATTCAGGGTACAAGTA",2,24,7,0,3,36,362
"ATTCAGGGTACGACAG",2,22,3,2,9,38,951
"ATTCAGGTCGCTTGCT",1,8,12,0,0,21,471
"ATTCATCAGCACACAG",5,11,8,0,2,26,663
"ATTCATCAGCTCGTGC",3,12,3,0,4,22,246
"ATTCATCGTAATGCGG",10,26,6,0,5,47,1055
"ATTCATCTCCGTACGG",0,6,0,0,0,6,221
"ATTCATCTCGTTCGCT",0,0,0,0,0,0,21
"ATTCCATAGGAGGCAG",2,7,2,0,2,13,218
"ATTCCATAGGCATCAG",3,16,8,5,5,37,668
"ATTCCATCAACGGGTA",0,21,5,0,3,29,460
"ATTCCATCACTGTCCT",2,10,0,0,2,14,317
"ATTCCATGTAACACGG",0,8,0,0,0,8,180
"ATTCCATGTCAAACGG",2,4,3,0,0,9,197
"ATTCCATGTGAGACCA",1,0,0,0,0,1,64
"ATTCCATTCATGCCGG",0,5,0,0,0,5,271
"ATTCCCGCATTCTCTA",1,10,3,0,2,16,152
"ATTCCCGGTAGGGTAC",6,22,14,3,9,54,1245
"ATTCCCGGTCGGTACC",2,3,0,0,0,5,66
"ATTCCCGGTCTTGCTC",0,2,0,0,0,2,213
"ATTCCCGGTGCACAAG",47,235,56,17,45,400,19943
"ATTCCCGGTTGCGGCT",1,25,7,0,23,56,2022
"ATTCCCGTCTCACTCG",0,9,0,0,0,9,150
"ATTCCTAAGCATCTTG",0,3,0,0,0,3,69
"ATTCCTAAGGCTTCCG",13,30,46,5,44,138,6696
"ATTCCTAAGGTCTACT",3,34,12,3,3,55,767
"ATTCCTAAGTACTCGT",1,5,5,0,2,13,20
"ATTCCTACAGCTACAT",1,10,4,0,2,17,372
"ATTCCTACATCTATCT",1,8,0,0,0,9,164
"ATTCCTAGTACAAGTA",1,9,3,0,2,15,256
"ATTCCTAGTGTGTGGA",1,2,0,0,0,3,111
"ATTCCTAGTTAAACAG",0,6,0,0,0,6,24
"ATTCCTATCATCGGGC",1,2,0,0,0,3,13
"ATTCCTATCGGTCATA",1,3,0,0,0,4,32
"ATTCCTATCTCAGTCC",0,6,0,0,0,6,321
"ATTCCTATCTTACCGC",0,4,0,0,0,4,91
"ATTCGTTGTCAGGAGT",23,119,27,11,30,210,9392
"ATTCGTTGTCCACAGC",7,33,6,2,6,54,2104
"ATTCGTTGTGACAGGT",1,2,0,0,0,3,11
"ATTCGTTGTTTCACAG",0,5,0,0,0,5,150
"ATTCGTTTCACAACCA",1,9,3,0,0,13,204
"ATTCGTTTCAGAATAG",1,14,0,2,5,22,148
"ATTCTACAGTTGCGCC",1,2,0,0,0,3,254
"ATTCTACCACCCTAAA",189,1377,373,94,282,2315,123353
"ATTCTACCACTCAAGT",20,178,35,11,76,320,15683
"ATTCTACGTCAGTTTG",1,0,0,0,0,1,6
"ATTCTACTCACAAGGG",0,6,4,0,0,10,178
"ATTCTACTCATGGTAC",0,6,0,0,3,9,251
"ATTCTACTCTTGGCTC",2,17,9,2,6,36,66
"ATTCTTGAGAACAGGA",3,10,2,2,4,21,118
"ATTCTTGAGCTACTGT",0,8,0,0,0,8,341
"ATTCTTGAGTGAGGTC",3,4,2,0,0,9,45
"ATTCTTGCAAATCGTC",0,5,0,0,0,5,19
"ATTCTTGCAACCAACT",1,7,2,0,0,10,384
"ATTCTTGCAAGTTTGC",0,4,3,0,0,7,87
"ATTCTTGGTAATGCTC",3,29,7,0,5,44,641
"ATTCTTGGTCTTCGAA",0,2,2,0,2,6,251
"ATTCTTGGTTCAAAGA",0,4,0,0,0,4,49
"ATTCTTGTCACCATCC",1,16,5,0,4,26,920
"ATTCTTGTCCGTTTCG",1,4,0,0,0,5,157
"ATTGGGTAGAGCCGTA",2,5,4,2,0,13,236
"ATTGGGTAGAGCGACT",1,18,8,0,0,27,324
"ATTGGGTAGCTGTTAC",3,22,9,0,6,40,603
"ATTGGGTCATAGAGGC",54,299,86,22,222,683,31701
"ATTGGGTGTCTTCAAG",3,15,4,0,6,28,533
"ATTGGGTGTTGTCAGT",0,9,0,2,0,11,183
"ATTGGGTTCCTACGGG",0,2,0,0,0,2,22
"ATTGTTCAGGCGAACT",4,27,11,2,4,48,686
"ATTGTTCAGTAAATGC",1,6,0,0,2,9,120
"ATTGTTCAGTGTAGTA",0,30,10,3,4,47,371
"ATTGTTCCAACAAAGT",11,40,53,6,18,128,6085
"ATTGTTCCAGGCTACC",1,2,0,0,0,3,138
"ATTGTTCCAGGTCCCA",0,6,0,0,0,6,103
"ATTGTTCGTAAGAACT",0,6,0,0,0,6,65
"ATTGTTCGTACTCGAT",0,2,0,0,0,2,85
"ATTGTTCGTGCGGATA",4,25,8,2,30,69,2367
"ATTGTTCGTGGGATTG",76,301,118,31,314,840,47421
"ATTGTTCGTTTGTGGT",11,66,15,4,18,114,5713
"ATTGTTCTCTCGGCTT",0,4,0,0,0,4,137
"ATTTACCAGGACGCAT",1,15,6,0,6,28,526
"ATTTACCGTAGTCGTT",4,7,2,0,5,18,450
"ATTTACCGTGCTGCAC",0,3,2,0,0,5,91
"ATTTCACAGGTACAAT",0,17,5,0,4,26,388
"ATTTCACCAATAGGAT",2,14,6,2,8,32,129
"ATTTCACCACACACTA",27,72,36,9,16,160,9784
"ATTTCACCACTACGGC",2,3,3,0,0,8,119
"ATTTCACCAGTAGGAC",1,8,2,2,6,19,871
"ATTTCACCATACAGGG",1,10,4,0,0,15,168
"ATTTCACGTGTGTGGA",0,3,0,0,0,3,32
"ATTTCTGAGCGTGCCT",23,197,36,10,29,295,13435
"ATTTCTGCAACCGGAA",0,4,3,0,0,7,88
"ATTTCTGCATACTGTG",1,15,7,2,2,27,540
"ATTTCTGGTCCGGTCA",0,0,0,0,0,0,9
"ATTTCTGGTCCTACAA",3,19,6,3,6,37,249
"ATTTCTGTCAACTGAC",0,8,0,0,0,8,217
"CAAAGAAAGACATCAA",8,51,63,5,12,139,5378
"CAAAGAAAGGTGGGTT",0,2,0,0,0,2,103
"CAAAGAAAGGTTCCAT",5,41,11,0,18,75,767
"CAAAGAACAATCCTAG",2,20,6,0,4,32,474
"CAAAGAACAGCCATTA",26,96,112,7,109,350,17214
"CAAAGAACATAGAAAC",1,18,6,0,7,32,55
"CAAAGAAGTCGCAGTC",26,232,48,16,38,360,14340
"CAAAGAAGTTTCAGAC",1,10,3,0,4,18,615
"CAAAGAATCACGGACC",6,46,32,6,31,121,4877
"CAAAGAATCCCAATAG",1,27,5,2,0,35,418
"CAAAGAATCTGGTGGC",0,0,0,0,0,0,14
"CAACAACAGCTGCGAA",1,7,0,0,0,8,346
"CAACAACAGTAACCGG",0,8,3,0,0,11,311
"CAACAACAGTGGCCTC",2,22,7,0,4,35,733
"CAACAACCAAAGGATT",21,178,35,11,33,278,14395
"CAACAACCAGCTCCTT",1,4,0,0,0,5,110
"CAACAACCATGTACGT",0,0,0,0,0,0,37
"CAACAACGTTAGTTCG",0,0,0,0,0,0,10
"CAACAGTAGCATGCAG",1,2,0,0,0,3,18
"CAACAGTCAATTGCGT",39,145,324,28,64,600,27930
"CAACAGTTCCTCACGT",1,26,6,0,0,33,635
"CAACAGTTCTTGCGCT",2,18,9,0,9,38,610
"CAACCAAAGTGGGAAA",4,76,14,2,13,109,3365
"CAACCAACAAGTGCAG",11,54,31,128,23,247,12102
"CAACCAACATCCGCGA",3,20,8,2,4,37,765
"CAACCAAGTACTCGCG",2,0,0,0,0,2,168
"CAACCAAGTGACCGAA",46,334,79,29,78,566,25702
"CAACCAAGTGATACCT",11,45,14,3,8,81,1442
"CAACCAAGTTGCATCA",15,60,120,10,24,229,10218
"CAACCAATCCCGAGGT",1,3,0,0,0,4,64
"CAACCTCAGAAGGGAT",6,31,9,0,6,52,640
"CAACCTCCAAAGCAAT",4,44,9,0,10,67,2420
"CAACCTCCACAGTCGC",0,10,2,0,0,12,272
"CAACCTCCAGCTGTAT",4,19,0,0,2,25,714
"CAACCTCGTAGTGTGG",17,54,59,7,112,249,13012
"CAACCTCGTCCATAGT",0,3,2,0,0,5,177
"CAACCTCGTTTCAGAC",3,17,3,0,4,27,862
"CAACCTCTCGAGGCAA",2,6,0,0,2,10,317
"CAACCTCTCTATCACT",15,69,23,5,55,167,6805
"CAACGATAGACGGTTG",0,13,0,0,0,13,564
"CAACGATAGAGAGGGC",242,1622,427,116,343,2750,140153
"CAACGATAGCACCCAC",0,3,0,0,0,3,215
"CAACGATAGCACTTTG",2,6,3,0,0,11,33
"CAACGATAGCCTATTG",1,15,0,2,3,21,283
"CAACGATAGTAGATCA",2,7,2,0,2,13,230
"CAACGATAGTTTCTTC",0,0,0,0,0,0,55
"CAACGATCACTCCCTA",4,23,10,0,5,42,818
"CAACGATGTACCCGCA",0,2,2,0,0,4,15
"CAACGATGTAGACGTG",2,3,0,0,4,9,197
"CAACGATGTGCGAACA",11,73,20,5,15,124,5096
"CAACGATTCAAGAAAC",0,9,0,0,0,9,119
"CAACGATTCGCATGAT",0,7,5,0,3,15,511
"CAACGATTCGCTAATG",3,4,0,0,2,9,176
"CAACGGCAGTATGAAC",4,31,5,0,5,45,867
"CAACGGCCAGATCACT",18,95,16,6,22,157,7627
"CAACGGCGTAAGGCTG",4,25,9,3,4,45,1223
"CAACGGCGTACTCAAC",1,8,2,0,2,13,251
"CAACGGCGTAGGACTG",1,16,2,0,0,19,457
"CAACGGCGTCAAATCC",2,15,6,0,2,25,685
"CAACGGCGTCCAGCAC",1,5,5,0,0,11,108
"CAACGGCTCCACATAG",0,4,0,0,0,4,7
"CAACGGCTCTTACCAT",1,3,0,0,0,4,26
"CAAGACTAGAATCTAG",90,264,79,77,59,569,21862
"CAAGACTTCTCCCAAC",0,4,0,2,0,6,131
"CAAGAGGAGATTGGGC",5,80,21,14,17,137,6416
"CAAGAGGAGCGAGGAG",3,3,0,0,0,6,215
"CAAGAGGAGTATTGCC",1,11,5,0,2,19,184
"CAAGAGGCAATTCTCT",39,343,82,21,57,542,25058
"CAAGAGGCAGATCCAT",3,9,2,0,4,18,32
"CAAGAGGCATACTGAC",2,19,5,0,2,28,51
"CAAGAGGGTACGGCAA",73,476,184,33,108,874,45016
"CAAGAGGGTCCTCCAT",26,70,148,13,31,288,14482
"CAAGAGGGTGAGAACC",2,3,0,0,0,5,93
"CAAGAGGTCAGCTCTC",6,38,10,5,9,68,1630
"CAAGAGGTCCCTCATG",1,17,5,0,4,27,334
"CAAGAGGTCGGCATCG",2,14,3,2,3,24,253
"CAAGAGGTCGGTAGAG",4,47,16,0,4,71,2721
"CAAGCTACACTGTCGG",1,7,4,0,2,14,366
"CAAGCTACATTCCTCG",246,1792,450,133,368,2989,154394
"CAAGCTAGTGTCATTG",0,0,0,0,0,0,24
"CAAGCTAGTTCGGCGT",10,67,50,7,44,178,5241
"CAAGCTAGTTCTGAGT",1,21,10,0,4,36,595
"CAAGCTAGTTTCTATC",0,6,0,0,0,6,156
"CAAGCTATCTCGCAGG",0,9,4,0,5,18,593
"CAAGGGAAGAAGTGTT",2,29,8,3,8,50,464
"CAAGGGAAGAGTCACG",1,15,6,0,5,27,433
"CAAGGGAAGCTGGTGA",5,21,2,0,2,30,333
"CAAGGGACAACTTCTT",1,30,5,0,3,39,1030
"CAAGGGACAATGCAGG",1,2,0,0,2,5,175
"CAAGGGACATGACGAG",0,2,0,0,0,2,5
"CAAGGGATCGGTTCAA",1,31,7,0,3,42,1024
"CAATACGCAATAGTCC",6,34,26,3,8,77,2703
"CAATACGCACGACAAG",4,22,9,2,5,42,1115
"CAATACGGTACCATAC",24,79,115,11,34,263,10251
"CAATACGGTATACCCA",1,7,2,0,2,12,190
"CAATACGTCACAAGAA",0,7,3,0,0,10,154
"CAATACGTCGTTCTAT",2,2,0,0,0,4,94
"CAATCGAAGGTGATCG",1,5,2,0,3,11,729
"CAATCGAAGTCATCCA",1,10,3,0,3,17,470
"CAATCGACATAAGCGG",16,116,87,11,33,263,13153
"CAATCGAGTTCCAAAC",0,12,2,0,2,16,359
"CAATCGATCGGTGTAT",23,85,178,11,38,335,20637
"CAATCGATCTGAGGCC",0,0,0,0,0,0,11
"CAATGACAGAACAAGG",0,0,0,2,0,2,57
"CAATGACCAATATCCG",1,0,0,0,0,1,17
"CAATGACCACTAACGT",5,33,10,3,8,59,1067
"CAATGACGTAACGATA",11,43,57,4,17,132,5395
"CAATGACGTTCTTGTT",1,12,2,0,2,17,174
"CAATGACTCGCTACAA",1,21,6,3,3,34,467
"CAATTTCAGAGTTGCG",1,0,0,0,0,1,8
"CAATTTCCACTTCAAG",1,21,5,3,6,36,950
"CAATTTCGTAACATCC",0,5,5,0,4,14,513
"CAATTTCGTGCTCTCT",0,6,3,0,2,11,155
"CAATTTCTCACATCAG",0,0,0,0,0,0,6
"CAATTTCTCGACGAGA",13,57,118,8,29,225,12187
"CAATTTCTCGTGCACG",2,15,6,0,0,23,680
"CACAACAAGGCCTGAA",0,12,3,0,0,15,204
"CACAACACAACTAGAA",3,39,5,0,4,51,766
"CACAACACATATCTGG",5,29,9,0,4,47,2519
"CACAACATCACGGAGA",1,0,0,0,0,1,169
"CACAACATCCTTCGAC",1,2,3,0,0,6,107
"CACACAAAGAAGAGCA",0,4,0,0,0,4,8
"CACACAAAGAGAGTGA",41,220,58,16,42,377,14323
"CACACAACAATTGAAG",0,0,0,0,0,0,88
"CACACAAGTGGATTTC",0,0,0,0,0,0,3
"CACACAATCTACGGTA",54,188,303,33,72,650,35363
"CACAGATAGGTTCAGG",0,2,0,0,0,2,23
"CACAGATCACACGGAA",110,157,41,10,42,360,14818
"CACAGATCACTACACA",0,7,2,0,0,9,174
"CACAGATCACTGTCCT",3,10,7,0,7,27,703
"CACAGATGTCCATAGT",16,52,111,5,24,208,11244
"CACAGATTCCCTATTA",3,30,33,5,10,81,2829
"CACAGATTCTGGAGAG",4,51,15,4,8,82,2988
"CACAGGCAGACGGATC",1,5,0,0,0,6,291
"CACAGGCAGCCTCTTC",0,21,0,0,8,29,774
"CACAGGCAGCGGGTTA",0,10,0,0,0,10,164
"CACAGGCAGTAAGACT",0,19,2,0,0,21,584
"CACAGGCAGTTTCTTC",2,20,4,2,2,30,142
"CACAGGCGTAACCAGG",1,26,4,0,3,34,1075
"CACAGGCGTCCCGTGA",0,0,0,0,0,0,59
"CACAGGCGTGTATTCG",1,13,6,0,6,26,302
"CACAGGCTCACGAACT",3,19,8,2,3,35,1014
"CACATGAAGACGCCAA",1,24,9,0,10,44,1276
"CACATGAAGCGCCGTT",113,641,93,26,96,969,32715
"CACATGAAGGCTAACG",0,5,2,0,0,7,118
"CACATGACAAAGTGTA",0,8,0,0,0,8,84
"CACATGACAGCGTGCT",12,29,68,4,18,131,6318
"CACATGAGTGACCTGC",1,0,0,0,0,1,19
"CACATGAGTGAGTTTC",1,0,0,0,0,1,19
"CACATGAGTGCCGTAC",1,23,4,0,3,31,892
"CACCAAAAGAATAACC",5,30,12,4,9,60,583
"CACCAAAAGCTTAGTC",196,1573,364,85,258,2476,134019
"CACCAAACAGACCTGC",2,9,0,0,0,11,227
"CACCAAACAGAGGACT",18,60,28,8,94,208,9391
"CACCAAACAGGCACAA",138,152,62,131,58,541,21198
"CACCAAACATGGGATG",9,44,95,5,16,169,8804
"CACCAAACATTGCAAC",162,1146,275,93,231,1907,92551
"CACCAAATCCCGTGAG",5,24,7,2,8,46,921
"CACCGTTAGAGTAACT",0,5,0,0,0,5,116
"CACCGTTAGTAGCAAT",37,261,65,22,52,437,20037
"CACCGTTCATCGGAAG",0,5,0,0,0,5,168
"CACCGTTGTACCCAGC",6,28,6,2,6,48,1224
"CACCGTTTCCCTCGTA",11,25,0,4,5,45,1911
"CACCGTTTCCTGGGAC",1,7,0,0,2,10,735
"CACCGTTTCTGTAAGC",17,77,158,13,39,304,15145
"CACGAATAGTAACGAT",5,20,5,0,3,33,219
"CACGAATAGTTGTCAC",2,10,4,0,3,19,176
"CACGAATCAACTCGTA",4,12,9,0,5,30,558
"CACGAATCAGAGGTAC",5,24,5,0,7,41,790
"CACGAATCAGTAACGG",13,79,35,12,107,246,6936
"CACGAATCATGTCAGT",1,30,8,0,0,39,127
"CACGAATCATTAAAGG",0,0,0,0,0,0,39
"CACGAATGTTAGGGAC",2,42,11,3,6,64,947
"CACGGGTAGCCGGAAT",42,116,65,224,44,491,21929
"CACGGGTAGGGCCAAT",0,5,0,0,0,5,162
"CACGGGTAGTAGGGTC",0,3,4,0,0,7,308
"CACGGGTAGTCGAAAT",2,3,3,0,0,8,148
"CACGGGTGTTCCCACT",0,0,0,0,0,0,84
"CACGGGTTCTTGAACG",1,16,9,0,3,29,934
"CACGTGGCAATCCTTT",16,59,128,14,32,249,14987
"CACGTGGCATTGAGCT",0,2,0,0,0,2,138
"CACGTGGGTAACGCGA",0,4,4,0,0,8,188
"CACGTGGGTATGCAAA",1,9,0,0,0,10,138
"CACGTGGGTCGCCACA",9,36,52,4,15,116,5365
"CACGTGGTCTGCGGGT",0,4,2,0,0,6,98
"CACGTTCAGCTCCATA",0,3,2,0,0,5,345
"CACGTTCAGGTTCCGC",1,11,3,2,4,21,517
"CACGTTCAGTACTGTC",1,5,2,0,4,12,193
"CACGTTCAGTCGAAGC",128,76,27,8,26,265,10827
"CACGTTCCAGAACTTC",0,6,4,0,0,10,325
"CACGTTCGTAGTAAGT",2,17,2,0,3,24,658
"CACGTTCGTGCGTTTA",1,2,2,0,3,8,65
"CACGTTCTCAGAGCGA",3,4,3,0,6,16,667
"CACGTTCTCGACCCAG",20,73,20,7,16,136,6604
"CACGTTCTCTGCATAG",1,0,0,0,0,1,76
"CACGTTCTCTTCTGGC",0,6,0,0,2,8,281
"CACTAAGAGGCTAACG",1,5,2,0,0,8,135
"CACTAAGAGGTAAAGG",0,2,0,0,0,2,110
"CACTAAGAGTTGGGAC",2,11,4,0,0,17,423
"CACTAAGCAAGTGGCA",12,108,17,5,22,164,7517
"CACTAAGCATGAGTAA",2,26,8,3,4,43,661
"CACTAAGGTAGCTTGT",4,17,7,2,13,43,1609
"CACTAAGGTAGTCGGA",0,36,6,0,5,47,861
"CACTAAGTCCGTCAAA",0,2,0,0,0,2,104
"CACTAAGTCGCCGAAC",1,15,3,0,13,32,1444
"CACTGAAAGAGGTCAC",2,8,0,0,0,10,392
"CACTGAAAGCTCACTA",5,48,5,2,9,69,1215
"CACTGAAAGTAGGCCA",51,285,77,21,76,510,26193
"CACTGAACACATACTG",1,4,3,0,0,8,135
"CACTGAACACGCGCAT",0,11,4,0,0,15,187
"CACTGAAGTCCAGTTA",0,6,0,0,2,8,131
"CACTGAAGTGATTAGA",0,0,0,0,0,0,12
"CACTGAAGTTCTAACG",7,31,21,0,9,68,1210
"CACTGAATCGCCTTTG",15,79,33,12,144,283,15410
"CACTGAATCTCTAAGG",0,14,4,0,2,20,572
"CACTGGGAGCCATTTG",3,5,0,0,3,11,255
"CACTGGGAGCCTGCCA",0,0,0,0,0,0,7
"CACTGGGAGTCACACT",3,23,5,0,5,36,1022
"CACTGGGCACTAGGTT",0,0,0,0,0,0,4
"CACTGGGTCTCTAGGA",8,84,22,4,15,133,6420
"CACTGTCAGCAACTCT",0,8,2,0,2,12,341
"CACTGTCAGCCTTTGA",0,9,0,0,0,9,389
"CACTGTCAGGTCTACT",3,19,11,0,2,35,744
"CACTGTCAGTACTCGT",2,17,9,0,6,34,859
"CACTGTCCAAAGGGTC",1,3,0,0,0,4,82
"CACTGTCCAGTTTCGA",7,42,26,4,17,96,3758
"CACTGTCGTTAAACCC",2,9,4,0,0,15,75
"CACTGTCTCCGAACGC",4,15,4,0,4,27,875
"CACTGTCTCGGAAGGT",16,86,36,8,26,172,7125
"CACTTCGCAAAGTATG",2,12,2,0,2,18,371
"CACTTCGCAACTTGCA",2,12,9,0,5,28,141
"CACTTCGCACGACTAT",0,7,0,0,0,7,550
"CACTTCGGTATCGTGT",23,212,44,18,28,325,13294
"CACTTCGGTATGCTTG",1,24,7,0,7,39,995
"CACTTCGTCAGTCCGG",1,11,0,0,0,12,248
"CAGAGCCAGCCTCAGC",5,21,9,0,3,38,1102
"CAGAGCCAGCGTCGAA",2,8,0,2,0,12,212
"CAGAGCCAGGTCATTC",69,420,91,30,79,689,27532
"CAGAGCCAGTATGCAA",0,4,0,0,0,4,78
"CAGAGCCGTAGGTCAG",0,5,3,0,0,8,78
"CAGAGCCGTCTTCCGT",0,0,2,0,0,2,53
"CAGAGCCTCAAATAGG",1,2,0,0,0,3,107
"CAGAGCCTCAATCAGC",0,4,0,0,4,8,81
"CAGAGCCTCCTCTCGA",0,4,0,0,0,4,51
"CAGAGCCTCTGATTCT",0,4,0,2,0,6,27
"CAGATACAGCCACTCG",1,17,5,0,4,27,82
"CAGATACCACTGTTCC",30,88,31,8,18,175,7782
"CAGATACTCCTACACC",1,4,0,0,0,5,238
"CAGATACTCGGCGATC",1,21,4,0,4,30,1545
"CAGATACTCTAGGCCG",4,18,15,0,5,42,1775
"CAGATCACACAAGCTT",0,9,0,0,0,9,219
"CAGATCACACAGCTGC",15,50,80,11,25,181,7865
"CAGATCACATGTGTCA",0,2,0,0,0,2,57
"CAGATCAGTAGAGATT",4,17,6,0,4,31,459
"CAGATCAGTGGCGTAA",1,9,0,0,0,10,135
"CAGATCATCATTGTTC",0,2,0,0,0,2,9
"CAGATCATCGCGGTAC",1,10,2,2,3,18,406
"CAGATCATCGGATTAC",6,27,6,3,4,46,488
"CAGATCATCTACTCAT",3,24,9,0,11,47,993
"CAGATCATCTCCACTG",0,5,3,0,3,11,126
"CAGATTGAGAAGCTCG",4,30,8,2,0,44,655
"CAGATTGAGCCAAGCA",0,3,2,0,0,5,122
"CAGATTGAGTAACGAT",0,3,0,0,0,3,100
"CAGATTGCAAAGAACT",1,37,7,0,11,56,649
"CAGATTGCACGCTATA",1,3,0,4,0,8,258
"CAGATTGCAGGTTACT",1,11,2,0,2,16,451
"CAGATTGCATCAGCTA",0,8,2,0,0,10,35
"CAGATTGTCGCCGTGA",1,15,8,0,6,30,729
"CAGCAATAGACCGCCT",0,3,0,0,0,3,232
"CAGCAATAGGAACTAT",2,26,4,2,5,39,765
"CAGCAATAGTATGTAG",0,4,2,0,0,6,38
"CAGCAATCAATCGTCA",0,29,11,2,9,51,1169
"CAGCAATGTAACGATA",2,7,2,0,2,13,101
"CAGCAATGTCCTGGGT",6,76,14,5,17,118,4579
"CAGCAATGTGAGCAGT",1,8,5,2,0,16,303
"CAGCAATGTGTTTACG",3,14,0,0,2,19,73
"CAGCAATTCTCGTCGT",2,17,8,0,9,36,514
"CAGCACGAGACCAACG",48,36,22,5,12,123,4497
"CAGCACGAGGAAACGA",7,70,15,5,10,107,4636
"CAGCACGAGGAAAGTG",0,7,0,0,0,7,101
"CAGCACGCAAATACAG",3,27,33,5,12,80,4270
"CAGCACGCAACCAGAG",62,404,73,26,68,633,27992
"CAGCACGCAGTAGTTC",0,11,5,0,3,19,444
"CAGCACGCAGTTGTCA",0,0,0,0,0,0,165
"CAGCACGGTGTAAACA",1,5,0,0,0,6,219
"CAGCACGTCCGGTAGC",1,11,0,0,0,12,344
"CAGCACGTCGTTCAGA",0,2,0,0,0,2,56
"CAGCAGCAGCACACAG",1,3,0,2,2,8,125
"CAGCAGCAGCCTGAGA",0,5,4,0,2,11,202
"CAGCAGCAGCGCCCAT",0,4,0,0,0,4,64
"CAGCAGCAGGATTCCT",1,3,0,0,0,4,83
"CAGCAGCAGGTAAGAG",0,3,0,0,0,3,6
"CAGCAGCAGGTATCTC",3,13,7,2,2,27,434
"CAGCAGCCAGTGGTGA",1,2,0,0,0,3,35
"CAGCAGCCAGTTTCGA",0,3,0,0,3,6,240
"CAGCAGCGTCATGACT",0,3,0,0,0,3,73
"CAGCAGCTCAAGTGTC",0,8,0,0,2,10,274
"CAGCAGCTCAGCGGAA",0,13,2,0,2,17,33
"CAGCCAGAGTCGCCAC",0,3,0,0,0,3,274
"CAGCCAGAGTGGATTA",1,3,0,0,0,4,148
"CAGCCAGGTCATTGCA",5,25,5,3,5,43,2042
"CAGCCAGTCGAGTTGT",23,269,55,88,53,488,17483
"CAGCCAGTCTTCGACC",0,0,0,0,0,0,220
"CAGCGTGAGCGGACAT",0,6,2,0,0,8,46
"CAGCGTGAGCTCCCTT",0,9,0,0,0,9,250
"CAGCGTGCACTGGCCA",3,8,0,2,0,13,261
"CAGCGTGGTATCGAAA",3,23,6,3,8,43,519
"CAGCGTGTCATCCTAT",1,2,0,0,0,3,78
"CAGGCCAAGGGAGTGG",1,8,0,0,0,9,197
"CAGGCCAAGGTGGTTG",2,17,5,2,12,38,785
"CAGGCCACAATCTGCA",1,6,0,2,2,11,220
"CAGGCCACACGCAGTC",1,7,2,0,0,10,121
"CAGGCCACAGGTCCGT",0,0,0,0,0,0,8
"CAGGCCACAGTATGAA",0,5,0,0,0,5,158
"CAGGCCACATGCCGGT",5,24,8,2,3,42,1319
"CAGGCCAGTAGCGATG",1,7,0,0,0,8,178
"CAGGCCAGTGATGGCA",24,33,18,0,8,83,2147
"CAGGCCAGTTCTTCAT",0,0,0,0,0,0,207
"CAGGCCAGTTTGAAAG",0,4,2,0,0,6,124
"CAGGCCATCATGGCCG",1,27,6,0,3,37,1452
"CAGGCCATCCCAGTGG",2,16,5,0,5,28,682
"CAGGCCATCGAACTCA",0,0,0,0,0,0,12
"CAGGCCATCGGAAACG",11,47,44,9,75,186,5762
"CAGGCCATCTCATTTG",0,6,2,0,0,8,773
"CAGGGCTAGAAGGATG",0,7,2,0,2,11,549
"CAGGGCTGTCCTACGG",0,3,0,0,0,3,15
"CAGGGCTGTCTGTGCG",0,2,0,0,0,2,18
"CAGGGCTTCGCGTTTC",44,217,59,46,45,411,15254
"CAGGTATAGTCTAGAA",54,245,66,14,57,436,18985
"CAGGTATCAGTTAAAG",2,14,0,0,2,18,28
"CAGGTATGTCGCATGC",81,67,20,13,28,209,7037
"CAGGTATGTGGACCAA",3,23,10,2,5,43,1009
"CAGGTATTCAGGAGAC",0,0,0,0,0,0,2
"CAGGTATTCGCTGATA",3,23,5,4,8,43,863
"CAGTGCGAGCATCCCG",0,6,0,0,0,6,127
"CAGTGCGAGGGTGGGA",209,706,917,114,1349,3295,161652
"CAGTGCGCATGCGTGC",0,4,3,0,2,9,453
"CAGTGCGGTAAGCGGT",0,5,0,0,2,7,86
"CAGTGCGGTCAAGCCC",378,134,70,13,58,653,23937
"CAGTGCGGTCTGTGGC",0,2,2,0,0,4,52
"CAGTGCGGTTGCGTAT",0,4,0,0,0,4,59
"CAGTGCGTCAACCTCC",2,4,0,0,3,9,77
"CAGTGCGTCATAGGCT",0,2,0,0,0,2,39
"CAGTGCGTCTGAGAAA",1,7,3,0,0,11,181
"CAGTTAGAGACCTGGA",2,10,0,0,2,14,160
"CAGTTAGAGCGCTTCG",1,4,2,0,2,9,102
"CAGTTAGAGCTGGCTC",3,31,6,0,9,49,1259
"CAGTTAGAGGACGCTA",0,5,0,0,0,5,84
"CAGTTAGCAACCTATG",4,30,2,0,9,45,1287
"CAGTTAGCAGACCCGT",0,2,0,0,0,2,37
"CAGTTAGGTCAACCAT",0,5,2,0,0,7,150
"CAGTTAGTCATGGCCG",357,469,144,53,135,1158,45702
"CAGTTAGTCTTGGTGA",1,2,0,0,0,3,60
"CAGTTCCAGCAAGCCA",82,87,34,6,21,230,9838
"CAGTTCCAGGACTGGT",50,146,87,28,432,743,36438
"CAGTTCCAGTCTGGAG",0,3,2,0,2,7,134
"CAGTTCCCAATCGCCG",5,41,12,7,13,78,2647
"CAGTTCCCACATGACT",2,13,4,0,0,19,536
"CAGTTCCCACGGCCAT",82,220,144,41,607,1094,54058
"CAGTTCCCAGACGCTC",0,7,2,0,3,12,231
"CAGTTCCGTGGTACAG",17,112,23,8,25,185,8509
"CAGTTCCTCCACTTTA",0,0,0,0,0,0,7
"CAGTTCCTCCTTCTGG",0,0,0,0,0,0,53
"CATAAGCAGCTGGAGT",14,58,150,13,23,258,11229
"CATAAGCAGGCACTCC",1,11,6,0,3,21,156
"CATAAGCAGTCTGCGC",1,0,2,0,0,3,214
"CATAAGCCAGAACTAA",0,10,0,0,3,13,333
"CATAAGCGTATGTCAC",3,25,10,2,10,50,658
"CATACAGAGAAAGTCT",13,33,10,4,11,71,2550
"CATACAGAGCTGAAGC",0,12,0,0,0,12,408
"CATACAGCACTGAGGA",1,4,0,0,0,5,47
"CATACAGTCCGCACGA",0,3,0,0,0,3,99
"CATACAGTCCTCAGAA",6,26,8,3,8,51,979
"CATACCCAGCGTCAGA",1,2,0,0,0,3,55
"CATACCCAGCTACAAA",0,4,0,0,2,6,120
"CATACCCGTCCTACGG",20,106,25,31,42,224,9709
"CATACCCGTGGCTGAA",0,5,6,0,3,14,293
"CATACCCTCGAGTGAG",74,151,40,16,24,305,9890
"CATACCCTCTATGTGG",1,4,0,0,0,5,78
"CATACTTAGATAACGT",4,32,5,0,8,49,834
"CATACTTAGCCATGCC",2,15,4,2,9,32,690
"CATACTTAGTTCACTG",3,8,4,0,2,17,768
"CATACTTGTGGCAGAT",63,409,126,39,96,733,36668
"CATACTTTCAGGACAG",0,8,2,0,0,10,226
"CATAGACAGCTGTCCG",0,4,0,0,3,7,20
"CATAGACAGTGCCCGT",1,5,0,0,3,9,187
"CATAGACGTACCGTGC",0,2,0,0,0,2,14
"CATAGACTCGATGCAT",0,3,0,0,0,3,297
"CATAGACTCGTCCATC",2,16,5,0,0,23,385
"CATAGACTCTAGAGCT",15,145,36,7,25,228,12654
"CATAGACTCTCCGCAT",1,5,3,0,0,9,72
"CATCAAGAGTGCACTT",1,20,9,2,4,36,336
"CATCAAGCACAAGGTG",1,6,0,0,0,7,153
"CATCAAGCAGTTGGTT",3,23,2,0,9,37,1181
"CATCAAGGTAACTAAG",0,5,3,2,0,10,190
"CATCAAGGTATGGTAA",0,4,3,0,0,7,207
"CATCAAGGTCACTCTC",4,12,3,0,2,21,454
"CATCAAGGTCCTACGG",0,0,0,0,0,0,5
"CATCCACAGACGGTCA",0,5,0,0,2,7,188
"CATCCACAGCAACTTC",138,1219,276,79,233,1945,104585
"CATCCACAGCGAGGAG",0,16,9,0,6,31,845
"CATCCACAGCGGGTAT",0,7,2,0,2,11,134
"CATCCACAGTAGCAAT",2,22,4,2,0,30,110
"CATCCACAGTCTACCA",1,17,10,0,6,34,809
"CATCCACAGTCTAGAA",1,12,3,0,0,16,58
"CATCCACCACGTCGGT",9,19,4,2,4,38,1736
"CATCCACCAGCTGTTA",1,2,0,0,0,3,69
"CATCCACCATATTCGG",0,0,0,0,0,0,9
"CATCCACGTAATCAAG",2,15,3,0,8,28,821
"CATCCACGTTTGATCG",0,15,3,0,6,24,618
"CATCCACTCCCTCTTT",1,10,0,0,2,13,150
"CATCCACTCGAGTACT",3,27,8,0,0,38,813
"CATCCCAAGAGAGGGC",0,13,3,0,0,16,54
"CATCCCAAGCCTTTCC",44,114,288,26,58,530,25251
"CATCCCAAGCTTCATG",0,0,0,0,0,0,81
"CATCCCAAGGCACTAG",0,5,0,0,0,5,83
"CATCCCACAACACAGG",2,34,10,3,12,61,1468
"CATCCCACAGCTCCTT",0,6,0,0,0,6,308
"CATCCCAGTGGAAATT",18,58,32,9,134,251,13443
"CATCCCATCGACCACG",0,2,0,0,4,6,473
"CATCCCATCTAACGGT",15,50,24,7,88,184,10325
"CATCCGTAGCGAGTCA",4,19,4,0,0,27,806
"CATCCGTGTATTCCTT",16,67,26,12,75,196,11043
"CATCCGTGTGAACCGA",6,32,30,6,30,104,2262
"CATCCGTTCAATCCGA",1,4,3,0,2,10,243
"CATCCGTTCCAACTGA",1,5,0,0,0,6,161
"CATCCGTTCCGCGATG",16,37,64,4,23,144,8260
"CATCCGTTCCTACTGC",3,25,15,4,6,53,1487
"CATCCGTTCGGCCCAA",0,4,2,0,0,6,90
"CATCCGTTCGTCCTCA",0,0,0,0,0,0,9
"CATCGCTAGCAATTCC",0,5,4,0,0,9,210
"CATCGCTAGCTCTATG",0,3,0,0,0,3,45
"CATCGCTTCAGCTCTC",2,13,6,2,2,25,750
"CATCGCTTCAGGAAGC",10,51,73,6,16,156,8238
"CATCGCTTCGCACTCT",1,4,3,0,0,8,105
"CATCGGGCAGGTTCGC",48,154,87,22,414,725,39198
"CATCGGGGTACTCCCT",0,0,0,0,0,0,13
"CATCGGGGTCAGACTT",4,20,2,2,4,32,618
"CATCGTCAGACATAAC",8,38,6,0,8,60,1519
"CATCGTCCAACAGCTT",4,25,17,2,5,53,821
"CATCGTCGTACTTGTG",13,55,24,5,106,203,6856
"CATCGTCGTCTGTAGT",119,1109,354,66,181,1829,70319
"CATCGTCGTTGAGTCT",2,4,0,0,0,6,29
"CATCGTCGTTTACACG",0,2,4,0,0,6,210
"CATCGTCTCAGGTAAA",2,6,2,0,0,10,238
"CATCGTCTCATTACGG",3,14,4,0,2,23,290
"CATCGTCTCTAAGCCA",2,3,0,0,0,5,68
"CATCGTCTCTCGCTCA",2,30,8,3,7,50,759
"CATGAGTAGAATACAC",0,12,3,0,0,15,115
"CATGAGTAGCAATAAC",0,18,7,2,3,30,1095
"CATGAGTCAAGCTCTA",2,20,4,4,2,32,50
"CATGAGTCACGGTGTC",1,5,3,0,0,9,195
"CATGAGTGTATCGATC",1,17,5,0,0,23,385
"CATGAGTGTCGAACAG",18,52,31,8,108,217,12508
"CATGAGTGTGCTGTCG",0,4,2,0,0,6,107
"CATGAGTTCCGCATAA",1,9,3,0,2,15,283
"CATGAGTTCCTAAGTG",1,8,2,0,3,14,94
"CATGAGTTCCTTCGAC",1,10,0,0,0,11,155
"CATGCAAAGCACACCC",0,8,0,0,0,8,156
"CATGCAAGTATAGCTC",1,7,0,0,0,8,120
"CATGCAAGTATGTCTG",34,224,123,15,43,439,20659
"CATGCAAGTGATAGAT",0,0,2,0,0,2,47
"CATGCAATCACACCGG",1,6,0,0,0,7,202
"CATGCAATCTAAGCCA",2,15,6,0,3,26,734
"CATGCCTAGGAAACGA",2,32,19,2,22,77,1581
"CATGCCTCAGGTGTTT",2,26,6,0,6,40,577
"CATGCCTCATCGCTCT",8,22,0,6,7,43,293
"CATGCCTTCGATACAC",0,6,0,0,2,8,56
"CATGCGGAGCTGTACT",7,45,14,0,3,69,809
"CATGCGGAGTCGAGGT",0,2,0,0,0,2,62
"CATGCGGCAACGATCT",40,367,76,23,70,576,31018
"CATGCGGGTAACGCGA",18,75,171,6,40,310,17077
"CATGCGGTCATGCAGT",1,5,8,0,0,14,480
"CATGCGGTCATTGGTG",6,45,10,7,8,76,1986
"CATGCGGTCCTGTTGC",2,8,2,2,3,17,575
"CATGCTCAGAGTTCGG",3,14,2,0,0,19,456
"CATGCTCAGATTAGCA",4,21,9,2,6,42,640
"CATGCTCAGGATCATA",6,36,15,2,8,67,917
"CATGCTCCAACACAGG",0,0,0,0,0,0,98
"CATGCTCCAAGCACCC",0,8,0,0,0,8,222
"CATGCTCCAAGTAGTA",1,8,3,0,2,14,158
"CATGCTCCATCTCATT",13,8,8,11,5,45,1173
"CATGCTCGTAGTGCGA",0,5,0,0,0,5,163
"CATGCTCGTCGCTTGG",0,2,0,0,0,2,55
"CATGCTCGTCGGTACC",0,0,3,0,0,3,102
"CATGCTCTCAGCTAGT",1,0,0,0,0,1,21
"CATGCTCTCGGAGTAG",1,4,0,0,0,5,62
"CATGCTCTCGTGTGGC",1,13,2,0,0,16,439
"CATGCTCTCTAACGCA",2,6,4,0,2,14,185
"CATGCTCTCTGCACCT",0,7,0,0,2,9,207
"CATGGATAGTCCGTCG",1,3,0,0,0,4,205
"CATGGATAGTGTTGAA",1,12,2,0,0,15,151
"CATGGATCAAGGCAAC",1,3,0,0,0,4,83
"CATGGATCACTGCATA",1,27,9,0,3,40,451
"CATGGATGTTTACCAG",3,24,5,4,5,41,623
"CATGGATTCATTCGGA",7,64,32,6,77,186,8357
"CATGGTAAGAAGTGTT",0,3,0,0,0,3,23
"CATGGTAAGCATTGTC",0,9,2,0,0,11,150
"CATGGTAAGCTGGAGT",62,48,27,30,22,189,7344
"CATGGTAAGTGCTAGG",159,546,152,35,156,1048,49151
"CATGGTACAAATGATG",0,5,2,0,0,7,84
"CATGGTACACCCTGTT",3,40,12,0,3,58,1793
"CATGGTACAGAATTCC",2,15,6,0,5,28,629
"CATGGTAGTACAGGTG",0,13,5,0,3,21,436
"CATGGTAGTGATAGTA",4,36,7,0,7,54,1082
"CATGGTATCAATCTTC",0,8,0,2,0,10,200
"CATGGTATCCTTTGAT",13,45,24,5,63,150,6630
"CATTCATAGTAGATCA",1,4,0,0,0,5,125
"CATTCATCAATGAAAC",2,10,0,0,0,12,204
"CATTCATCATCGGAAG",0,5,0,0,0,5,183
"CATTCATGTCTTGTCC",11,74,31,8,17,141,6644
"CATTCATGTTCCACAA",2,19,5,0,8,34,801
"CATTCATGTTGCGAAG",0,10,2,2,0,14,336
"CATTCATTCATAAGGA",0,5,2,0,0,7,103
"CATTCATTCCAAGCAT",98,770,210,45,156,1279,58582
"CATTCATTCCCATTTA",5,36,6,0,5,52,840
"CATTCCGAGACGAAGA",1,7,2,0,0,10,338
"CATTCCGAGAGCAGTC",1,14,3,0,7,25,407
"CATTCCGAGTTAGTGA",2,2,0,0,0,4,13
"CATTCCGGTAGACGTG",0,4,0,0,0,4,54
"CATTCCGTCAAGATAG",2,7,2,0,2,13,566
"CATTCCGTCGAGTGAG",0,7,3,0,2,12,133
"CATTCCGTCTACTGAG",0,3,0,0,0,3,129
"CATTCCGTCTCGGCTT",0,6,0,0,2,8,244
"CATTCTACAAGGTCTT",5,33,8,3,10,59,1046
"CATTCTACACAACGCC",0,0,0,0,0,0,45
"CATTCTACACGACTAT",1,4,3,0,2,10,135
"CATTCTAGTACAGAAT",6,37,10,0,8,61,897
"CATTCTAGTCCGAAGA",281,2180,535,135,409,3540,164315
"CATTCTAGTTGCTTGA",2,20,2,0,7,31,685
"CATTCTATCACCTCGT",73,440,154,44,110,821,41092
"CATTCTATCAGACATC",0,3,0,0,0,3,116
"CATTCTATCCGTGGGT",0,3,2,0,2,7,64
"CATTCTATCTGGTCAA",22,127,35,6,24,214,13849
"CATTGAGGTCTGTCAA",1,16,5,0,2,24,778
"CATTGAGGTGGGCTTC",0,5,0,0,0,5,123
"CATTGAGTCAACTCTT",3,32,7,2,6,50,121
"CATTGAGTCACACGAT",5,24,5,5,8,47,1273
"CATTGAGTCAGCAGAG",35,108,148,20,208,519,26916
"CATTGAGTCGAACGCC",1,28,6,2,14,51,1424
"CATTGCCAGCTCCATA",8,35,10,3,34,90,4153
"CATTGCCCAAATGCTC",0,0,2,0,0,2,25
"CATTGCCCAACACGTT",1,9,3,0,2,15,574
"CATTGCCCAGGTATGG",1,15,3,0,4,23,165
"CATTGCCTCATCTACT",0,2,0,0,2,4,18
"CATTGCCTCCGCACGA",0,5,3,0,0,8,150
"CATTGTTAGCTAAATG",8,27,16,6,45,102,4636
"CATTGTTAGTGGTGGT",2,11,4,0,0,17,514
"CATTGTTCAAGTTGGG",8,30,22,7,18,85,4055
"CATTGTTCACTGGCCA",0,2,0,0,0,2,87
"CATTGTTCAGTGTACT",53,334,92,21,69,569,28317
"CATTGTTGTCACGCTG",1,6,0,0,0,7,78
"CATTGTTGTGACAGGT",4,18,5,0,12,39,673
"CATTGTTGTGTCCTAA",0,5,4,0,0,9,139
"CATTGTTTCAGAACCT",1,23,2,0,4,30,442
"CATTGTTTCCGGTTCT",2,18,0,0,3,23,94
"CATTGTTTCGGTGTTA",0,3,2,0,2,7,188
"CATTTCAAGACTCATC",0,6,0,0,2,8,121
"CATTTCAAGAGTTGAT",1,4,0,0,0,5,160
"CATTTCACAAGAATGT",1,8,0,0,0,9,339
"CATTTCACAGTTACCA",0,4,2,0,2,8,165
"CATTTCACATGACTAC",1,9,3,0,4,17,205
"CATTTCAGTCTAATCG",0,5,0,0,0,5,65
"CATTTCAGTTTACTTC",97,591,205,50,132,1075,45720
"CATTTCATCAAGGACG",8,30,18,3,44,103,3727
"CATTTCATCCTGTAGA",0,10,2,0,3,15,166
"CATTTCATCTGTCTCG",17,84,114,5,39,259,12636
"CCAAGCGAGAAACTAC",21,49,121,13,26,230,10526
"CCAAGCGAGCTGTTAC",1,12,4,0,0,17,423
"CCAAGCGAGGGATCAC",0,11,5,0,0,16,96
"CCAAGCGGTGTCTCCT",99,552,140,107,113,1011,43247
"CCAAGCGTCCCTTCCC",2,14,3,0,5,24,344
"CCAAGCGTCTAGTTCT",1,7,7,0,2,17,233
"CCAAGCGTCTGTAAGC",1,5,0,0,0,6,122
"CCAATGAAGCGCCTCA",4,15,4,0,3,26,417
"CCAATGAAGCTCGTGC",2,15,2,0,2,21,46
"CCAATGAAGGAGCTGT",4,12,16,0,5,37,2295
"CCAATGAAGGTCATTC",1,25,4,0,7,37,591
"CCAATGAAGTCGTTAC",0,3,2,0,0,5,93
"CCAATGACACGGCACT",0,2,0,0,0,2,16
"CCAATGACATGCGTGC",0,5,3,0,0,8,124
"CCAATGAGTGAATATG",1,2,0,0,0,3,160
"CCAATGAGTTGCTGAT",5,24,7,0,6,42,665
"CCAATGATCATGAGGG",0,0,0,0,0,0,30
"CCAATTTAGCGCCTTG",1,24,3,2,7,37,750
"CCAATTTCACGCGGTT",0,0,3,0,0,3,84
"CCAATTTCATACTGAC",90,343,266,42,596,1337,65552
"CCAATTTCATCCGGTG",0,2,3,0,0,5,150
"CCAATTTGTGAGTTTC",12,38,94,9,22,175,9009
"CCAATTTGTTCATCTT",3,9,3,0,2,17,265
"CCACAAAAGCGACAGT",3,29,7,3,8,50,71
"CCACAAACAAATAAGC",0,0,0,0,0,0,19
"CCACAAACAACTGTGT",0,28,7,0,0,35,786
"CCACAAACATAGTCAC",0,4,0,0,0,4,163
"CCACAAACATTACGGT",0,10,0,0,0,10,128
"CCACAAATCATTGAGC",4,13,6,3,3,29,78
"CCACAAATCCTTGGAA",1406,563,331,113,286,2699,109630
"CCACAAATCGCGTTTC",0,0,0,0,0,0,196
"CCACAAATCTTTGATC",113,860,191,56,160,1380,70835
"CCACACTAGAATAGTC",1,3,4,0,0,8,140
"CCACACTAGGATATAC",0,2,0,0,2,4,190
"CCACACTCAACCACGC",3,5,3,0,0,11,220
"CCACACTGTGTTGACT",1,3,0,0,2,6,80
"CCACACTGTTATGTCG",0,5,0,0,5,10,350
"CCACCATAGATCCGAG",1,11,7,0,3,22,140
"CCACCATAGGCCTGCT",1,13,3,0,0,17,321
"CCACCATCAGTTGTCA",10,91,26,5,14,146,7100
"CCACCATTCACCGGGT",1,4,0,0,3,8,190
"CCACCATTCACTGCTC",0,0,0,0,0,0,10
"CCACCATTCCTTATCA",0,3,2,0,0,5,138
"CCACCATTCTAGGCCG",0,9,0,0,0,9,189
"CCACGAGAGCAGTCTT",1,8,2,0,2,13,128
"CCACGAGGTAGGCAGT",3,10,0,0,0,13,529
"CCACGAGTCGCCGTGA",15,59,30,13,127,244,9909
"CCACGAGTCTAACACG",2,22,3,0,0,27,261
"CCACGAGTCTAGATCG",2,36,3,0,4,45,2386
"CCACGAGTCTGAGGCC",19,35,26,4,8,92,4859
"CCACGTTAGGTCATAA",8,40,58,11,20,137,6624
"CCACGTTAGGTTCTTG",0,0,2,0,0,2,188
"CCACGTTCAAGATTGA",0,7,2,0,2,11,233
"CCACGTTCAGCTGCCA",0,0,0,0,0,0,5
"CCACGTTCAGTCGAGA",7,54,25,7,11,104,4732
"CCACGTTCATGACACT",0,6,5,0,0,11,180
"CCACGTTGTCGATGCC",0,0,0,0,0,0,56
"CCACGTTTCATACGAC",1,10,2,0,0,13,437
"CCACTTGAGTCACGAG",3,5,0,0,0,8,88
"CCACTTGCATCCTAAG",1,5,0,0,0,6,184
"CCACTTGTCACAACCA",1,0,0,0,0,1,10
"CCACTTGTCCATTCGC",1,7,3,0,0,11,418
"CCACTTGTCTACTGAG",0,3,0,0,0,3,63
"CCATAAGAGAGTCAGC",1,18,2,0,3,24,1502
"CCATAAGTCAGAACCT",27,223,47,36,32,365,14613
"CCATAAGTCAGTCATG",1,24,4,3,4,36,74
"CCATAAGTCTACTATC",1,6,0,0,0,7,127
"CCATCACAGGAGAGTA",48,40,13,4,13,118,5560
"CCATCACAGGGCCTCT",7,23,9,3,2,44,1529
"CCATCACCAGGTATGG",1,0,0,0,0,1,17
"CCATCACGTACCCGCA",1,2,0,0,0,3,87
"CCATCACGTCGGCACT",2,18,4,2,14,40,661
"CCATCACTCAGCAGAG",3,27,7,0,7,44,548
"CCATCACTCCTTTAGT",22,69,152,10,33,286,14052
"CCCAACTAGACAGCTG",0,0,0,0,0,0,23
"CCCAACTAGCCATTGT",0,17,7,0,4,28,466
"CCCAACTAGCGGCTCT",1,15,4,2,6,28,598
"CCCAACTAGGTCGTGA",4,24,35,0,11,74,2629
"CCCAACTAGTGCACCC",0,2,0,0,0,2,20
"CCCAACTCATAACGGG",1,0,2,0,0,3,106
"CCCAACTGTAACCAGG",0,5,0,0,0,5,97
"CCCAACTGTCCTGGGT",63,236,94,351,81,825,41028
"CCCAACTGTGTACGCC",31,309,55,16,57,468,27450
"CCCAACTGTTAGTCGT",7,28,9,0,9,53,624
"CCCAACTTCCGTGACG",3,26,4,2,5,40,874
"CCCATTGAGTAGCAAT",2,44,8,3,10,67,2010
"CCCATTGCAACAGCCC",1,18,5,4,0,28,752
"CCCATTGCATCGGCCA",47,115,198,27,171,558,28338
"CCCATTGCATGACGGA",10,81,23,4,15,133,4221
"CCCATTGTCAAGCGTT",4,17,0,0,2,23,480
"CCCATTGTCCTGGGTG",17,63,122,8,27,237,12534
"CCCGAAGCACATGGTT",2,15,4,0,2,23,756
"CCCGAAGCACTTGACA",4,22,4,0,8,38,678
"CCCGAAGCAGCATCTA",1,4,2,0,0,7,110
"CCCGAAGGTCTCAGGC",0,0,0,0,0,0,19
"CCCGAAGGTGGAACAC",60,228,347,28,85,748,38739
"CCCGAAGGTTGCTTGA",34,262,100,22,59,477,24357
"CCCGAAGTCACAATGC",1,13,3,0,3,20,98
"CCCGAAGTCAGTCAGT",26,147,23,11,25,232,6244
"CCCGAAGTCGCCTTTG",0,7,0,0,0,7,166
"CCCGGAAAGGTATTGA",3,24,3,2,3,35,552
"CCCGGAACAACTTCTT",0,2,0,0,4,6,417
"CCCGGAAGTGACTGAG",1,4,0,0,0,5,132
"CCCGGAAGTTTGGAGG",3,17,4,0,2,26,507
"CCCGGAATCACCCTTG",2,4,0,0,0,6,138
"CCCGGAATCCCTTTGG",2,3,0,0,0,5,90
"CCCGGAATCGGTAGAG",0,3,0,0,2,5,197
"CCCTAACAGAAAGCGA",1,2,2,0,0,5,101
"CCCTAACAGGTGCCTC",1,4,0,0,2,7,186
"CCCTAACGTCGCATCG",1,10,0,0,0,11,28
"CCCTAACGTTCGTAAC",0,2,0,0,0,2,218
"CCCTAACTCGTTCCTG",6,25,6,2,4,43,1290
"CCCTCAAAGAGCCCAA",0,0,0,0,0,0,3
"CCCTCAACAACGCATT",3,23,14,0,5,45,922
"CCCTCAACAGGTGACA",10,73,22,6,40,151,6538
"CCCTCAATCGATACTG",0,9,0,2,0,11,152
"CCCTCTCAGAGAACCC",1,21,4,0,7,33,982
"CCCTCTCAGTCATCGT",3,16,5,0,0,24,913
"CCCTCTCCAGCAGTAG",1,5,0,0,0,6,70
"CCCTCTCGTCATCGCG",1,3,0,0,0,4,114
"CCCTCTCGTGAACGGT",2,15,3,0,0,20,692
"CCCTCTCGTGATGAAT",2,5,0,0,0,7,222
"CCCTCTCGTGTCCACG",2,15,6,2,7,32,665
"CCCTCTCTCGAGAAAT",1,0,0,0,0,1,90
"CCCTCTCTCGGAATTC",28,36,12,2,11,89,2919
"CCCTCTCTCTCGGCTT",1,3,8,0,2,14,393
"CCCTGATGTACTGCCG",14,56,31,7,70,178,6763
"CCCTTAGAGGCGATAC",0,3,3,0,0,6,117
"CCCTTAGCAATCACGT",1,4,2,0,0,7,102
"CCCTTAGCAGCGGTTC",4,24,14,3,16,61,2827
"CCCTTAGGTTTCCATT",1,15,0,0,0,16,503
"CCCTTAGTCAACCTTT",0,2,0,0,2,4,17
"CCCTTAGTCAGTCCGG",4,18,6,0,5,33,651
"CCCTTAGTCGTTCAGA",1,2,0,0,0,3,88
"CCGAACGAGAAACTCA",2,21,5,0,4,32,607
"CCGAACGAGCGCACAA",13,56,18,2,70,159,6513
"CCGAACGAGGGTCACA",1,14,5,0,4,24,421
"CCGAACGAGTCTGCGC",2,6,0,0,0,8,234
"CCGAACGCACAGTCGC",141,46,31,6,17,241,9023
"CCGAACGCACGCCACA",2,18,7,2,0,29,1137
"CCGAACGTCCAATCTT",2,29,6,3,7,47,912
"CCGAACGTCCGTGTAA",2,4,3,0,0,9,51
"CCGATCTAGACCTCCG",0,3,0,0,2,5,86
"CCGATCTAGAGAGCAA",2,18,3,0,3,26,188
"CCGATCTAGCAGATAT",0,2,0,0,3,5,67
"CCGATCTAGCGACATG",0,4,0,0,0,4,128
"CCGATCTCAGGAACCA",3,15,7,0,2,27,507
"CCGATCTCATCCGCGA",0,20,4,0,4,28,139
"CCGATCTCATCGATGT",2,32,10,0,6,50,892
"CCGATCTGTATTGACC",1,5,2,0,0,8,170
"CCGATCTGTTAAGACA",4,22,6,0,4,36,746
"CCGATCTTCAACCCGG",0,2,0,0,0,2,29
"CCGATCTTCAGAGCAG",7,107,19,8,13,154,4958
"CCGATCTTCAGATTGC",200,820,211,96,185,1512,70092
"CCGATGGAGAGGCGGA",3,16,3,0,2,24,1611
"CCGATGGAGCATAGGC",0,3,0,0,2,5,79
"CCGATGGAGGACGCAT",70,46,23,8,17,164,6774
"CCGATGGAGTCTCGTA",1,5,2,0,0,8,197
"CCGATGGAGTGTAGAT",0,4,0,0,0,4,233
"CCGATGGCACAGAGAC",1,5,2,0,0,8,156
"CCGATGGCAGAAGCGT",0,0,0,0,0,0,4
"CCGATGGGTTACAGCT",1,0,0,0,0,1,166
"CCGATGGTCAGTGATC",0,5,0,0,0,5,136
"CCGATGGTCATAGAGA",0,9,0,0,0,9,259
"CCGATGGTCATCTGTT",15,62,91,10,46,224,10835
"CCGCAAGAGCATCTTG",5,26,41,5,11,88,2520
"CCGCAAGCAGTCAGCC",0,0,0,0,0,0,31
"CCGCAAGCAGTTGTTG",0,3,3,0,2,8,109
"CCGCAAGGTTGGGTAG",1,7,0,0,0,8,104
"CCGCAAGTCCACGTAA",847,292,180,53,153,1525,70383
"CCGCAAGTCCGTCCTA",0,0,0,0,0,0,15
"CCGGACACATGTGCTA",1,20,3,2,0,26,832
"CCGGACAGTGTCATTG",8,85,18,5,11,127,3407
"CCGGACATCATGGATC",1,0,0,0,0,1,81
"CCGGGTAAGATACTGA",2,15,3,0,0,20,376
"CCGGGTAGTCCACTCT",4,24,5,0,4,37,48
"CCGGGTATCGGCAGTC",0,2,2,0,0,4,41
"CCGGTAGAGAGAGCGG",0,0,0,0,0,0,82
"CCGGTAGAGCTTTCCC",23,167,94,6,35,325,12620
"CCGGTAGAGGATATAC",21,55,63,9,88,236,11473
"CCGGTAGAGGATTCCT",0,0,0,0,0,0,157
"CCGGTAGCAACTCGAT",1,6,3,2,0,12,123
"CCGGTAGCAGCGCGTT",3,29,19,0,5,56,1978
"CCGGTAGGTAGTCGGA",40,54,17,5,18,134,4201
"CCGGTAGGTCGTTCAA",0,2,0,0,0,2,14
"CCGGTAGGTCTCACAA",12,51,85,5,13,166,9848
"CCGGTAGGTGACTGTT",28,80,179,14,36,337,21009
"CCGGTAGTCCCAGTGG",74,59,25,3,20,181,5713
"CCGGTAGTCCGAGATT",7,30,64,2,13,116,6418
"CCGGTAGTCGTAGTCA",0,0,0,0,2,2,3
"CCGGTAGTCTGCGTCT",0,0,0,0,0,0,17
"CCGGTGAAGCCGAACA",19,168,38,20,42,287,4681
"CCGGTGAAGTCAGCGA",0,2,0,0,0,2,49
"CCGGTGAAGTCGAATA",0,4,2,0,0,6,41
"CCGGTGACAGACTCTA",0,4,2,0,0,6,121
"CCGGTGACATCCGATA",0,0,0,0,0,0,366
"CCGGTGAGTCACCACG",0,6,2,0,0,8,174
"CCGGTGAGTGACATCT",0,7,4,4,3,18,306
"CCGGTGAGTGACGCCT",0,6,2,0,0,8,60
"CCGGTGAGTGTTGACT",0,7,3,0,2,12,56
"CCGGTGAGTTGTCCCT",2,16,6,0,2,26,645
"CCGGTGATCGGACGTC",0,2,0,0,0,2,263
"CCGTAGGAGGGCTAAC",4,29,7,2,3,45,910
"CCGTAGGCACGCTGAC",1,13,2,0,3,19,200
"CCGTAGGGTACTGGGA",0,4,0,0,0,4,191
"CCGTAGGGTCGCGTCA",0,0,0,0,0,0,36
"CCGTAGGGTGATAGTA",0,2,0,0,0,2,32
"CCGTAGGGTGTCATCA",1,2,0,0,0,3,58
"CCGTAGGTCCCTAGGG",1,5,2,0,0,8,167
"CCGTAGGTCGCACGAC",44,345,93,24,75,581,28864
"CCGTGAGAGCATCCCG",16,48,65,8,61,198,7155
"CCGTGAGAGCCACCGT",1,5,0,2,6,14,641
"CCGTGAGAGCTTGTGT",22,161,40,10,44,277,10595
"CCGTGAGAGGTGGCTA",0,6,0,0,0,6,112
"CCGTGAGAGTGAACAT",7,43,16,3,26,95,4454
"CCGTGAGCAAACAGGC",23,158,37,22,27,267,10231
"CCGTGAGCAGTTACCA",9,131,36,7,20,203,8586
"CCGTGAGGTTAACCTG",2,0,4,0,0,6,75
"CCGTGAGTCGATAACC",1,0,0,0,0,1,59
"CCGTGAGTCGATTGGT",28,142,51,251,83,555,17169
"CCGTGAGTCGTGTTCC",1,16,2,0,2,21,262
"CCGTGAGTCTCCCATG",1,20,0,0,7,28,651
"CCGTTCACAAAGAACT",5,27,6,0,9,47,2460
"CCGTTCACAGAGTGTG",2,8,0,0,0,10,180
"CCGTTCAGTACCGGAA",0,4,0,0,0,4,183
"CCGTTCAGTACCTGTA",1,14,3,2,3,23,605
"CCGTTCAGTCTACGTA",2,11,0,0,0,13,517
"CCGTTCAGTGTGTGTT",1,13,4,0,2,20,247
"CCGTTCAGTTGGAGAC",141,716,170,45,153,1225,54801
"CCGTTCATCATTGTGG",1,23,4,0,3,31,436
"CCGTTCATCGAGTCTA",8,54,13,4,8,87,1616
"CCGTTCATCTTACGTT",2,30,9,2,4,47,966
"CCTAACCAGGAAGTCC",1,14,0,0,3,18,313
"CCTAACCTCACCTCTG",1,3,3,0,0,7,204
"CCTAACCTCCATAGGT",0,3,2,0,0,5,65
"CCTAACCTCGTAGAGG",1,0,0,0,0,1,7
"CCTAAGAAGAAGTATC",13,88,21,7,52,181,7505
"CCTAAGAAGAGTGTGC",2,11,5,0,4,22,478
"CCTAAGAAGGCAGTCA",0,7,2,0,0,9,144
"CCTAAGAAGGTGTGAC",20,56,113,12,28,229,10934
"CCTAAGAAGTGTACCT",0,16,3,0,2,21,413
"CCTAAGACAAAGGATT",14,41,76,7,15,153,7409
"CCTAAGAGTACCACGC",15,60,77,8,76,236,12437
"CCTAAGAGTCGCTTGG",32,783,134,16,48,1013,15498
"CCTAAGAGTCTGTTAG",26,81,37,12,176,332,14492
"CCTAAGATCCCGTGAG",36,220,43,13,45,357,17953
"CCTAAGATCGGAACTT",24,92,170,15,108,409,24528
"CCTACGTAGAAGTCTA",0,6,0,2,2,10,58
"CCTACGTAGAGATTCA",0,0,0,0,0,0,8
"CCTACGTAGGATTACA",8,47,63,4,15,137,6390
"CCTACGTGTAGAGCTG",0,0,0,0,0,0,31
"CCTACGTGTCGACTTA",4,33,24,0,6,67,3275
"CCTACGTGTTGCTCGG",2,6,2,0,0,10,31
"CCTACGTTCGCGTGAC",35,123,330,13,56,557,32070
"CCTATCGAGATAGCAT",0,3,0,0,0,3,10
"CCTATCGAGCCGCACT",0,9,2,0,4,15,700
"CCTATCGAGGTCTGGA",4,30,3,0,4,41,539
"CCTATCGAGTTTCGGT",80,418,132,35,116,781,38349
"CCTATCGCACTTGGCG",0,0,0,0,0,0,102
"CCTATCGGTAGGGAGG",3,3,0,0,0,6,551
"CCTATCGGTGGCTAGA",1,9,2,0,2,14,511
"CCTATCGTCACGGGCT",1,15,5,0,6,27,674
"CCTATCGTCAGAACCT",0,5,0,0,2,7,170
"CCTATCGTCCTACCGT",0,4,0,0,2,6,92
"CCTATCGTCTAGGCAT",1,9,3,0,0,13,373
"CCTATCGTCTCTTGCG",0,0,0,0,0,0,24
"CCTCAACAGAATTGCA",49,137,390,25,76,677,35069
"CCTCAACCACAGTCCG",1,9,0,0,0,10,125
"CCTCAACCATGACCCG",0,6,3,0,0,9,226
"CCTCAACTCATGGAGG",1,4,0,0,0,5,103
"CCTCAACTCCCAAGTA",0,11,5,0,6,22,821
"CCTCAACTCCCATACC",0,11,0,0,0,11,137
"CCTCAACTCGAACGGA",1,17,7,0,3,28,443
"CCTCAACTCTCATAGG",1,2,2,0,0,5,101
"CCTCACAAGCATCGAG",1,4,0,0,4,9,161
"CCTCACAAGTTTGGCT",0,14,4,0,6,24,512
"CCTCACACATAAGCAA",0,16,7,2,4,29,667
"CCTCACAGTCAAATCC",2,30,9,4,7,52,1186
"CCTCACAGTCGAATTC",1,3,2,0,0,6,142
"CCTCACAGTGGTCAAG",0,0,0,0,0,0,19
"CCTCACATCACCATAG",0,10,3,0,3,16,231
"CCTCACATCTAACGCA",0,5,0,2,0,7,233
"CCTCACATCTACGGGC",10,40,77,5,15,147,7392
"CCTCAGTAGAATTGCA",3,20,11,0,7,41,531
"CCTCAGTAGCCATGCC",2,19,21,0,5,47,2514
"CCTCAGTAGGGATCTG",0,5,0,0,0,5,82
"CCTCAGTAGTCTACCA",0,3,0,0,0,3,52
"CCTCAGTCAAATTGCC",1,8,2,2,0,13,340
"CCTCAGTCAACAGATA",0,6,0,0,2,8,202
"CCTCAGTCATAATGAG",9,60,13,5,15,102,3280
"CCTCAGTCATCTGCGG",0,0,0,0,0,0,132
"CCTCAGTCATGTGCCG",9,63,22,4,14,112,7196
"CCTCAGTGTAACACCT",5,27,11,0,10,53,992
"CCTCAGTGTATACCTG",2,2,0,0,0,4,264
"CCTCAGTGTCGGCACT",0,7,0,0,0,7,210
"CCTCAGTTCATAGCAC",24,226,51,16,49,366,19165
"CCTCATGAGAGAGCAA",5,17,6,2,2,32,347
"CCTCATGGTACTCGCG",0,19,5,2,0,26,425
"CCTCATGTCAATCTTC",90,77,31,9,27,234,9139
"CCTCATGTCACCCATC",14,37,76,4,16,147,7235
"CCTCATGTCCACGAAT",0,21,5,0,2,28,692
"CCTCATGTCGATCCAA",3,29,9,2,6,49,530
"CCTCCAAAGACATACA",3,5,0,0,0,8,188
"CCTCCAAGTCACAGAG",2,0,0,0,2,4,20
"CCTCCAAGTCAGGTAG",0,21,0,0,2,23,557
"CCTCCAAGTGGTTCTA",20,178,40,6,29,273,13488
"CCTCCAATCAGACAAA",3,29,23,4,3,62,2065
"CCTCCAATCCATTCGC",1,9,2,0,0,12,213
"CCTCCTCAGACCACGA",0,5,0,0,0,5,334
"CCTCCTCAGCTTCATG",1,4,0,0,2,7,198
"CCTCCTCCAATTAGGA",7,74,16,6,15,118,3458
"CCTCCTCGTAACATGA",80,65,24,9,22,200,9243
"CCTCCTCGTATGCTTG",0,2,0,0,0,2,39
"CCTCCTCGTCACAGTT",2,19,10,2,4,37,1653
"CCTCCTCGTGAATATG",1,2,2,0,0,5,300
"CCTCCTCTCAGACCGC",33,273,68,19,67,460,25208
"CCTCCTCTCCGAGTGC",2,10,5,0,2,19,61
"CCTCTAGGTTGGACTT",30,207,67,23,48,375,20372
"CCTCTAGTCATCCTGC",4,16,2,3,3,28,1030
"CCTCTAGTCGAGAGCA",0,4,0,0,2,6,87
"CCTCTAGTCGCTAATG",1,2,0,0,0,3,102
"CCTCTCCAGATTGTGA",0,17,5,0,4,26,186
"CCTCTCCAGGAGTACC",1,0,0,0,0,1,6
"CCTCTCCCAATGACCT",9,75,35,7,10,136,5057
"CCTCTCCGTAGGTCAG",0,11,0,0,0,11,603
"CCTCTCCGTTCTTGCC",1,21,11,0,10,43,1019
"CCTCTCCGTTTGAAAG",0,2,2,0,2,6,13
"CCTCTCCTCCACGTCT",2,21,6,2,6,37,1207
"CCTCTCCTCGGCTGAC",1,14,0,0,0,15,761
"CCTCTCCTCGTTCTCG",1,2,2,0,0,5,308
"CCTCTCCTCTCATTAC",34,155,75,15,199,478,21946
"CCTGCATAGCCTCACG",1,12,2,0,0,15,609
"CCTGCATCAGCCGGTT",29,87,77,14,159,366,18247
"CCTGCATCATGGGATG",1,7,2,0,0,10,465
"CCTGCATGTATAGGGC",0,4,0,0,0,4,10
"CCTGCATGTGGAATGC",0,8,0,0,2,10,316
"CCTGCATTCACAAGGG",5,34,34,0,10,83,3131
"CCTGCATTCAGACCGC",39,116,70,293,62,580,24824
"CCTGCATTCAGGAACG",2,13,5,0,5,25,1134
"CCTGTTGAGACGGTTG",1,2,0,0,0,3,125
"CCTGTTGAGGCTCAAG",1,17,6,2,2,28,620
"CCTGTTGAGTCATGCT",1,20,2,2,8,33,567
"CCTGTTGCAAAGAACT",0,20,5,2,5,32,113
"CCTGTTGCACTGGCCA",0,3,0,0,2,5,131
"CCTGTTGGTATCGTGT",0,4,0,0,0,4,67
"CCTGTTGTCAAGGACG",0,0,0,0,0,0,15
"CCTGTTGTCACTTGTT",0,3,0,0,0,3,112
"CCTTCAGAGCATGATA",28,219,48,17,44,356,16395
"CCTTCAGAGCTGGTGA",5,41,9,3,14,72,2165
"CCTTCAGAGGTCGACA",3,30,15,2,6,56,742
"CCTTCAGCACCTTCGT",0,3,2,0,0,5,95
"CCTTCAGGTGTTCATG",4,20,7,0,2,33,529
"CCTTCAGTCCATCACC",1,2,0,0,0,3,69
"CCTTGTGAGCTGACCC",15,37,67,6,18,143,7245
"CCTTGTGCACATAACC",23,61,25,8,20,137,6336
"CCTTGTGCATAGTCAC",1,3,0,0,0,4,143
"CCTTGTGTCATACAGC",1,8,3,0,2,14,149
"CCTTGTGTCCGTGACG",15,60,23,8,95,201,7455
"CCTTGTGTCGCATAGT",2,26,2,0,8,38,987
"CCTTGTGTCGTGCTCT",1,0,0,0,0,1,10
"CCTTTGGAGGTCACAG",3,14,7,0,4,28,752
"CCTTTGGGTAGCTGAG",11,52,39,6,36,144,7227
"CCTTTGGGTGAGAACC",40,296,70,28,51,485,27726
"CCTTTGGGTGATTCTG",0,5,0,0,0,5,65
"CCTTTGGTCCCATGGG",2,5,3,0,0,10,298
"CCTTTGGTCGACCAAT",1,2,0,0,0,3,187
"CCTTTGGTCGTTGCCT",7,28,4,0,7,46,769
"CGAAGGAAGCATCGAG",0,12,3,0,3,18,47
"CGAAGGAAGGGCAACT",1,3,2,0,3,9,26
"CGAAGGACAGGGATAC",5,28,15,2,17,67,1751
"CGAAGGACAGGTTCGC",3,29,8,0,5,45,794
"CGAAGGATCCATAGGT",1,18,5,2,8,34,1018
"CGAAGTTAGACTCATC",1,4,0,0,2,7,75
"CGAAGTTCAATGACCT",1,23,4,0,0,28,138
"CGAAGTTCAGCTACTA",1,19,3,0,0,23,633
"CGAAGTTCAGTTGAAA",64,250,126,29,541,1010,46328
"CGAAGTTCATATGCGT",0,11,3,0,0,14,299
"CGAAGTTGTCTATGAC",7,89,19,2,19,136,4413
"CGAAGTTGTTCAAAGA",1,2,0,0,0,3,82
"CGAAGTTTCATCGCCT",4,22,2,0,6,34,176
"CGAATTGAGGTTCCGC",125,177,59,19,56,436,19138
"CGAATTGCACAAATCC",0,2,0,0,0,2,13
"CGAATTGCACGGCGTT",3,20,9,0,4,36,632
"CGAATTGCACTGTCCT",32,89,178,9,67,375,18705
"CGAATTGCATTCCTCG",0,4,0,0,2,6,303
"CGAATTGGTACGATGG",0,4,0,0,3,7,339
"CGAATTGGTGGATCAG",14,103,16,11,13,157,7429
"CGAATTGTCACTCTTA",5,27,9,0,5,46,947
"CGAATTGTCCGCCTAT",0,4,0,0,0,4,101
"CGAATTGTCCTCAGAA",2,5,0,0,3,10,540
"CGAATTGTCGACGATT",1,24,9,0,8,42,848
"CGAATTGTCTGGTGCG",1,2,0,0,0,3,34
"CGACAGCAGAGTGAAG",0,2,0,0,2,4,99
"CGACAGCAGATGACCG",3,22,6,0,5,36,379
"CGACAGCAGCCAAGTG",1,5,5,0,3,14,143
"CGACAGCCAATCCTAG",0,18,3,0,5,26,596
"CGACAGCCAGTCTTCC",3,28,7,0,4,42,1587
"CGACAGCGTAGAGGAA",1,4,0,0,0,5,71
"CGACAGCGTCACTGAT",0,0,0,0,0,0,16
"CGACAGCGTGGGACAT",3,25,12,2,3,45,105
"CGAGAAGGTATCCCAA",6,35,13,3,53,110,4885
"CGAGAAGGTGGAAGTC",1,2,2,0,4,9,247
"CGAGAAGTCCGATGCG",5,58,10,3,9,85,4687
"CGAGAAGTCTACACAG",0,0,0,0,0,0,7
"CGAGAAGTCTCCTACG",2,4,3,0,2,11,654
"CGAGAAGTCTGGTCAA",0,3,0,0,2,5,137
"CGAGAAGTCTTCGACC",2,9,2,0,0,13,153
"CGAGGAACAAATGAAC",0,4,2,0,4,10,323
"CGAGGAACACACGTGC",0,18,5,3,6,32,303
"CGAGGAACACGCCAGT",0,2,0,0,0,2,156
"CGAGGAACACTAGTAC",20,111,74,124,39,368,15284
"CGAGGAACATCACGGC",1,10,2,0,3,16,319
"CGAGGAACATCGTCCT",1,21,3,0,2,27,472
"CGAGGAAGTAAGCAAT",1,5,5,0,0,11,215
"CGAGGAAGTCTCTCAC",2,17,6,0,4,29,770
"CGAGGAAGTTACGTAC",1,15,3,0,5,24,361
"CGAGGAATCGGAGTAG",2,11,9,0,5,27,476
"CGAGGCTAGACTTCGT",2,13,4,0,4,23,42
"CGAGGCTCAAACCGGA",1,8,3,0,0,12,242
"CGAGGCTCAGCGGTTC",6,28,25,2,9,70,2507
"CGAGGCTGTACGACTT",1,4,17,0,0,22,1398
"CGAGGCTGTGATGAAT",0,0,0,0,2,2,84
"CGAGGCTTCAAACCCA",8,51,10,2,9,80,2489
"CGAGTGCCACACGTGC",1,17,8,0,0,26,322
"CGAGTGCGTGGACCAA",0,3,0,0,2,5,59
"CGAGTGCTCAGATTGC",0,6,2,0,3,11,542
"CGAGTGCTCCAAGAGG",2,12,6,0,5,25,948
"CGAGTTACACCAGTAT",26,91,71,8,134,330,15154
"CGAGTTACACTCCACT",0,5,2,0,2,9,70
"CGAGTTAGTATCATGC",4,18,5,2,3,32,667
"CGAGTTAGTCCCTGTT",0,2,0,0,0,2,68
"CGAGTTAGTCGACTGC",2,22,5,4,4,37,905
"CGAGTTAGTCGACTTA",0,17,3,2,4,26,679
"CGAGTTAGTCTTGTCC",0,0,0,0,0,0,16
"CGAGTTATCACCTTAT",0,0,0,0,0,0,30
"CGAGTTATCATACGAC",1,16,3,0,3,23,527
"CGAGTTATCATAGCAC",1,9,0,0,2,12,128
"CGAGTTATCCTCAGAA",3,22,10,0,4,39,437
"CGAGTTATCTACTTCA",1,25,8,0,5,39,960
"CGAGTTATCTGGACTA",2,19,11,2,0,34,600
"CGATCGGAGAATCTAG",144,1291,334,88,239,2096,88517
"CGATCGGAGCATACTC",3,21,7,2,4,37,585
"CGATCGGCAAAGGTTA",0,3,0,0,0,3,60
"CGATCGGCAATTGCCA",0,3,0,0,0,3,14
"CGATCGGCACCGGAAA",71,44,19,4,14,152,7419
"CGATCGGCAGACGATG",2,20,6,0,5,33,764
"CGATCGGGTAGCACAG",5,21,13,2,8,49,1086
"CGATCGGGTCTACGAT",5,25,4,0,6,40,690
"CGATCGGGTGCTAGCC",1,9,3,0,0,13,90
"CGATCGGTCCATCCGT",0,5,0,0,0,5,246
"CGATCGGTCCCTAGGG",2,8,4,0,3,17,831
"CGATCGGTCTGTCAGA",1,19,4,0,4,28,262
"CGATGCGAGGAACTCG",0,3,0,0,0,3,94
"CGATGCGCAACCGTAT",2,21,5,2,3,33,220
"CGATGCGGTCTAACTG",2,16,6,0,4,28,756
"CGATGCGGTTGAAGTA",0,0,2,0,2,4,106
"CGATGGCAGAGATGCC",1,33,10,0,3,47,1234
"CGATGGCAGCCTGACC",1,3,0,0,0,4,74
"CGATGGCAGGAAAGGT",2,4,0,0,0,6,67
"CGATGGCAGTGGTGAC",20,71,27,15,108,241,12217
"CGATGGCCACCGTACG",1,12,4,0,3,20,448
"CGATGGCCAGCCCACA",1,4,2,0,2,9,153
"CGATGGCGTCACGCTG",2,23,5,0,15,45,1654
"CGATGGCTCCCTCATG",2,22,6,0,2,32,728
"CGCAGGTAGCGAAACC",1,4,4,0,3,12,206
"CGCAGGTAGGGATCTG",2,8,0,0,0,10,632
"CGCAGGTAGGTTACAA",29,152,34,9,30,254,11197
"CGCAGGTCACGTGTGC",1,20,7,0,2,30,581
"CGCAGGTGTGGCCTCA",22,51,15,4,13,105,5418
"CGCAGGTTCACCTCAC",1,5,2,0,0,8,153
"CGCATAAAGCTCTATG",0,0,0,0,0,0,26
"CGCATAAAGGACTGGT",1,10,0,0,0,11,15
"CGCATAAAGGCTGGAT",1,5,0,0,0,6,84
"CGCATAAAGTAATCCC",3,17,3,0,6,29,987
"CGCATAACAACATCGT",1,3,2,0,0,6,93
"CGCATAACAATCCAGT",0,0,3,0,0,3,34
"CGCATAACACGCCAGT",0,10,2,0,0,12,215
"CGCATAACATAGCTGT",1,4,0,0,0,5,65
"CGCATAACATTCTCTA",2,20,4,0,8,34,666
"CGCATAAGTAGTCTTG",1,15,2,0,5,23,497
"CGCATAAGTATGCGGA",4,22,8,0,2,36,679
"CGCATAATCCGCTAGG",0,5,0,0,0,5,87
"CGCATAATCTATCGCC",0,4,0,0,0,4,101
"CGCATAATCTGGCCGA",16,69,106,8,113,312,14011
"CGCATGGAGTACTGGG",0,11,5,0,0,16,268
"CGCATGGCACGGTGCT",6,18,7,2,6,39,566
"CGCATGGGTATAATGG",0,5,0,0,2,7,98
"CGCATGGGTTGCACGC",2,4,0,0,0,6,99
"CGCATGGTCACCTCTG",0,9,5,0,0,14,498
"CGCATGGTCGACCAAT",0,2,0,0,0,2,35
"CGCCAGAAGTGCACTT",0,12,0,0,0,12,254
"CGCCAGAAGTTTCGGT",0,7,3,0,0,10,81
"CGCCAGACACTCCTTG",0,0,0,0,0,0,1
"CGCCAGAGTCTACTGA",147,1139,241,72,385,1984,98152
"CGCCAGATCGCCTTGT",3,23,14,4,60,104,5433
"CGCCATTAGCGAAACC",1,6,3,0,0,10,239
"CGCCATTAGGACACTG",2,25,13,0,3,43,1120
"CGCCATTAGGCTCTCG",0,6,0,0,0,6,173
"CGCCATTAGTATTCCG",28,111,92,21,177,429,12231
"CGCCATTCAGGTCCGT",0,0,0,0,0,0,60
"CGCCATTCAGTAACCT",0,6,3,0,0,9,154
"CGCCATTCAGTCTTCC",0,5,0,0,0,5,124
"CGCCATTCATTCAGGT",0,7,0,0,0,7,183
"CGCCATTTCAGTCAGT",0,3,0,0,0,3,150
"CGCCATTTCGGAGTAG",0,5,0,0,0,5,147
"CGCGTGAAGAGCCGTA",61,617,122,22,91,913,28570
"CGCGTGACAACCGCCA",0,4,0,0,0,4,41
"CGCGTGACACCTCTGT",0,3,2,0,0,5,115
"CGCGTGAGTAGAGCTG",3,17,9,3,0,32,424
"CGCGTGATCCACAGGC",16,64,166,12,38,296,12725
"CGCGTGATCCACCTGT",0,12,0,0,2,14,244
"CGGAACCAGATCCAAA",3,12,12,2,3,32,712
"CGGAACCCAGGTTCAT",1,4,0,0,3,8,170
"CGGAACCCAGTTTGGT",0,9,0,0,2,11,132
"CGGAACCCATGGGTTT",0,2,0,0,0,2,76
"CGGAACCGTCCTACGG",0,0,0,0,0,0,31
"CGGAACCTCATTGCTT",1,26,15,2,7,51,1171
"CGGAACCTCGGAATTC",0,4,7,0,3,14,202
"CGGAACCTCTCGCCTA",4,24,12,0,6,46,584
"CGGAATTCAATTCTTC",2,18,4,0,7,31,419
"CGGAATTCACCGTGAC",0,5,0,0,0,5,64
"CGGAATTCACGACTAT",4,27,7,0,2,40,179
"CGGAATTCACGAGGTA",0,6,0,0,0,6,172
"CGGAATTCAGATCATC",4,20,10,2,5,41,836
"CGGAATTTCCCAGGCA",5,5,0,0,2,12,609
"CGGAATTTCCCTAGGG",1,4,0,0,0,5,58
"CGGAATTTCGGTGTAT",0,2,0,0,0,2,16
"CGGAATTTCTGAACGT",1,5,5,0,3,14,374
"CGGACACAGAATCCCT",1,4,2,0,0,7,169
"CGGACACAGTTTGCTG",0,12,4,0,7,23,453
"CGGACACCACGATAGG",0,0,0,0,0,0,16
"CGGACACCACTGCGAC",0,3,0,0,0,3,126
"CGGACACCAGTTAGAA",8,36,24,2,15,85,3315
"CGGACACCATGGAACG",0,2,0,0,0,2,90
"CGGACACTCACCTGTC",2,4,0,0,0,6,313
"CGGACACTCATGAGAA",8,36,60,4,14,122,4592
"CGGACACTCCACGGAC",1,11,2,0,2,16,630
"CGGACACTCTCACTCG",1,7,3,0,2,13,256
"CGGAGAAAGCATGTTC",0,5,3,0,0,8,59
"CGGAGAACAAAGGGCT",0,4,2,0,4,10,611
"CGGAGAACACGGTAGA",1,3,3,0,0,7,141
"CGGAGAAGTAGTCGGA",20,25,10,3,6,64,1767
"CGGAGAATCATTACCT",0,8,0,0,0,8,116
"CGGAGAATCGTCGACG",0,11,0,0,0,11,43
"CGGAGAATCTACTGCC",0,12,5,0,3,20,288
"CGGCAGTCACCGTGAC",25,160,46,18,28,277,9911
"CGGCAGTCAGGTGACA",1,14,5,0,4,24,358
"CGGCAGTGTCGCATTA",0,5,2,0,0,7,164
"CGGCAGTTCAGCTAGT",5,29,10,3,3,50,838
"CGGCAGTTCCCTGGTT",9,52,9,7,13,90,3691
"CGGCAGTTCTCATGGA",12,13,6,0,2,33,1174
"CGGGACTAGTGATGGC",20,42,23,80,15,180,8094
"CGGGACTAGTTCCGTA",1,2,2,0,2,7,186
"CGGGACTGTCCTCCAT",2,2,0,0,0,4,96
"CGGGACTGTGCCTTTC",14,63,98,5,40,220,10631
"CGGGACTGTTGTTGCA",4,19,5,0,0,28,170
"CGGGACTGTTTGGCTA",0,3,3,0,0,6,17
"CGGGACTTCAGAACCT",0,5,0,0,0,5,421
"CGGGACTTCTCATGGA",0,3,2,0,0,5,32
"CGGGACTTCTCTGCCA",0,0,0,0,0,0,280
"CGGGCATAGGTTCTAC",1,19,5,0,3,28,648
"CGGGCATCACGAAAGC",0,5,0,0,0,5,102
"CGGGCATGTGTAAACA",0,5,2,0,4,11,183
"CGGGCATGTGTTCGAT",4,15,5,2,4,30,584
"CGGGCATTCAAGAGGC",154,1401,262,78,202,2097,102958
"CGGGCATTCACTGATG",0,0,0,0,0,0,29
"CGGGTCAAGACTTAAG",1,13,4,3,6,27,448
"CGGGTCAAGCCTGGAA",0,3,0,0,0,3,84
"CGGGTCAAGGCTAGCA",0,0,0,0,0,0,24
"CGGGTCACAACTAGAA",75,609,156,38,117,995,52522
"CGGGTCACAACTCCAA",2,9,0,0,0,11,344
"CGGGTCACACGCGCAT",15,97,22,6,20,160,6611
"CGGGTCACACTAGTAC",1,7,0,2,3,13,286
"CGGGTCAGTGACAACG",0,3,0,0,0,3,20
"CGGGTCAGTGTGTGGA",0,3,3,0,0,6,241
"CGGGTCAGTTCCTAGA",8,26,6,0,11,51,607
"CGGGTCATCGACTCCT",0,7,2,0,3,12,628
"CGGGTCATCGGATAAA",2,32,13,0,0,47,1006
"CGGGTCATCGTCCATC",1,4,3,0,0,8,186
"CGGGTCATCGTTATCT",1,14,5,0,0,20,513
"CGGGTCATCTCGAACA",1,8,4,3,0,16,208
"CGGGTCATCTGAACGT",0,2,0,0,0,2,51
"CGGGTGTAGAGAGTTT",3,9,9,0,7,28,588
"CGGGTGTAGCTCACTA",0,0,2,0,2,4,103
"CGGGTGTCAGAGGCAT",3,11,4,2,5,25,227
"CGGGTGTGTCATAGTC",4,31,12,0,4,51,384
"CGGGTGTGTGATTAGA",7,30,25,5,57,124,4967
"CGGGTGTGTGGGTTGA",25,71,35,15,128,274,12211
"CGGGTGTGTGTGTGGA",2,12,0,0,2,16,296
"CGGGTGTTCAACTGAC",2,9,2,0,0,13,140
"CGGGTGTTCTCTATGT",67,567,203,45,125,1007,46996
"CGGGTGTTCTGCATAG",1,10,2,0,3,16,86
"CGGTCAGGTTATAGCC",8,44,33,7,23,115,3586
"CGGTCAGTCACGGACC",25,229,49,10,44,357,14580
"CGTAAGTAGCAATTCC",1,5,2,0,2,10,158
"CGTAAGTCACTGGCGT",1,6,0,0,0,7,184
"CGTAAGTCATCCTATT",0,5,0,0,0,5,173
"CGTAAGTGTAACGCGA",0,3,0,0,0,3,5
"CGTAAGTGTGGAACAC",40,472,85,26,65,688,26009
"CGTAAGTGTTAGGAGC",2,13,3,0,3,21,541
"CGTAAGTTCGTGTGAT",0,11,0,0,0,11,151
"CGTAATGAGCGTACAG",2,10,8,0,3,23,406
"CGTAATGCACATGACT",238,116,54,20,55,483,18045
"CGTAATGCAGCATCTA",25,85,109,11,145,375,16640
"CGTAATGGTGAGAACC",4,20,7,3,5,39,652
"CGTAATGGTTGAGGAC",1,11,6,2,4,24,464
"CGTAATGTCAAGTCTG",8,70,14,4,13,109,4550
"CGTAGTAAGGAAGTGA",1,3,3,0,0,7,107
"CGTAGTAAGTCCTACA",0,3,0,0,0,3,32
"CGTAGTACAGCTGTCG",0,6,2,0,2,10,382
"CGTAGTAGTACGAGCA",0,7,0,0,0,7,121
"CGTAGTAGTATACCTG",26,247,64,17,109,463,26113
"CGTAGTAGTGCGAACA",65,49,22,5,16,157,7024
"CGTAGTATCCGATCTC",21,76,125,8,37,267,13226
"CGTAGTATCCTAGCGG",0,0,0,0,0,0,8
"CGTAGTATCGTTGTAG",0,12,5,2,4,23,504
"CGTCAAAAGCGGTAAC",1,3,2,0,0,6,118
"CGTCAAAAGGATTCCT",0,6,0,0,0,6,101
"CGTCAAACATCTAACG",1,4,0,0,0,5,124
"CGTCAAATCCACTGAA",3,25,7,0,6,41,921
"CGTCAAATCCGATTAG",4,12,2,0,9,27,373
"CGTCAAATCGTCTCAC",1,21,5,0,4,31,811
"CGTCAAATCTTGGTGA",1,9,3,0,3,16,287
"CGTCCATAGGTGGTTG",0,6,0,0,0,6,133
"CGTCCATAGTGGATAT",3,20,6,2,4,35,355
"CGTCCATCACAGCGCT",2,11,2,0,0,15,398
"CGTCCATCACTTGAGT",5,15,3,0,2,25,157
"CGTCCATCAGTCAGAG",4,28,23,6,7,68,1674
"CGTCCATCAGTGTACT",0,2,0,0,0,2,23
"CGTCCATCATCCGAGC",0,2,2,0,0,4,33
"CGTCCATCATTCTTCA",1,12,8,0,4,25,396
"CGTCCATGTGCATACT",1,5,2,0,0,8,148
"CGTCCATGTGTCCGGT",0,5,2,0,0,7,130
"CGTGAATAGGTCCTGC",6,22,3,0,6,37,278
"CGTGAATCAAGTATAG",5,14,2,0,6,27,42
"CGTGAATCACAGAGAC",1,2,0,0,0,3,80
"CGTGAATGTAGTCTTG",1,4,0,0,3,8,74
"CGTGAATTCAGTGGGA",0,5,0,0,0,5,14
"CGTGAATTCCGACGGT",4,14,5,0,3,26,800
"CGTGAATTCGCTAGCG",2,19,8,0,6,35,1569
"CGTGAATTCTACCAGA",26,232,48,17,40,363,16352
"CGTGATAAGGCAGCTA",2,5,2,0,0,9,94
"CGTGATACACGGGCTT",3,26,2,0,4,35,775
"CGTGATACACTGCGAC",1,6,2,0,0,9,79
"CGTGATACAGCGACAA",2,6,3,0,2,13,693
"CGTGATACAGCGACCT",18,89,29,9,14,159,4646
"CGTGATACATGACTAC",7,69,13,7,16,112,2486
"CGTGATACATGTGACT",43,386,105,23,64,621,28120
"CGTGATACATTATGCG",0,6,0,0,2,8,45
"CGTGATATCATTTGCT",2,21,8,0,18,49,1317
"CGTGATATCCCTGTTG",1,9,3,0,2,15,891
"CGTGCTTGTGCCCAGT",1,4,0,0,0,5,26
"CGTGTCTGTATGAGCG",0,0,0,0,0,0,40
"CGTGTCTGTCCGGCAT",51,562,103,22,67,805,32938
"CGTTAGAAGTTGAATG",0,10,0,0,0,10,246
"CGTTAGACATTCTCCG",33,238,97,21,46,435,22808
"CGTTAGAGTAACAGGC",1,7,5,0,0,13,56
"CGTTAGAGTATGGTTC",4,18,8,0,4,34,552
"CGTTAGAGTCTTTCAT",4,52,11,8,14,89,2869
"CGTTAGAGTGACACGA",3,25,11,0,8,47,604
"CGTTAGAGTTTGATCG",1,3,0,0,0,4,60
"CGTTAGATCATGGGAG",1,12,2,0,2,17,174
"CGTTAGATCCCTTGGT",10,21,9,2,4,46,778
"CGTTAGATCCTTATAC",6,16,7,0,2,31,600
"CGTTCTGAGCACTCAT",1,21,2,0,3,27,880
"CGTTCTGAGCGTATGG",3,14,3,2,0,22,481
"CGTTCTGCAATGTGGG",0,2,2,0,0,4,159
"CGTTCTGCAGCCGGTT",1,14,8,0,4,27,694
"CGTTCTGTCGTACACA",0,0,0,0,0,0,3
"CGTTGGGAGCGCTGAA",4,16,6,0,21,47,1388
"CGTTGGGAGGCACGAT",1,0,0,0,0,1,55
"CGTTGGGAGGCTGTAG",0,0,0,0,0,0,82
"CGTTGGGCAACGTAAA",16,57,119,6,25,223,11585
"CGTTGGGCATGACGAG",0,9,0,0,0,9,106
"CGTTGGGGTCTCACAA",1,2,0,0,2,5,25
"CGTTGGGGTTTCGATG",0,2,0,0,0,2,22
"CGTTGGGTCCAAAGGG",1,3,2,0,0,6,157
"CGTTGGGTCGGCTTCT",178,358,138,33,85,792,42961
"CGTTGGGTCGTAGAGG",2,6,3,3,0,14,228
"CTAACCCAGAGTCCGA",2,19,2,0,7,30,454
"CTAACCCAGCTTAAGA",18,118,23,7,12,178,9481
"CTAACCCCACAGTGAG",78,556,143,41,87,905,42362
"CTAACCCCATCGTCCT",1,12,2,0,0,15,655
"CTAACCCCATTGCTTT",4,31,48,4,10,97,3862
"CTAACTTAGAAGCCAC",0,0,0,0,0,0,20
"CTAACTTAGTGCTCGC",4,3,2,0,0,9,501
"CTAACTTAGTTGCATC",2,26,3,0,3,34,749
"CTAACTTCAGTTGAAA",9,61,20,2,5,97,127
"CTAACTTCATACACCA",5,32,17,8,6,68,1144
"CTAACTTCATTCTGTT",2,30,8,0,4,44,1144
"CTAACTTGTGCACATT",0,3,2,0,2,7,239
"CTAACTTTCCAATCCC",0,0,0,0,0,0,14
"CTAACTTTCCCAGGAC",26,93,64,8,34,225,11341
"CTAACTTTCCTGATAG",0,7,0,0,0,7,302
"CTAACTTTCTTCTGTA",0,2,2,0,2,6,31
"CTAAGTGAGACACACG",1,12,3,0,6,22,382
"CTAAGTGAGATAACGT",2,6,3,0,3,14,152
"CTAAGTGAGCTGTACT",1,23,6,2,4,36,550
"CTAAGTGAGTGCCAGA",13,59,13,2,10,97,3433
"CTAAGTGAGTGCTACT",0,0,0,0,0,0,24
"CTAAGTGCACCCTTAC",0,2,0,0,0,2,16
"CTAAGTGCATGCACTA",1,10,2,0,4,17,330
"CTAAGTGGTCGGCACT",1,2,3,2,0,8,118
"CTAAGTGGTGGTCTGC",4,26,3,0,5,38,605
"CTAAGTGTCCAACTAG",1,4,3,0,0,8,127
"CTAAGTGTCGCTTAAG",172,1995,431,77,274,2949,92647
"CTACAGAGTACGCTTA",1,5,2,0,0,8,44
"CTACAGAGTTTCGACA",2,18,5,0,3,28,627
"CTACAGATCAAGAAAC",1,11,2,0,0,14,89
"CTACAGATCCACACAA",0,2,0,0,0,2,219
"CTACAGATCCTACGGG",59,525,146,38,120,888,42126
"CTACAGATCTCCAATT",13,53,86,5,24,181,9271
"CTACATTAGTCGAAGC",142,1101,251,103,213,1810,79113
"CTACATTCAGCAGAAC",0,4,0,0,0,4,196
"CTACATTGTACTAACC",1,12,3,0,4,20,235
"CTACATTGTCGTACAT",2,2,0,0,0,4,219
"CTACATTTCATTGGTG",85,738,153,43,142,1161,63787
"CTACATTTCCTCTAAT",6,47,60,3,18,134,5200
"CTACATTTCGTAGCCG",0,4,0,0,0,4,120
"CTACATTTCGTGACTA",1,7,0,0,2,10,188
"CTACCCAAGCAGCCCT",2,0,0,0,0,2,42
"CTACCCACAATAGTAG",5,24,10,0,4,43,93
"CTACCCACAGTCGGTC",1,16,9,0,0,26,780
"CTACCCAGTCACCGCA",26,80,210,16,43,375,17195
"CTACCCAGTCGCATGC",0,5,0,0,0,5,156
"CTACCCAGTTAGCTAC",1,8,3,0,0,12,252
"CTACCCATCGAGCCTG",0,10,2,2,3,17,270
"CTACCCATCGCCACTT",2,4,2,0,0,8,140
"CTACCTGAGCAGAAAG",5,28,2,0,6,41,1050
"CTACCTGCAACAAGAT",6,30,2,2,5,45,973
"CTACCTGCATTGAAAG",1,4,0,0,0,5,214
"CTACCTGGTGAATGTA",1,12,7,0,6,26,513
"CTACCTGGTGATACAA",0,5,0,0,0,5,169
"CTACCTGGTGGATCGA",1,5,0,0,0,6,66
"CTACCTGGTTAGCGGA",0,0,0,0,0,0,22
"CTACCTGTCCCATGGG",3,26,3,0,5,37,637
"CTACCTGTCCCGAGAC",3,12,7,0,4,26,60
"CTACCTGTCGAACCAT",1,12,4,0,2,19,317
"CTACGGGAGGAACGCT",1,21,4,2,5,33,1120
"CTACGGGAGGGTGGGA",1,8,3,0,0,12,120
"CTACGGGAGTGTTGTC",0,18,4,0,4,26,270
"CTACGGGCATAATGCC",0,6,0,0,0,6,182
"CTACGGGGTGACTATC",4,16,6,0,28,54,2410
"CTACGGGGTGTCATGT",3,14,0,0,3,20,455
"CTACGGGTCAGATTGC",1,3,3,0,0,7,146
"CTACGGGTCCGCTGTT",0,6,0,0,0,6,106
"CTACGGGTCCGTAGGC",0,0,0,0,0,0,100
"CTACGGGTCGCAACAT",1,7,10,0,4,22,438
"CTACGGGTCTCTCTTC",89,289,199,41,716,1334,69962
"CTACTATCACAGCTGC",0,4,0,0,0,4,258
"CTACTATCATCGAACT",1,16,5,0,5,27,56
"CTACTATTCCGTTTCG",0,3,0,0,0,3,222
"CTACTATTCGTTCATT",0,4,4,0,0,8,216
"CTAGACAAGGTCATAA",0,10,0,0,2,12,158
"CTAGACAAGGTGAGAA",0,0,0,0,0,0,17
"CTAGACAGTTGGGACA",5,19,0,0,0,24,111
"CTAGACATCCGCAGTG",2,7,4,0,0,13,141
"CTAGACATCCTTACCG",0,2,2,0,0,4,171
"CTAGACATCGACCAAT",59,400,92,25,79,655,27886
"CTAGGTAAGACACACG",5,33,45,0,9,92,2902
"CTAGGTAAGGAGCAAA",20,130,28,9,26,213,11729
"CTAGGTACAACGTTAC",4,22,12,2,6,46,826
"CTAGGTACAAGACGGT",1,6,3,0,2,12,174
"CTAGGTACACGGCTAC",1,18,7,0,4,30,484
"CTAGGTACACGTATAC",18,154,39,8,29,248,11697
"CTAGGTACATCCGATA",4,18,10,0,9,41,1082
"CTAGGTACATCTCATT",3,25,11,2,9,50,741
"CTAGGTAGTCTTACTT",3,18,4,0,5,30,672
"CTAGGTATCGCATTGA",0,0,0,0,0,0,15
"CTAGGTATCTCTGAGA",4,20,7,0,2,33,679
"CTATAGGAGAAGCGCT",1,2,2,0,0,5,289
"CTATAGGAGCAAATGT",4,23,8,0,15,50,1386
"CTATAGGCAATGTGGG",53,108,31,7,32,231,8356
"CTATAGGTCATCTGTT",2,23,8,0,5,38,78
"CTATAGGTCTAAGAAG",0,13,0,0,0,13,266
"CTATCCGAGGACAGTC",2,9,6,2,7,26,590
"CTATCCGAGGAGTCTG",18,56,68,7,43,192,7347
"CTATCCGCAATACGAA",0,5,0,0,0,5,69
"CTATCCGCATTCACCC",0,12,4,0,5,21,755
"CTATCTACAATCGCGC",0,20,5,0,3,28,67
"CTATCTACACCAGCTG",1,3,0,0,2,6,95
"CTATCTACACTCCTGT",1,10,6,0,5,22,463
"CTATCTACAGCGAGTA",1,6,0,0,2,9,201
"CTATCTACATTCAGCA",4,30,8,4,3,49,1032
"CTATCTAGTATTTCTC",4,35,8,2,10,59,939
"CTATCTAGTTGTGCCG",3,32,35,2,10,82,3018
"CTATCTATCTTTCGAT",3,19,4,3,0,29,443
"CTCAACCCATGTACGT",19,73,126,11,33,262,12933
"CTCAACCTCGCTAATG",0,2,0,0,0,2,124
"CTCAACCTCGGCAGTC",20,62,27,8,108,225,7833
"CTCAACCTCTACTATC",55,249,62,23,67,456,15618
"CTCAACCTCTCGACCT",1,30,11,0,5,47,847
"CTCAACCTCTGGCCGA",0,2,0,0,0,2,67
"CTCAAGAAGCAGCAGT",187,559,127,42,108,1023,49931
"CTCAAGAAGGATAATC",0,6,3,0,0,9,147
"CTCAAGAAGGCTAAAT",6,26,5,0,4,41,630
"CTCAAGAAGTGATAGT",20,83,163,16,37,319,16442
"CTCAAGACACCTCTGT",1,5,0,0,0,6,95
"CTCAAGACAGCGAGTA",5,19,5,2,3,34,478
"CTCAAGAGTATGTCCA",32,168,69,19,205,493,23799
"CTCAAGAGTCAGTTTG",0,2,2,0,0,4,201
"CTCAAGATCGTTACCC",15,47,155,8,18,243,13392
"CTCAATTAGAAAGCGA",2,28,11,0,3,44,815
"CTCAATTAGAGAGCGG",3,41,7,2,8,61,1439
"CTCAATTAGAGCATAT",1,13,2,0,0,16,312
"CTCAATTAGGTTCCGC",36,137,53,16,49,291,14721
"CTCAATTCATTGAGCT",0,0,0,0,0,0,27
"CTCAATTGTATGCAAA",6,47,4,5,10,72,937
"CTCAATTGTCGCGGTT",137,154,54,24,40,409,12532
"CTCAATTTCTCTGCTG",0,5,0,0,3,8,131
"CTCACTGAGATTAGTG",5,27,5,3,8,48,609
"CTCACTGAGCTGCCAC",0,2,0,0,2,4,163
"CTCACTGCAACAAGTA",0,4,2,0,0,6,104
"CTCACTGCATTGCCGG",37,166,137,18,144,502,21539
"CTCACTGTCAGACCGC",1,16,5,0,5,27,898
"CTCACTGTCGCTCTCA",0,0,0,0,0,0,67
"CTCAGAAAGGCGTTGA",1,3,3,0,2,9,199
"CTCAGAAAGGCTTTCA",0,4,2,0,0,6,117
"CTCAGAACAAGTAGTA",0,3,0,0,0,3,95
"CTCAGAACACGACAAG",2,6,0,0,0,8,179
"CTCAGAACAGAAACCG",62,419,115,36,90,722,32069
"CTCAGGGAGCGCAATG",1,3,2,0,0,6,204
"CTCAGGGCAACTTGCA",1,6,0,0,0,7,454
"CTCAGGGCACATAGCT",12,42,65,0,19,138,8254
"CTCAGGGGTTATGGTC",0,2,0,0,2,4,114
"CTCAGGGTCATGACAC",2,6,0,0,2,10,150
"CTCAGGGTCCAGTTCC",1,7,3,0,2,13,540
"CTCAGGGTCGACGCGT",30,185,61,8,44,328,16133
"CTCAGGGTCGATACTG",0,0,0,0,0,0,4
"CTCAGTCAGAACAGGA",0,0,0,0,2,2,48
"CTCAGTCAGCATCAGG",0,9,3,0,0,12,402
"CTCAGTCAGGGAGGCA",0,3,3,0,0,6,90
"CTCAGTCAGGTTCCGC",1,14,6,2,5,28,802
"CTCAGTCCAATTCACG",0,3,0,0,3,6,97
"CTCAGTCCAGATCATC",3,22,6,0,5,36,1310
"CTCAGTCGTGTTTGCA",1,8,3,0,3,15,124
"CTCAGTCTCCTGGGTG",1,8,0,0,0,9,132
"CTCAGTCTCGGACGTC",0,3,3,0,0,6,76
"CTCATCGCAAACCATC",2,24,6,0,0,32,990
"CTCATCGCATCTATCT",133,581,140,50,123,1027,55061
"CTCATCGGTACTGAGG",2,19,3,0,4,28,686
"CTCATCGGTCGTCGGT",0,0,0,0,0,0,6
"CTCATCGGTGTGTGTT",0,3,0,0,0,3,116
"CTCATCGTCATGCCAA",0,3,0,0,0,3,190
"CTCATCGTCTACTGAG",3,22,23,3,11,62,3101
"CTCATCGTCTGTCAGA",63,72,24,2,18,179,7114
"CTCATGCCAACCTAAC",12,88,27,14,107,248,8374
"CTCATGCCAGTCGCAC",4,21,4,2,6,37,725
"CTCATGCGTGAATGTA",0,4,0,2,0,6,117
"CTCATGCTCACTCCGT",1,4,0,0,0,5,181
"CTCATGCTCTGTCGTC",1,13,6,0,4,24,654
"CTCATTACAAGGCGTA",45,356,101,22,67,591,24928
"CTCATTACACACGCCA",1,7,0,0,0,8,260
"CTCATTACAGCTACAT",0,2,3,0,0,5,242
"CTCATTACAGTAACGG",1,6,2,0,3,12,260
"CTCATTACATAATGAG",3,15,15,2,3,38,1765
"CTCATTATCACCCATC",3,41,16,2,11,73,1606
"CTCCAACAGACTTAAG",9,35,19,8,42,113,3798
"CTCCAACAGCACTAAA",1,39,13,2,8,63,1199
"CTCCAACAGGGATGTC",0,18,5,2,4,29,542
"CTCCAACCACATACTG",0,2,0,0,0,2,86
"CTCCAACCACGACAAG",2,18,4,0,3,27,790
"CTCCAACCACGCAAAG",0,0,0,0,0,0,11
"CTCCAACTCAACGAGG",0,0,0,0,0,0,207
"CTCCAACTCACACCCT",0,9,0,0,0,9,220
"CTCCACAGTGGTCTGC",0,6,2,0,2,10,306
"CTCCACATCGAACCAT",0,5,2,0,0,7,96
"CTCCATGAGGCTCACC",0,3,0,0,0,3,244
"CTCCATGAGTATGATG",2,13,2,0,7,24,129
"CTCCATGAGTCGAAAT",0,5,3,0,0,8,245
"CTCCATGAGTTGCTGT",8,30,29,3,26,96,4068
"CTCCATGCAACAACAA",2,28,7,0,2,39,684
"CTCCATGTCCTCGCAT",0,0,0,0,0,0,20
"CTCCATGTCGCTATTT",0,7,0,0,4,11,164
"CTCCATGTCTCCCAAC",0,0,0,0,0,0,18
"CTCCCAACAGTTACCA",2,10,0,0,0,12,191
"CTCCCAACATCGGAAG",1,0,0,0,0,1,105
"CTCCCAAGTCGAATTC",1,4,2,0,0,7,281
"CTCCCAAGTCGAGCTC",88,787,164,59,151,1249,64867
"CTCCCAAGTGTAAACA",3,22,4,0,4,33,495
"CTCCCAAGTTAGTCGT",0,0,4,0,0,4,160
"CTCCCAATCCAACCGG",12,48,96,7,22,185,6499
"CTCCCTCGTATCAGGG",1,6,0,0,0,7,215
"CTCCCTCTCCGTTTCG",0,3,0,0,2,5,156
"CTCCCTCTCGACCATA",1,0,2,0,0,3,229
"CTCCGATAGAATTCAG",2,16,4,2,7,31,665
"CTCCGATAGCGTGAAC",0,5,0,0,0,5,153
"CTCCGATAGGATTACA",20,51,16,0,35,122,4758
"CTCCGATAGGCATGCA",0,0,0,0,0,0,13
"CTCCGATAGTTCAACC",1,11,2,0,0,14,416
"CTCCGATCATCATCCC",1,2,0,0,0,3,80
"CTCCGATTCCCTTGTG",0,0,0,0,0,0,16
"CTCCTCCAGATTGCGG",0,4,0,0,0,4,129
"CTCCTCCAGCATAGGC",41,143,253,27,202,666,39159
"CTCCTCCCACCCGTAG",13,72,145,3,24,257,10793
"CTCCTCCCAGAGGCAT",0,0,0,0,0,0,52
"CTCCTCCCAGCTCCTT",0,2,0,0,0,2,101
"CTCCTCCGTCACTACA",0,17,9,0,4,30,810
"CTCCTCCGTCGACTGC",4,16,8,0,2,30,761
"CTCCTCCGTCGGTAAG",0,10,2,0,0,12,121
"CTCCTCCGTCTACATG",62,176,103,37,391,769,38105
"CTCCTCCGTGTTGAGG",2,4,2,0,0,8,157
"CTCCTCCGTTAGAAGT",0,4,0,0,0,4,150
"CTCCTCCTCCCGAATA",0,4,2,0,0,6,77
"CTCCTTTAGTTGGGAC",1,5,5,0,3,14,104
"CTCCTTTGTACAGTCT",0,3,0,0,0,3,208
"CTCCTTTGTCTTGCTC",0,6,3,0,0,9,111
"CTCCTTTTCAGCGCGT",3,28,22,2,4,59,1379
"CTCCTTTTCAGGCGAA",7,25,6,4,2,44,1289
"CTCGAGGAGCAGCCCT",1,24,6,0,5,36,397
"CTCGAGGAGCGATGAC",0,4,0,0,0,4,112
"CTCGAGGCAAGCAGGT",1,33,8,3,5,50,1068
"CTCGAGGCACATGAAA",2,12,7,2,3,26,912
"CTCGAGGCAGGGTTGA",22,30,9,3,9,73,2214
"CTCGAGGGTAGGCTGA",0,0,3,0,4,7,94
"CTCGAGGGTTGAGGAC",0,6,2,0,3,11,150
"CTCGAGGTCACTCTTA",2,3,0,0,0,5,170
"CTCGAGGTCAGTGTCA",0,10,0,0,3,13,101
"CTCGAGGTCATGTCTT",2,5,0,0,2,9,79
"CTCTCAGAGAAATTGC",1,12,5,0,0,18,354
"CTCTCAGAGCACTCAT",1,10,0,0,0,11,135
"CTCTCAGAGGACCCAA",1,8,2,0,0,11,197
"CTCTCAGAGGCTGGAT",2,4,0,0,2,8,75
"CTCTCAGAGTGCGACA",4,26,8,2,2,42,88
"CTCTCAGCAACGTAAA",2,20,7,0,4,33,566
"CTCTCAGCACTAGTAC",1,0,0,0,0,1,28
"CTCTCAGCATGGCTGC",3,9,4,2,6,24,468
"CTCTCAGGTAGACACG",0,0,0,0,0,0,38
"CTCTCAGGTCAGTCTA",1,17,3,0,4,25,1022
"CTCTCAGTCTTCTCAA",0,5,4,0,0,9,113
"CTCTCGAAGCATTTGC",7,31,13,0,7,58,2012
"CTCTCGAAGGCTAGCA",27,262,61,18,48,416,20556
"CTCTCGACAAGGTCAG",19,103,19,7,25,173,6180
"CTCTCGACAAGTGCAG",0,6,0,0,0,6,138
"CTCTCGACAATCCTAG",2,8,0,0,3,13,71
"CTCTCGACACATAACC",0,0,0,0,2,2,100
"CTCTCGAGTGAATGAT",0,5,0,0,0,5,10
"CTCTCGAGTGAGTAGC",2,5,2,0,3,12,273
"CTCTCGATCAGCAGAG",27,155,44,12,150,388,15094
"CTCTGGTAGCAACTCT",1,3,0,0,0,4,234
"CTCTGGTAGCCATGCC",1,9,3,0,5,18,636
"CTCTGGTAGCCTGTGC",0,0,0,0,2,2,66
"CTCTGGTAGCGGTAGT",1,7,2,0,5,15,98
"CTCTGGTAGTCGCGAA",0,6,0,0,0,6,95
"CTCTGGTAGTGCTCGC",3,16,3,0,4,26,1033
"CTCTGGTCAAAGGGCT",23,54,91,6,20,194,9001
"CTCTGGTCACGTGAGA",1,4,0,2,0,7,20
"CTCTGGTCAGAGGCTA",0,8,0,0,0,8,13
"CTCTGGTCAGTCGTTA",0,0,0,0,0,0,3
"CTCTGGTCATAGACTC",54,205,70,5,35,369,17770
"CTCTGGTCATCCGTGG",1,2,0,0,0,3,20
"CTCTGGTGTGAACTAA",4,14,4,0,0,22,519
"CTCTGGTGTGCCGGTT",2,16,8,0,6,32,701
"CTGAATGAGCTCATAC",0,0,0,0,0,0,13
"CTGAATGCAATCAAGA",1,6,2,0,0,9,173
"CTGAATGGTATGATCC",2,12,5,0,5,24,672
"CTGAATGGTATGCGGA",6,19,4,0,6,35,470
"CTGAATGGTGCGGTAA",2,2,0,0,0,4,98
"CTGAATGGTTACCCTC",2,6,2,0,0,10,162
"CTGAGCGAGACGACTG",1,0,0,0,0,1,46
"CTGAGCGAGTCATCGT",0,7,2,0,0,9,112
"CTGAGCGAGTGCCTCG",185,114,97,15,52,463,19473
"CTGAGCGCAAATGAGT",0,5,2,0,5,12,290
"CTGAGCGGTACTCCCT",1,11,5,0,4,21,457
"CTGAGCGGTAGATGTA",39,310,72,21,58,500,28057
"CTGAGCGGTTACACTG",0,21,2,0,6,29,312
"CTGAGCGGTTGGGCCT",10,33,9,4,9,65,3084
"CTGAGCGGTTTACTTC",1,0,0,0,0,1,122
"CTGAGCGTCGAACGCC",0,0,0,0,0,0,3
"CTGAGGCAGACGATAT",8,33,52,4,12,109,5031
"CTGAGGCCACTCCACT",1,3,0,0,0,4,421
"CTGAGGCGTTACGGAG",36,283,64,21,54,458,26923
"CTGAGGCTCCACGAAT",0,2,0,0,0,2,15
"CTGAGGCTCTTACACT",0,7,0,0,0,7,80
"CTGATCCAGACCAAGC",0,7,0,0,0,7,146
"CTGATCCAGCTAGATA",1,7,0,0,0,8,173
"CTGATCCCACAGAAGC",0,0,0,0,0,0,9
"CTGATCCGTCGCCACA",1,7,0,0,2,10,303
"CTGATCCGTTAAGAAC",0,0,0,0,0,0,145
"CTGATCCGTTACACTG",1,5,2,0,2,10,172
"CTGATCCTCCTGGCTT",0,0,0,0,0,0,35
"CTGCAGGAGGCCCAAA",0,4,0,0,0,4,146
"CTGCAGGAGGGTAGCT",3,63,11,2,15,94,3967
"CTGCAGGAGTTACGAA",0,28,9,2,6,45,1018
"CTGCAGGCACCATTCC",44,375,84,24,84,611,22774
"CTGCAGGCAGAATTCC",1,9,0,0,0,10,324
"CTGCAGGGTACGATTC",0,6,0,0,0,6,77
"CTGCAGGGTCTTGCTC",1,0,0,0,2,3,77
"CTGCAGGTCCTTCTGG",0,0,0,0,0,0,83
"CTGCATCAGACCTCAT",2,0,2,0,4,8,131
"CTGCATCCACTCACTC",0,3,0,0,0,3,90
"CTGCATCCACTGCATA",56,225,110,28,494,913,47329
"CTGCATCGTAGCGCCT",0,2,0,0,0,2,9
"CTGCATCTCACCCTTG",57,429,91,24,73,674,31521
"CTGCATCTCTGACCCT",0,15,2,2,3,22,543
"CTGCATCTCTTGGATG",1,19,7,0,4,31,625
"CTGCCATCAAGCACAG",66,39,26,8,15,154,5800
"CTGCCATGTCTGGTTA",2,16,9,0,3,30,596
"CTGCCATGTGCATTTG",1,7,0,0,2,10,415
"CTGCCATTCCAACTAG",2,26,5,3,3,39,1083
"CTGCCATTCCGTGCGA",0,3,0,0,0,3,69
"CTGCCATTCGCGGACT",1,18,3,0,7,29,95
"CTGCCATTCTCAGTCC",0,5,0,0,0,5,172
"CTGCCTAAGAAATTGC",4,14,5,2,0,25,43
"CTGCCTAAGAGTCTGG",4,9,2,0,3,18,420
"CTGCCTACATCTTTCA",0,0,0,0,0,0,24
"CTGCCTAGTCATATGC",0,11,0,0,5,16,470
"CTGCCTAGTTCGGCCA",116,113,46,14,35,324,14509
"CTGCCTATCCGAAATC",1,21,6,0,3,31,787
"CTGCCTATCCGAGGCT",1,14,7,0,0,22,755
"CTGCGAGAGTGTACCT",7,64,26,2,15,114,3290
"CTGCGAGCAAGAGGCT",4,29,10,4,3,50,610
"CTGCGAGCAGACCTGC",3,33,6,0,6,48,938
"CTGCGAGCATGCCATA",11,44,67,6,20,148,6847
"CTGCGAGTCTGCGGAC",0,3,0,0,0,3,85
"CTGCTCACACGCTGAC",1,11,0,0,2,14,463
"CTGCTCACATCACGGC",9,23,9,0,6,47,793
"CTGCTCAGTAGGAGGG",1,3,2,0,0,6,53
"CTGCTCAGTCGAACAG",0,3,0,0,0,3,119
"CTGCTCATCACGGACC",0,11,4,0,0,15,252
"CTGCTCATCTACTTCA",1,0,0,0,0,1,17
"CTGGACGCAAAGGGCT",0,3,0,0,0,3,8
"CTGGACGCACGACGTC",1,12,2,0,0,15,284
"CTGGACGGTGGGATTG",0,7,0,2,0,9,120
"CTGGACGTCAAGCCCG",0,5,2,0,0,7,144
"CTGGACGTCAGTCAGT",0,5,2,0,0,7,99
"CTGGACGTCGCCAGAC",0,10,7,0,2,19,140
"CTGGCAGAGAACTCCT",0,25,6,0,0,31,678
"CTGGCAGAGCTAGAAT",0,7,3,0,0,10,108
"CTGGCAGCAGAGGTTG",17,51,26,5,81,180,8660
"CTGGCAGGTATCGTGT",1,2,5,0,2,10,175
"CTGGCAGGTCGTTGCG",2,6,0,0,0,8,157
"CTGGCAGGTTTGGGAG",24,165,36,8,27,260,10741
"CTGGCAGTCACGGTCG",1,2,0,0,0,3,60
"CTGGCAGTCCGAGGCT",30,191,88,20,208,537,21561
"CTGGCAGTCGTGGCGT",4,19,44,5,10,82,2668
"CTGGCAGTCGTTGTTT",21,74,370,9,32,506,9567
"CTGGCAGTCTCCGATC",0,3,2,0,0,5,295
"CTGGCAGTCTGGGTCG",0,9,0,0,0,9,75
"CTGGTCTAGATAGGGA",8,52,14,0,11,85,2855
"CTGGTCTAGCGATTCT",1,9,2,0,0,12,187
"CTGGTCTAGGTACCTT",7,33,54,4,13,111,5131
"CTGGTCTCACTGAGTT",0,3,2,0,0,5,87
"CTGGTCTCAGCATTGT",138,1121,261,60,215,1795,90845
"CTGGTCTTCGCGTGCA",1,5,0,0,2,8,567
"CTGTACCCACTCCGGA",0,0,0,0,0,0,18
"CTGTACCGTTTCGCTC",0,4,2,0,0,6,111
"CTGTACCTCCCAGTGG",36,68,17,81,23,225,7112
"CTGTACCTCTCTAAGG",7,37,48,3,8,103,4574
"CTGTAGAAGGACGGAG",7,30,7,3,5,52,2131
"CTGTAGAAGTAAACGT",1,16,5,0,2,24,282
"CTGTAGAAGTTCTACG",1,12,3,0,4,20,391
"CTGTAGACAGCGACAA",1,25,5,0,8,39,570
"CTGTAGACATGGGCAA",2,21,0,0,0,23,368
"CTGTAGAGTGTTAGCT",6,33,4,0,6,49,136
"CTGTAGAGTTGCTAGT",1,3,0,0,0,4,127
"CTGTAGATCCACTTCG",0,16,5,0,3,24,493
"CTGTAGATCCGTCACT",1,24,0,0,4,29,278
"CTGTAGATCGTGTGGC",1,4,2,0,2,9,204
"CTGTATTAGAAGCCAC",5,31,16,3,35,90,3424
"CTGTATTCAACCGTGC",2,2,4,0,0,8,83
"CTGTATTCACACGTGC",3,29,7,2,8,49,1013
"CTGTATTCAGAGTTCT",5,24,25,2,8,64,1717
"CTGTATTCAGTACTAC",0,5,2,0,0,7,201
"CTGTATTTCCTACACC",4,35,16,3,5,63,1852
"CTGTATTTCGATGCAT",24,114,38,11,42,229,11350
"CTGTATTTCGTCAGAT",1,2,3,0,0,6,50
"CTGTATTTCTGACCCT",0,21,4,0,0,25,433
"CTGTCGTAGCTTTCTT",2,18,6,0,8,34,1088
"CTGTCGTCATAAGATG",0,2,3,0,0,5,56
"CTGTCGTCATGAATAG",1,8,3,0,2,14,60
"CTGTCGTCATGCAGCC",1,19,4,2,8,34,552
"CTGTCGTGTCTGTCAA",7,23,27,0,4,61,1148
"CTGTCGTTCCCTCTAG",0,0,0,0,0,0,117
"CTGTCGTTCGACACTA",0,0,0,0,0,0,36
"CTGTGAAAGAGTTCGG",0,4,2,0,0,6,38
"CTGTGAAAGATTGCGG",26,176,40,11,36,289,14734
"CTGTGAAAGGAGTATT",2,13,7,0,5,27,433
"CTGTGAACAAGGCGTA",0,2,0,0,2,4,56
"CTGTGAACACAGCCTG",2,19,7,0,0,28,771
"CTGTGAACAGTGTGCC",0,2,4,0,0,6,176
"CTGTGAAGTCGTGGTC",1,5,0,0,0,6,107
"CTGTGAATCATTACCT",1,3,2,0,0,6,88
"CTGTGGGCAGTCAGTT",0,2,0,0,0,2,39
"CTGTGGGCATTGCTTT",0,6,0,0,2,8,188
"CTGTGGGGTACTAACC",4,29,11,0,32,76,3050
"CTGTGGGTCTATTGTC",2,11,4,0,3,20,500
"CTTACCGAGAAGCGAA",1,8,3,0,2,14,212
"CTTACCGAGAGTTGTA",0,3,4,0,0,7,237
"CTTACCGAGCACTCCG",2,22,8,0,0,32,701
"CTTACCGAGCGCTTCG",4,9,5,2,3,23,569
"CTTACCGAGTCTCCTC",0,6,3,0,2,11,109
"CTTACCGCAACACAGG",0,5,0,0,0,5,94
"CTTACCGCACGAAAGC",25,76,176,3,40,320,17217
"CTTACCGGTCATGACT",0,2,0,0,0,2,8
"CTTACCGGTGCGTGCT",1,11,0,0,3,15,274
"CTTACCGTCAGCTTGA",2,4,0,2,0,8,191
"CTTAGGAAGCTTTCCC",1,9,3,0,2,15,176
"CTTAGGAAGGACAAGA",22,160,37,13,46,278,13978
"CTTAGGAAGGATGCGT",0,3,2,0,0,5,35
"CTTAGGAAGTACAGAT",0,4,2,0,0,6,36
"CTTAGGAAGTCTCGTA",0,5,0,0,0,5,33
"CTTAGGACAAACGTGG",0,8,0,0,0,8,149
"CTTAGGACAAGCAATA",1,6,2,0,0,9,177
"CTTAGGACACTTTAGG",73,181,434,35,107,830,40227
"CTTAGGAGTTTGGGAG",1,5,0,0,0,6,270
"CTTAGGATCCCGAGTG",0,2,0,0,0,2,8
"CTTAGGATCGTCTACC",19,112,138,11,34,314,16129
"CTTCAATAGCTGCCTG",1,6,3,0,3,13,151
"CTTCAATAGTGCTAGG",2,6,2,0,0,10,75
"CTTCAATCAATAACCC",1,7,5,0,5,18,230
"CTTCAATCAGATCACT",0,9,0,0,0,9,256
"CTTCAATCATCAGTGT",4,23,7,0,5,39,885
"CTTCAATCATTACGGT",1,12,2,2,0,17,201
"CTTCAATGTCGCAACC",0,0,0,0,0,0,43
"CTTCAATGTCTTGCTC",6,28,21,0,9,64,2056
"CTTCAATTCACTGATG",0,11,8,0,2,21,46
"CTTCAATTCACTGCTC",0,6,2,0,0,8,292
"CTTCAATTCATGTCAG",1,3,4,0,0,8,198
"CTTCAATTCGCATTGA",0,3,0,0,0,3,7
"CTTCCGAAGACTAGAT",1,5,0,0,0,6,31
"CTTCCGAAGGGCAGAG",1,15,5,0,5,26,183
"CTTCCGAAGTTCGCAT",0,0,3,0,0,3,129
"CTTCCGACAATTTCGG",2,11,4,2,0,19,413
"CTTCCGACACCTGCAG",36,140,145,13,50,384,16770
"CTTCCGAGTCCACTCT",3,12,3,0,0,18,523
"CTTCCGATCATCACCC",0,13,6,0,6,25,63
"CTTCCGATCATCGACA",5,33,5,2,4,49,965
"CTTCCGATCATTTGCT",0,6,3,0,3,12,123
"CTTCCGATCTAACGGT",0,4,2,0,2,8,128
"CTTCCTTAGGTATAGT",2,7,0,0,0,9,84
"CTTCCTTAGTTGTACC",1,6,0,0,0,7,247
"CTTCCTTCAGGTCAAG",0,16,5,0,2,23,575
"CTTCCTTCATTGCTGA",10,103,27,4,19,163,8986
"CTTCCTTGTTAACCTG",45,369,91,27,83,615,31258
"CTTCCTTGTTGGACTT",1,30,5,2,0,38,879
"CTTCCTTTCGGCTCTT",2,4,0,0,0,6,113
"CTTCGGTAGGGTGAGG",1,21,6,0,6,34,484
"CTTCGGTCAGAACCGA",0,2,0,0,0,2,5
"CTTCGGTCAGAAGTTA",2,8,2,0,0,12,74
"CTTCGGTGTTGGGACA",2,6,0,0,4,12,117
"CTTCGGTTCAACCTTT",4,32,21,2,3,62,1898
"CTTCGGTTCAGACCTA",4,25,14,0,4,47,333
"CTTCGGTTCATGCCGG",5,14,4,0,5,28,501
"CTTCGGTTCCATCAGA",1,6,0,0,2,9,107
"CTTCGGTTCTAGGAAA",1,17,5,0,3,26,120
"CTTCGGTTCTTTCAGT",0,3,0,0,0,3,14
"CTTCTAAAGTTAGTGA",0,7,3,0,0,10,210
"CTTCTAACAACACACT",0,2,0,0,0,2,106
"CTTCTAACAGAAATTG",7,68,18,0,17,110,1544
"CTTCTAAGTAAGTAGT",1,9,3,0,0,13,173
"CTTCTAAGTGGACTGA",0,7,0,0,0,7,18
"CTTCTAATCGAACACT",1,0,0,0,0,1,5
"CTTCTCTAGAGCATAT",0,6,0,0,3,9,87
"CTTCTCTAGATCGCTT",0,5,4,0,2,11,212
"CTTCTCTCAAATGGTA",2,6,0,0,3,11,541
"CTTCTCTCACGCACCA",10,42,69,7,14,142,6567
"CTTCTCTCAGCATACT",16,40,14,2,11,83,2031
"CTTCTCTCAGCTATTG",3,41,5,2,3,54,1547
"CTTCTCTGTCTCAAGT",10,36,38,2,12,98,3557
"CTTCTCTTCTGGTGCG",3,31,7,6,8,55,2097
"CTTGAGACAAATTGGA",7,45,4,0,7,63,2460
"CTTGAGACAATTGCAC",0,4,3,0,0,7,173
"CTTGAGACACATCCCT",0,3,0,0,0,3,163
"CTTGAGACATCGCCTT",3,11,3,0,3,20,164
"CTTGAGAGTGCTCTTC",1,4,0,0,0,5,117
"CTTGAGATCATGCCCT",2,40,8,2,4,56,970
"CTTGAGATCTTACCGC",1,8,2,0,0,11,297
"CTTGATTCAGGGTTGA",5,23,8,4,34,74,4084
"CTTGATTGTGATCATC",0,6,0,0,4,10,66
"CTTGATTTCCAGGACC",4,26,6,2,5,43,1061
"CTTGATTTCCATACAG",1,5,0,0,3,9,171
"CTTGATTTCCTTCAGC",0,0,0,0,0,0,7
"CTTGATTTCTAACGGT",0,10,2,0,3,15,322
"CTTTCAAAGAGCTGCA",6,31,11,3,3,54,1003
"CTTTCAAAGGCGCTTC",0,3,3,0,0,6,100
"CTTTCAACAAGCGCTC",0,10,3,0,0,13,445
"CTTTCAACAAGGCCTC",48,134,93,26,314,615,31906
"CTTTCAAGTTGCGGCT",4,21,9,0,2,36,833
"CTTTCAATCGACGCGT",0,0,0,0,0,0,18
"CTTTCGGAGCAAGCCA",0,3,0,0,2,5,152
"CTTTCGGCAAGCAGGT",0,4,2,0,0,6,105
"CTTTCGGCAAGGACAC",2,4,2,0,0,8,119
"CTTTCGGCACTATCGA",27,168,62,153,51,461,18898
"CTTTCGGCAGAGTCAG",0,2,0,0,2,4,43
"CTTTCGGCATCGGTTA",1,8,3,0,3,15,373
"CTTTCGGGTCAGTCCG",6,39,8,0,4,57,1577
"CTTTCGGGTGAGATCG",1,15,3,0,2,21,262
"CTTTCGGTCCATACAG",222,228,86,23,73,632,30884
"CTTTCGGTCGAAATCC",1,15,11,2,5,34,889
"CTTTCGGTCGAGAAAT",2,4,3,0,0,9,106
"CTTTCGGTCTCTGGTC",1,3,0,0,0,4,174
"CTTTCGGTCTGCATGA",0,7,4,0,3,14,149
"CTTTCGGTCTGTGCAA",0,4,6,0,4,14,779
"GAAACCTAGCCATTTG",200,543,171,56,131,1101,48325
"GAAACCTAGTCTAGAA",4,19,3,0,4,30,386
"GAAACCTAGTGCAGCA",4,24,7,0,11,46,972
"GAAACCTGTAGAGATT",4,30,5,2,9,50,863
"GAAACCTTCGTCCTCA",0,10,5,0,2,17,68
"GAAACCTTCTCATTTG",219,1001,487,125,957,2789,127730
"GAAACCTTCTTGCAGA",1,5,0,0,0,6,50
"GAAACCTTCTTGGCTC",0,5,0,0,0,5,44
"GAAATGAAGCCTCTGG",2,10,2,0,0,14,259
"GAAATGACACACCTGG",1,4,2,0,2,9,348
"GAAATGACACGGTGCT",0,0,0,0,0,0,7
"GAAATGAGTAGACAGC",1,18,5,2,2,28,422
"GAAATGAGTTACGATC",2,7,0,0,0,9,80
"GAAATGATCTTCTCAA",3,5,0,0,0,8,85
"GAACACTAGACTCTAC",1,11,2,0,0,14,152
"GAACACTAGAGGGTGG",1,6,3,0,3,13,213
"GAACACTAGGTATAGT",3,7,0,0,0,10,205
"GAACACTCACGGATCC",1,25,6,3,2,37,743
"GAACACTCAGCTCCTT",0,0,0,0,2,2,41
"GAACACTGTTACACAC",2,22,6,0,7,37,1081
"GAACACTTCGGACTGC",1,9,7,2,5,24,402
"GAACGTTAGAAGAACG",0,9,5,0,3,17,295
"GAACGTTAGACTGTTC",1,2,0,0,0,3,41
"GAACGTTAGATGCCGA",0,24,6,0,4,34,691
"GAACGTTCAACTAGAA",0,5,0,0,0,5,93
"GAACGTTCAAGTTTGC",5,34,31,0,8,78,2506
"GAACGTTCAGCGTATT",0,2,0,0,0,2,17
"GAACGTTGTCTAATCG",0,0,0,0,0,0,3
"GAACGTTTCCATCACC",24,26,7,3,10,70,2701
"GAACTGTCACGCCAGT",0,5,3,0,5,13,520
"GAACTGTGTACTGCGC",1,0,0,0,0,1,73
"GAACTGTGTAGTCTTG",0,5,2,0,0,7,56
"GAACTGTGTCCATAGT",2,8,0,0,2,12,152
"GAACTGTGTGGATCGA",42,301,71,15,46,475,26034
"GAACTGTTCCGTGTGG",0,2,0,0,0,2,35
"GAACTGTTCTCAATCT",246,193,84,27,64,614,26909
"GAAGAATCAAGTGGAC",0,3,0,0,0,3,61
"GAAGAATGTTGGACTT",0,6,3,0,0,9,135
"GAAGAATTCTATACTC",5,23,6,2,7,43,729
"GAAGCCCAGAGTTGAT",2,8,2,0,0,12,254
"GAAGCCCAGCGAAACC",0,4,4,0,0,8,180
"GAAGCCCAGTTTAGGA",7,66,15,6,17,111,4350
"GAAGCCCCAGCGCTTG",9,102,26,3,17,157,6889
"GAAGCCCGTCCAGCGT",13,169,37,7,28,254,8018
"GAAGCCCGTCTGTCCT",8,30,16,5,56,115,2386
"GAAGCCCTCAGAGCGA",3,16,11,0,2,32,1521
"GAAGCGAAGTAAGCAT",0,2,6,0,2,10,90
"GAAGCGAAGTCTACCA",1,14,0,0,2,17,249
"GAAGCGACAACAACAA",19,61,80,10,65,235,10382
"GAAGCGACACTGCACG",207,554,138,35,129,1063,44132
"GAAGCGACATGCAGCC",1,6,0,0,2,9,135
"GAAGCGAGTGGTCCGT",0,3,0,0,0,3,5
"GAAGGACAGTAGAATC",0,0,0,0,0,0,6
"GAAGGACCAGAGGTAC",1,3,0,0,2,6,65
"GAAGGACCATATAGCC",2,28,6,0,4,40,965
"GAAGGACCATTCGGGC",3,17,7,2,7,36,261
"GAAGGACGTCTTTATC",0,4,2,0,0,6,122
"GAAGGACTCCTGTTGC",41,121,73,315,54,604,26615
"GAAGGACTCTGGGAGA",2,9,4,2,2,19,124
"GAAGGGTAGATACCAA",3,7,5,3,2,20,242
"GAAGGGTAGGAGGCAG",7,38,69,7,12,133,5469
"GAAGGGTAGGCAGTCA",0,2,0,0,0,2,5
"GAAGGGTAGTTGTACC",0,3,2,0,2,7,116
"GAAGGGTCACGTAGAG",3,22,10,0,4,39,413
"GAAGGGTGTCGCATCG",1,3,0,0,0,4,86
"GAAGGGTGTCTTTATC",0,10,0,0,0,10,156
"GAAGGGTGTGCGCTCA",0,5,2,0,0,7,116
"GAAGGGTGTGGAGGTT",1,5,0,0,2,8,242
"GAAGGGTTCAAATGAG",14,62,38,2,11,127,4863
"GAAGTAACAAGATGTA",124,346,1051,73,186,1780,97997
"GAAGTAACACAATGAA",0,3,0,0,0,3,23
"GAAGTAACATCAGCAT",0,2,0,0,0,2,118
"GAAGTAACATCGAACT",0,9,0,0,0,9,223
"GAAGTAAGTACCTTCC",2,14,4,0,2,22,694
"GAAGTAAGTTCTCTCG",0,2,4,0,0,6,15
"GAAGTAATCATGAAAG",2,30,9,6,7,54,813
"GAAGTAATCCACGGAC",0,5,2,0,0,7,99
"GAAGTAATCGCGAAGA",1,9,3,0,0,13,207
"GAAGTAATCGGAAGGT",5,26,12,4,20,67,2664
"GAAGTAATCTTCCGTG",3,29,6,3,4,45,646
"GAATAGAAGCTCCGAC",1,13,3,0,6,23,860
"GAATAGAGTACCTTCC",4,8,4,0,2,18,296
"GAATAGAGTGCGCTCA",23,148,44,12,32,259,10881
"GAATAGAGTGGCACTC",2,3,3,2,3,13,195
"GAATAGATCTCTGGTC",28,256,66,19,57,426,17460
"GAATAGATCTGAATCG",0,3,0,0,0,3,43
"GAATCACAGAGCTGCA",1,3,0,0,0,4,157
"GAATCACAGATAGTGT",1,2,0,0,0,3,273
"GAATCACAGCCGATAG",2,21,9,2,7,41,1066
"GAATCACAGCTAATGA",0,0,0,0,0,0,52
"GAATCACAGGTCATCT",32,181,87,10,35,345,15987
"GAATCACAGGTTCTAC",0,25,5,0,3,33,754
"GAATCACCAGATTCGT",55,164,381,27,200,827,39604
"GAATCACGTAATACCC",2,22,8,2,6,40,100
"GAATCACGTTTAAGGA",3,3,0,0,0,6,78
"GAATCACTCAACTACG",3,29,4,0,6,42,795
"GAATCACTCAATCCAG",2,7,0,0,0,9,197
"GAATCACTCGTTCCCA",1,28,2,2,6,39,500
"GAATCGTAGACGTCGA",0,2,0,0,0,2,44
"GAATCGTAGCCGTAAG",4,13,0,0,2,19,428
"GAATCGTAGCGAGTCA",0,3,0,0,0,3,9
"GAATCGTAGTCACAGG",0,5,0,0,3,8,92
"GAATCGTAGTTACGTC",2,8,0,0,5,15,114
"GAATCGTCACTTCATT",34,30,12,3,10,89,3207
"GAATCGTGTAGTGATA",0,0,0,0,0,0,4
"GACACGCAGCCACTCG",2,18,0,0,0,20,72
"GACACGCAGGGCGAGA",2,9,2,0,2,15,586
"GACACGCCACGAGGAT",0,0,0,0,4,4,49
"GACACGCGTACGTGTT",9,37,49,2,5,102,3960
"GACACGCGTATGTCCA",2,12,3,0,5,22,58
"GACACGCGTGCTTATG",1,11,14,2,5,33,1641
"GACACGCGTTCCTAGA",0,5,2,0,0,7,99
"GACACGCGTTCGAAGG",10,36,70,4,13,133,5956
"GACACGCGTTTAGACC",0,3,0,0,0,3,47
"GACACGCTCATGGTAC",2,7,3,0,0,12,72
"GACACGCTCGGAGTAG",1,26,5,0,3,35,715
"GACACGCTCTATCACT",0,3,0,0,0,3,93
"GACAGCCAGCGGATCA",3,14,2,0,3,22,508
"GACAGCCAGGAAAGGT",74,548,139,39,114,914,48829
"GACAGCCAGTGATAAC",4,21,8,0,9,42,1030
"GACAGCCCAAGGTCAG",5,48,8,7,6,74,2098
"GACAGCCGTGATCGTT",15,59,115,7,21,217,10084
"GACAGCCGTGCCTAAT",4,21,30,2,6,63,2363
"GACAGCCTCCCAGTGG",0,4,0,0,2,6,195
"GACAGCCTCGAGATAA",0,2,2,0,0,4,82
"GACAGCCTCGCTTGAA",0,3,0,0,4,7,220
"GACAGCCTCTGGTGGC",0,0,0,0,0,0,10
"GACATCAAGCTAGTTC",0,2,0,0,0,2,53
"GACATCACAACAGATA",114,58,21,9,29,231,6978
"GACATCACAAGCCTGC",0,4,0,0,0,4,103
"GACATCACAGACTCTA",5,33,5,0,15,58,616
"GACATCAGTTGGTGTT",6,19,38,3,6,72,3458
"GACCAATAGACGATAT",0,8,3,0,0,11,122
"GACCAATCAATGAAAC",21,54,131,9,66,281,13232
"GACCAATCACCCTGTT",46,174,345,29,162,756,38088
"GACCAATCACCTCAGG",0,9,2,0,2,13,152
"GACCAATGTCAAATCC",1,11,3,0,0,15,324
"GACCAATGTCACTTCC",1,4,0,0,0,5,104
"GACCAATGTGTTCAGT",0,4,0,0,3,7,283
"GACCAATTCGAGAAAT",3,31,12,3,3,52,1283
"GACCCAGGTGGAAGTC",2,6,0,0,2,10,207
"GACCCAGTCGGTCAGC",2,2,2,0,0,6,195
"GACCCAGTCGTTCTCG",1,6,0,0,0,7,162
"GACCCAGTCTCAACGA",0,3,0,0,0,3,277
"GACCCTTCACCAAATC",0,9,0,0,2,11,121
"GACCCTTGTGACTCGC",17,113,38,9,27,204,9338
"GACCCTTGTTGCGAAG",2,13,4,0,3,22,327
"GACCCTTTCGAAATCC",2,20,5,0,5,32,695
"GACCCTTTCTCGTCGT",4,19,12,2,11,48,966
"GACCGTGAGGTAGATT",6,8,2,0,3,19,340
"GACCGTGAGTAACGTA",0,0,0,0,0,0,42
"GACCGTGCAATAACCC",0,5,2,0,3,10,81
"GACCGTGCAGGTTCGC",49,330,110,20,195,704,28785
"GACCGTGGTGGCTGCT",18,19,5,2,10,54,1419
"GACCGTGGTGTACATC",1,3,0,2,0,6,74
"GACCGTGGTTCAGCTA",3,17,7,0,5,32,630
"GACCGTGTCATGTCTT",11,61,31,7,80,190,7321
"GACCTTCAGAGCCGTA",0,2,0,0,0,2,133
"GACCTTCAGCGGACAT",4,29,4,4,4,45,875
"GACCTTCCACCCTAGG",0,0,0,0,0,0,3
"GACCTTCCAGGCTATT",0,0,0,0,0,0,12
"GACCTTCGTACGTGTT",0,8,2,0,0,10,785
"GACCTTCGTGCTGCAC",0,8,0,0,0,8,83
"GACGCTGAGAGAGGGC",1,10,2,2,0,15,128
"GACGCTGCAGGACAGT",10,32,60,7,13,122,5706
"GACGCTGGTACAGGTG",0,4,3,0,0,7,127
"GACGCTGGTGATAGAT",0,0,0,0,0,0,46
"GACGCTGGTTTGGCTA",1,7,2,0,0,10,196
"GACGCTGTCCCTCATG",0,6,2,0,0,8,68
"GACGTTAAGCACGGAT",17,4,3,0,4,28,1386
"GACGTTACAAGAGTAT",43,109,180,21,147,500,25054
"GACGTTACAGACGCTC",20,69,150,18,32,289,15385
"GACGTTACATTCGATG",2,2,0,0,0,4,76
"GACGTTAGTCTTGAGT",0,2,0,0,0,2,69
"GACGTTAGTTAGAAAC",2,13,3,0,0,18,376
"GACGTTAGTTGCTTGA",2,14,2,0,0,18,299
"GACGTTATCCACTGGG",39,116,336,21,61,573,27251
"GACGTTATCTTACCAT",1,7,5,0,0,13,305
"GACTATGAGACATACA",0,0,0,0,0,0,3
"GACTATGAGAGTTGCG",1,6,0,0,2,9,126
"GACTATGAGGGCGAGA",0,2,0,0,0,2,8
"GACTATGAGTGAATAC",0,2,0,0,0,2,98
"GACTATGCACGCCAGT",55,156,38,9,36,294,12049
"GACTATGCAGCTGTCG",5,19,9,3,4,40,499
"GACTATGGTAGAGACC",1,27,9,0,5,42,101
"GACTATGGTATGCGTT",1,6,2,0,2,11,136
"GACTATGGTGAGGCAT",1,2,0,0,0,3,74
"GACTATGGTGCGCTCA",0,0,0,0,0,0,41
"GACTATGGTTGCTAGT",2,25,9,2,13,51,861
"GACTATGTCACGTAGT",41,36,9,2,7,95,3175
"GACTATGTCGTCCATC",5,23,7,0,4,39,688
"GACTATGTCTCGTTTA",0,9,0,0,0,9,172
"GACTCAAAGCGCGTTC",7,24,5,2,5,43,486
"GACTCAAAGTAACAGT",1,3,0,0,0,4,33
"GACTCAAAGTAGGAAG",2,0,0,0,0,2,63
"GACTCAACAACACGAG",1,6,3,0,0,10,166
"GACTCAACAGTTGAAA",1,6,0,0,3,10,234
"GACTCAAGTCCACGCA",0,0,0,0,0,0,13
"GACTCAAGTCGAGCAA",0,8,2,0,0,10,197
"GACTCAAGTGATTAGA",0,12,2,2,3,19,204
"GACTCAATCTCAAAGC",1,17,7,0,2,27,63
"GACTCAATCTGCTTAT",6,18,9,2,4,39,1071
"GACTCTCAGAGCTTTC",0,5,0,0,0,5,101
"GACTCTCCAGCGTATT",3,6,3,0,0,12,271
"GACTCTCCAGTTACCA",0,6,2,0,0,8,312
"GACTCTCCATAGACTC",0,0,0,0,0,0,6
"GACTCTCGTCAACGCC",148,1045,339,68,203,1803,97333
"GACTCTCGTCTACGTA",11,65,41,11,108,236,9052
"GACTCTCTCCAATCCC",1,0,0,0,0,1,82
"GACTCTCTCGATGGAG",10,50,17,7,64,148,5753
"GACTCTCTCTCGGGAC",3,11,3,0,3,20,446
"GACTCTCTCTCTGCCA",1,5,0,0,0,6,506
"GACTGATAGATGCCGA",0,5,0,0,0,5,14
"GACTGATCACCAGACC",0,3,0,0,0,3,69
"GACTGATCATAACGGG",4,43,12,0,8,67,1106
"GACTGATCATTGGGAG",0,3,0,0,3,6,134
"GACTGATGTGTTAAAG",0,6,3,0,2,11,111
"GACTGATTCAACTCTT",3,6,0,0,0,9,127
"GACTGATTCCTTCTTC",0,12,2,0,0,14,71
"GACTGATTCTTCTTCC",1,12,2,0,4,19,65
"GACTTCCAGGTTCATC",1,3,0,0,0,4,38
"GACTTCCAGGTTTGAA",3,17,4,0,3,27,916
"GACTTCCGTCGAGTTT",0,12,0,0,0,12,68
"GACTTCCGTTCTTGCC",3,14,3,0,3,23,433
"GACTTCCTCAACACGT",10,7,3,0,3,23,744
"GAGAAATAGATTCGAA",8,26,9,5,5,53,732
"GAGAAATCACTCTAGA",1,8,2,0,0,11,444
"GAGAAATCACTGGAAG",1,15,10,0,6,32,694
"GAGAAATCATCCGGCA",0,2,0,0,0,2,20
"GAGAAATGTACTGAGG",3,22,7,2,6,40,507
"GAGAAATGTGCCTACG",120,1001,188,61,151,1521,79135
"GAGACCCAGAGTCTTC",5,12,6,0,2,25,127
"GAGACCCAGCACCTGC",1,5,3,0,0,9,666
"GAGACCCGTATAATGG",17,130,31,13,20,211,8665
"GAGACCCTCACTGATG",0,10,2,0,0,12,171
"GAGACCCTCATTTGTC",2,10,3,0,2,17,126
"GAGACCCTCTCCGTGT",0,12,0,0,4,16,310
"GAGACTTAGTACGAGC",0,4,0,0,4,8,116
"GAGACTTCAAGAGATT",3,23,4,0,3,33,625
"GAGACTTCAGACAATA",0,9,2,0,3,14,187
"GAGACTTCAGTTGGTT",1,3,3,0,0,7,206
"GAGACTTGTAACATAG",1,10,0,0,0,11,27
"GAGACTTGTAATGCTC",0,0,0,0,0,0,53
"GAGACTTGTCTTCAAG",0,4,3,0,4,11,218
"GAGACTTTCAAAGCCT",2,29,9,0,5,45,853
"GAGACTTTCACTCCGT",0,5,0,0,0,5,223
"GAGACTTTCCCGAGAC",0,9,4,0,0,13,230
"GAGACTTTCGAAATCC",0,4,2,0,0,6,213
"GAGACTTTCTATCGTT",1387,512,341,97,276,2613,124238
"GAGAGGTAGAGCAAGA",0,2,0,0,0,2,27
"GAGAGGTAGGAAAGTG",2,2,3,0,0,7,107
"GAGAGGTAGTTGAATG",0,3,0,0,3,6,169
"GAGAGGTCACCCAATA",2,16,7,0,4,29,718
"GAGAGGTGTCTAGTGT",0,0,0,0,0,0,5
"GAGAGGTGTTTCGATG",39,121,108,15,283,566,30460
"GAGAGGTTCCCACAGG",1,6,0,0,2,9,125
"GAGAGGTTCCGTTGAA",3,12,7,0,4,26,362
"GAGAGGTTCTTCACAT",2,4,0,0,0,6,80
"GAGATGGAGGAGGGTG",0,3,0,0,0,3,10
"GAGATGGAGGTCTGGA",48,343,82,23,62,558,25768
"GAGATGGAGTAAACAC",0,9,2,0,3,14,159
"GAGATGGCAAGCACAG",1,7,3,0,0,11,227
"GAGATGGCAGCTATTG",0,3,0,0,0,3,11
"GAGATGGGTTGCATGT",1,2,0,0,2,5,111
"GAGATGGTCAAGTGGG",1,0,0,0,0,1,13
"GAGATGGTCCCTCATG",2,21,5,2,5,35,381
"GAGATGGTCCTACCAC",24,239,44,15,39,361,15851
"GAGCCTGCAAAGGAGA",0,18,4,3,5,30,512
"GAGCCTGCATGCCGGT",0,5,0,0,0,5,118
"GAGCCTGGTCTAACTG",1,8,5,0,2,16,467
"GAGCCTGGTCTTGAGT",0,7,2,0,2,11,121
"GAGCTGCAGAGTGTTA",5,15,9,0,5,34,470
"GAGCTGCAGATGCAGC",0,0,0,0,0,0,29
"GAGCTGCAGGGCAACT",1,2,0,0,0,3,174
"GAGCTGCAGGTCATCT",3,19,20,2,8,52,2256
"GAGCTGCCATCATGAC",0,5,2,0,5,12,212
"GAGCTGCTCAAGTCGT",0,20,7,0,9,36,663
"GAGCTGCTCATTTCGT",0,0,0,0,0,0,14
"GAGGCAAAGAGCCTGA",0,0,0,0,0,0,103
"GAGGCAAAGCTCCCTT",1,8,0,0,0,9,156
"GAGGCAAAGGAGGTTC",0,0,0,0,0,0,10
"GAGGCAAAGTCCGTCG",0,4,0,0,2,6,61
"GAGGCAACAACACAAA",0,2,0,0,0,2,38
"GAGGCAACACCACTGG",8,18,47,3,11,87,3353
"GAGGCAACACTGAATC",114,234,72,27,77,524,17902
"GAGGCAACAGCGAGTA",14,61,63,10,95,243,9149
"GAGGCAACAGCTACAT",0,4,0,0,0,4,228
"GAGGCAAGTAACATCC",1,2,0,0,0,3,83
"GAGGCAATCCCGAATA",1,5,4,0,0,10,20
"GAGGCAATCTGCAGCG",1,22,8,3,0,34,566
"GAGGCAATCTGGGCCA",1,8,0,0,0,9,210
"GAGGCCTAGGCAATGC",6,48,13,0,12,79,2757
"GAGGCCTAGGCAGGTT",0,10,2,0,0,12,257
"GAGGCCTAGGCTGTAG",1,3,2,0,0,6,181
"GAGGCCTGTGGGTATG",0,0,0,0,0,0,28
"GAGGCCTTCTAGGCCG",2,9,0,0,3,14,202
"GAGGGATAGAGGTCAC",1,0,0,0,0,1,16
"GAGGGATCAAGTGCTT",22,69,73,12,95,271,10894
"GAGGGATCACGCGTCA",3,3,0,0,0,6,38
"GAGGGATCATGCGGTC",9,5,0,0,0,14,153
"GAGGGATGTCATATGC",0,2,0,0,2,4,80
"GAGGGATTCACCATGA",0,5,2,0,0,7,14
"GAGGGTAAGAAATTGC",5,30,16,6,54,111,3617
"GAGGGTACAGGCAATG",1,31,2,0,4,38,457
"GAGGGTAGTAGGGTAC",0,3,0,0,0,3,5
"GAGGGTATCGAATCCA",13,50,98,7,17,185,7594
"GAGGGTATCGTGGGTC",1,25,4,0,3,33,427
"GAGTCATAGACTGTTC",1,5,0,0,0,6,129
"GAGTCATCAAGAGAGA",2,5,2,0,2,11,167
"GAGTCATCAAGCGATG",0,0,2,0,0,2,8
"GAGTCATCAATAGTGA",27,152,122,15,47,363,22259
"GAGTCATCACCAGACC",3,25,10,2,9,49,400
"GAGTCATCACCGGCTA",0,6,2,0,0,8,309
"GAGTCATCACTAAACC",1,19,6,2,3,31,608
"GAGTCATCATGCCATA",1,33,6,0,5,45,650
"GAGTCATGTTGCTCCT",18,115,26,6,24,189,7909
"GAGTCTACACGAGGAT",5,28,9,0,5,47,533
"GAGTCTACAGAAATTG",0,2,0,0,0,2,4
"GAGTCTAGTATGAGGC",0,3,0,0,0,3,18
"GAGTCTAGTCAGGAGT",5,22,5,2,5,39,753
"GAGTCTAGTCGTTCAA",0,2,2,0,2,6,164
"GAGTCTAGTTTCTATC",0,6,0,0,0,6,144
"GAGTCTATCACCTTAT",1,4,4,0,0,9,90
"GAGTCTATCCGTGACG",2,31,8,0,9,50,793
"GAGTCTATCGCGTAGC",0,4,0,0,0,4,28
"GAGTGAGAGGCCATAG",175,1548,320,91,270,2404,110790
"GAGTGAGCAACTACGT",29,81,101,15,143,369,18183
"GAGTGAGCAGCAGATG",18,57,117,10,27,229,12625
"GAGTGAGCATAGAGGC",1,5,0,0,7,13,161
"GAGTGAGCATGCAGCC",1,4,0,0,0,5,108
"GAGTGAGGTCCGAAAG",0,5,3,0,0,8,44
"GAGTGAGGTTGTAAAG",0,7,0,0,0,7,90
"GAGTGAGTCAGATTGC",122,796,189,45,150,1302,59004
"GAGTGTTAGATTGAGT",0,3,0,0,0,3,8
"GAGTGTTAGGCTTAGG",2,18,5,0,0,25,255
"GAGTGTTGTAACGCGA",0,4,0,0,2,6,74
"GAGTGTTGTCTAACTG",1,8,0,0,0,9,94
"GAGTGTTGTTGCCGCA",0,2,0,0,0,2,140
"GAGTGTTGTTTAGAGA",284,2091,557,152,486,3570,169374
"GAGTGTTTCGAGGCAA",0,4,4,0,0,8,62
"GAGTTACAGCGTATGG",0,4,2,0,0,6,221
"GAGTTACCAACTCGTA",0,5,0,0,0,5,228
"GAGTTACCATCTCAAG",23,100,29,72,27,251,11291
"GAGTTACCATTGAAAG",2,12,4,0,3,21,326
"GAGTTACGTATACGGG",0,2,0,0,0,2,38
"GAGTTACTCCTAGCCT",0,0,0,0,0,0,9
"GAGTTACTCTCGTTTA",0,14,4,0,5,23,179
"GAGTTGTAGCGCCATC",0,0,0,0,0,0,7
"GAGTTGTAGGTGCATG",0,0,0,0,0,0,3
"GAGTTGTCACGCTTAA",136,207,56,18,55,472,21239
"GAGTTGTCAGCTTTCC",1,6,0,2,0,9,169
"GAGTTGTCAGGTCCGT",1,4,2,0,0,7,429
"GAGTTGTCAGGTCTCG",1,4,0,0,2,7,39
"GAGTTGTTCAATCCGA",1,4,0,0,0,5,149
"GAGTTGTTCCGTCAAA",4,22,5,2,4,37,858
"GAGTTGTTCTGACGCG",15,60,97,7,25,204,8962
"GAGTTTGAGAGTGGCT",2,7,0,0,0,9,104
"GAGTTTGAGATGTTCC",0,4,3,0,0,7,117
"GAGTTTGAGGTACAGC",1,13,8,0,0,22,352
"GAGTTTGCAGCTCATA",1,10,4,0,0,15,475
"GAGTTTGGTAGACTGG",2,19,7,0,3,31,411
"GAGTTTGGTGCCGAAA",3,15,8,0,4,30,478
"GAGTTTGGTTCACCGG",0,0,0,0,0,0,34
"GAGTTTGGTTTCGTAG",1,3,4,0,0,8,536
"GAGTTTGTCCATCACC",28,102,266,18,49,463,21871
"GAGTTTGTCTGTCCGT",3,21,4,2,5,35,461
"GATAGAAAGTCGAATA",0,7,0,0,0,7,243
"GATAGAACAGATACTC",36,240,77,23,65,441,21574
"GATAGAAGTCTGCGCA",2,15,5,2,2,26,109
"GATAGAAGTCTGTAAC",4,46,5,2,6,63,1929
"GATAGAAGTTAGGAGC",17,113,32,8,16,186,6147
"GATAGAATCCCGAGGT",2,14,10,0,5,31,484
"GATAGAATCGCCTAGG",0,4,2,0,0,6,86
"GATAGAATCGGTCACG",1,0,0,0,0,1,52
"GATAGCTAGGCCCACT",0,4,0,0,0,4,94
"GATAGCTAGGTGCTTT",1,40,15,0,8,64,834
"GATAGCTCAGCAGTTT",18,49,14,4,7,92,4178
"GATAGCTCATGACGGA",2,8,2,0,0,12,140
"GATAGCTCATTATGCG",18,91,36,14,130,289,14768
"GATAGCTGTAAGTTAG",0,0,0,0,0,0,97
"GATAGCTTCCTAAGTG",2,41,5,3,6,57,373
"GATCACAAGAAGCGAA",18,69,38,14,177,316,13688
"GATCACAAGGATACCG",1,5,3,0,5,14,102
"GATCACAAGGTAGCCA",0,5,0,0,2,7,40
"GATCACACATGGCCAC",0,8,2,0,0,10,65
"GATCACAGTAGAATGT",0,6,2,0,0,8,119
"GATCACATCGCTGTTC",1,6,0,0,0,7,238
"GATCACATCTGGGAGA",3,27,3,0,7,40,460
"GATCACATCTTAGCAG",0,5,2,0,0,7,138
"GATCAGTAGAGATTCA",1,19,3,0,0,23,265
"GATCAGTAGATCACTC",3,18,9,2,0,32,459
"GATCAGTAGGTTGCCC",5,75,17,5,13,115,3983
"GATCAGTCATACCATG",0,0,0,0,0,0,6
"GATCAGTTCATCCTAT",1,16,4,0,2,23,500
"GATCAGTTCTGCGAGC",0,3,0,0,0,3,40
"GATCATGAGCATACTC",1,0,0,0,2,3,130
"GATCATGAGTGGCAGT",1,24,8,2,5,40,623
"GATCATGCAACGCCCA",136,1076,229,65,214,1720,72881
"GATCATGCAATAGGAT",1,4,4,0,0,9,172
"GATCATGCAGCAGTGA",0,11,0,0,0,11,52
"GATCATGCAGTCAACT",3,22,8,0,5,38,720
"GATCATGGTCGGTACC",3,13,4,0,3,23,328
"GATCATGGTTCCGCTT",1,2,0,0,0,3,33
"GATCATGTCCTCAGAA",0,2,2,0,0,4,65
"GATCATGTCTACGGGC",4,38,48,5,12,107,3638
"GATCATGTCTCTCCGA",1,8,2,0,2,13,329
"GATCCCTAGATACAGT",9,43,5,0,10,67,1115
"GATCCCTCACGCGGTT",1,14,6,0,0,21,437
"GATCCCTCACTGTTCC",0,6,0,0,0,6,226
"GATCCCTGTAGTCCTA",12,27,57,4,14,114,5609
"GATCCCTGTTGGGTTT",1,5,0,0,0,6,63
"GATCCCTTCATTGGTG",0,2,0,0,0,2,67
"GATCCCTTCCGCAAAT",0,0,0,0,0,0,1
"GATCGTAAGATGCTGG",2,9,0,0,0,11,204
"GATCGTAAGCTAGAGC",2,3,0,0,2,7,136
"GATCGTAAGGGCAGGA",1,8,0,0,4,13,122
"GATCGTAAGTCCTGTA",3,7,0,0,0,10,80
"GATCGTAAGTGTCATC",4,37,10,0,7,58,1225
"GATCGTACACATGACT",36,326,71,19,62,514,24961
"GATCGTACATAACGGG",3,23,5,0,7,38,737
"GATCGTAGTCTGATCA",44,364,83,24,72,587,27253
"GATCGTAGTGGACTAG",4,25,19,2,10,60,1221
"GATGACTAGAGCTGAC",3,8,2,0,3,16,338
"GATGACTTCGCCTCTA",0,3,0,0,0,3,207
"GATGACTTCTCCGTGT",2,21,5,0,3,31,526
"GATGAGGAGCGTATGG",0,2,0,0,0,2,57
"GATGAGGAGTACTCGT",14,110,22,8,22,176,8783
"GATGAGGAGTATCTGC",2,11,3,0,7,23,509
"GATGAGGAGTGCAACG",0,0,0,0,0,0,4
"GATGAGGCACACCTGG",0,6,0,2,0,8,203
"GATGAGGCATCAACCA",14,42,21,5,92,174,8641
"GATGAGGCATCTGCGG",9,40,31,4,11,95,3096
"GATGAGGGTCTCTCCA",8,37,13,2,52,112,4975
"GATGAGGGTGACAACG",2,7,3,2,0,14,158
"GATGAGGGTGGCTTGC",3,18,8,0,3,32,1042
"GATGAGGTCACCGGTG",2,15,4,2,3,26,435
"GATGAGGTCCATATGG",0,6,0,0,0,6,107
"GATGAGGTCCTCTAGC",7,35,17,11,65,135,7163
"GATGAGGTCGACGACC",0,0,0,0,0,0,39
"GATGAGGTCGATCCAA",3,18,2,0,5,28,516
"GATGATCAGTCGCCAC",226,79,42,15,32,394,16860
"GATGATCCAGAGTTGG",4,11,6,0,0,21,338
"GATGATCCATCCTCAC",1,0,0,0,0,1,83
"GATGATCTCGAATCCA",2,18,10,3,21,54,2000
"GATGATCTCTGCAGCG",0,6,0,0,0,6,74
"GATGATCTCTTCCGTG",4,9,4,0,0,17,409
"GATGATCTCTTTCCAA",1,4,0,0,3,8,455
"GATGCTAAGAAGCGAA",0,3,3,0,2,8,100
"GATGCTAAGAGCCGAT",1,3,2,0,0,6,23
"GATGCTAAGGACTTCT",11,69,15,7,13,115,5196
"GATGCTAAGTTCCAGT",0,5,4,0,3,12,256
"GATGCTAGTACCGGCT",5,31,6,2,5,49,1225
"GATGCTAGTCGCGTTG",6,38,29,0,11,84,3191
"GATGCTATCAGGAAAT",1,27,9,0,5,42,100
"GATGCTATCCATTGTT",0,8,0,0,0,8,128
"GATGCTATCTCTGGTC",1,18,0,0,0,19,719
"GATGGAGAGATACAGT",1,19,7,0,9,36,478
"GATGGAGAGGCACTAG",0,14,5,0,2,21,384
"GATGGAGCAGAGAATT",59,194,97,28,331,709,34444
"GATGGAGCAGGATTCT",1,20,3,0,6,30,957
"GATGGAGCATAAGATG",0,0,0,0,0,0,3
"GATGGAGCATGAGAAT",25,88,200,13,41,367,17637
"GATGGAGGTCCAGAAG",3,9,4,0,0,16,482
"GATGGAGTCCTTATGT",5,11,8,0,4,28,395
"GATGTTGAGAAAGTCT",5,38,9,0,5,57,1403
"GATGTTGGTTCCGGTG",15,44,36,5,42,142,7115
"GATGTTGTCCGTGTCT",0,4,0,0,2,6,65
"GATGTTGTCCTAGAGT",0,2,0,0,0,2,51
"GATGTTGTCGTGCTCT",1,21,5,2,3,32,121
"GATGTTGTCTCAAAGC",1,0,0,0,0,1,1
"GATGTTGTCTCATAGG",8,42,15,0,4,69,2554
"GATTCGAAGTTGAAAC",81,816,193,53,135,1278,62079
"GATTCGACAATGACCT",8,21,6,6,48,89,3429
"GATTCGACAGGCTCTG",0,5,0,0,0,5,86
"GATTCGACATTAAGCC",6,14,7,0,4,31,1445
"GATTCGAGTGTTTCTT",0,3,2,2,0,7,196
"GATTCGAGTTGCTTGA",0,0,0,0,0,0,2
"GATTCGAGTTGTCCCT",11,39,21,0,66,137,6573
"GATTCGATCCACAGCG",0,4,0,0,2,6,91
"GATTCTTAGAGGCGGA",1,4,0,0,0,5,18
"GATTCTTCAAGTGATA",3,26,9,0,5,43,625
"GATTCTTCAGGAGGTT",2,27,4,0,0,33,431
"GATTCTTGTATGGAGC",12,62,19,4,11,108,4805
"GATTCTTGTTAGGAGC",2,16,7,0,4,29,341
"GATTCTTGTTTGCCGG",2,9,4,0,6,21,349
"GATTCTTTCGCGATCG",39,274,66,15,55,449,20488
"GATTGGTCAAGTGCAG",0,0,0,0,0,0,20
"GATTGGTCAGAACTAA",1,10,2,0,2,15,93
"GATTGGTCATCGGCCA",2,20,11,0,10,43,566
"GATTGGTCATGACTGT",2,18,8,0,4,32,1145
"GATTGGTGTCCAGCGT",2,36,7,0,6,51,1406
"GATTGGTGTCTTAGTG",3,4,0,0,0,7,114
"GATTGGTGTGGTATGG",1,10,5,0,0,16,204
"GATTGGTGTTAGAGTA",5,22,8,3,12,50,1367
"GATTGGTTCCCATTCG",0,5,0,0,0,5,93
"GATTTCTAGAGTACCG",0,0,0,0,0,0,18
"GATTTCTAGGGTACAC",39,127,117,14,214,511,25239
"GATTTCTCACGCGCAT",6,74,21,5,17,123,6978
"GATTTCTCACGGTGCT",2,13,3,0,2,20,384
"GATTTCTTCATCGACA",0,2,0,0,0,2,5
"GATTTCTTCCACAGGC",1,29,0,4,2,36,588
"GCAACATAGCAACAAT",4,19,4,4,3,34,488
"GCAACATAGTCTTGGT",3,41,15,2,3,64,1056
"GCAACATCACCCGTAG",593,217,129,43,98,1080,44363
"GCAACATCAGCACAGA",1,28,9,0,8,46,690
"GCAACATCATTGCCGG",0,5,0,0,0,5,71
"GCAACATTCGCGAAGA",1,6,3,0,0,10,66
"GCAACATTCGTAGCTA",1,22,5,3,2,33,237
"GCAACATTCGTGACTA",0,0,0,0,0,0,39
"GCAACCGAGTCATGGG",0,2,0,0,0,2,64
"GCAACCGCAGGCACAA",2,18,2,0,0,22,54
"GCAACCGGTCACCGCA",0,5,3,0,0,8,19
"GCAACCGGTTATGGTC",8,39,45,7,13,112,3963
"GCAACCGGTTGGGTAG",2,8,2,0,0,12,171
"GCAACCGTCCAACTAG",2,24,10,0,7,43,721
"GCAACCGTCGGCTTCT",0,4,3,2,0,9,379
"GCAACCGTCGTTGCCT",0,0,2,0,0,2,59
"GCACATACATGCAGCC",20,89,44,12,206,371,17582
"GCACATAGTGCGTTTA",3,18,6,3,7,37,433
"GCACATATCCCGAGGT",0,4,0,0,0,4,71
"GCACATATCTCCTGCA",4,32,3,0,6,45,937
"GCACGGTAGACTGAGC",2,16,7,0,2,27,568
"GCACGGTAGGAACTAT",1,3,0,0,0,4,54
"GCACGGTCAACACTAC",0,4,0,0,0,4,199
"GCACGGTCAAGGATGC",0,3,2,0,3,8,146
"GCACGGTCAAGTCCCG",1,5,0,0,0,6,176
"GCACGGTCACACACTA",3,13,4,0,3,23,493
"GCACGGTCACTGAGGA",1,7,0,0,0,8,105
"GCACGGTCATAGACTC",0,8,3,0,4,15,492
"GCACGGTCATTGACTG",2,14,5,2,5,28,655
"GCACGGTGTTGTGTAC",0,4,0,0,0,4,94
"GCACGGTTCAACTTTC",6,28,12,3,35,84,3780
"GCACGGTTCTTACCAT",3,20,3,0,6,32,688
"GCACGTGAGATCGCTT",2,24,6,2,5,39,553
"GCACGTGAGTATAACG",3,21,9,0,5,38,731
"GCACGTGCAAGGACAC",1,3,4,0,0,8,125
"GCACGTGCAATGTTGC",29,347,83,13,61,533,26404
"GCACGTGCACTGATTG",64,176,467,33,89,829,47162
"GCACGTGCAGAAATTG",1,6,0,0,0,7,114
"GCACGTGCAGCGTAGA",0,8,0,0,0,8,65
"GCACGTGCAGTTCTAG",12,37,77,0,11,137,5907
"GCACGTGCATACTGTG",2,15,4,0,3,24,420
"GCACGTGTCGCTGTTC",0,8,0,0,0,8,117
"GCACGTGTCGGTATGT",0,7,0,0,5,12,121
"GCACGTGTCTTGGTGA",0,8,0,0,4,12,70
"GCACTAAAGCAGCAGT",7,50,16,7,21,101,3309
"GCACTAAAGGTAAGGA",0,3,0,0,2,5,18
"GCACTAACAGCACAGA",3,34,5,0,4,46,548
"GCACTAAGTACAACGG",0,3,0,0,0,3,28
"GCACTAAGTAGGAAAG",1,9,0,0,0,10,250
"GCACTAAGTAGGGTAC",4,15,5,0,4,28,555
"GCACTAATCAACTGGT",2,4,4,0,0,10,328
"GCACTAATCGCTCATC",0,0,0,0,0,0,6
"GCAGCCAAGTCTAACC",0,7,0,0,2,9,170
"GCAGCCACACGACAAG",0,8,3,0,0,11,18
"GCAGCCAGTAGTATAG",10,25,15,5,59,114,4266
"GCAGCCAGTTAGGAGC",0,0,0,0,0,0,8
"GCAGCTGAGTGGAATT",2,18,2,2,4,28,354
"GCAGCTGCAAATCGGG",0,5,2,0,0,7,134
"GCAGCTGCAAATTGCC",0,0,0,0,0,0,55
"GCAGCTGCAACGGCCT",0,4,0,0,0,4,70
"GCAGCTGCATCAGCGC",2,16,3,0,5,26,411
"GCAGCTGTCTCTAAGG",0,11,2,0,0,13,105
"GCAGCTGTCTGAGAAA",2,13,5,0,6,26,370
"GCAGCTGTCTGTCGTC",5,15,3,0,3,26,54
"GCAGGCTAGCGCCATC",241,1921,437,115,332,3046,157140
"GCAGGCTAGTAACGTA",10,87,29,3,85,214,8830
"GCAGGCTCACGTAGTT",1,2,2,0,0,5,78
"GCAGGCTGTGAGCAGT",1,7,0,0,0,8,133
"GCAGGCTGTGCTAGCC",3,20,8,0,14,45,1554
"GCAGGCTTCCTACGAA",2,20,9,2,2,35,569
"GCAGGCTTCTGCATGA",70,521,104,35,92,822,39745
"GCAGTTAAGCCGTTAT",1,8,0,0,2,11,317
"GCAGTTAAGTGGTTAA",19,141,39,13,26,238,12315
"GCAGTTACAACCAATC",0,8,0,0,0,8,134
"GCAGTTACAAGCTACT",1,7,2,0,0,10,11
"GCAGTTACACTACCCT",0,7,3,0,0,10,139
"GCAGTTAGTTCGGCCA",0,5,0,0,0,5,85
"GCAGTTATCAGCTAGT",6,22,2,0,11,41,1030
"GCAGTTATCAGGTGTT",1,4,2,0,0,7,27
"GCAGTTATCTGACCCT",5,24,7,2,9,47,601
"GCATCGGAGAGGCGGA",0,2,2,0,0,4,113
"GCATCGGAGCAACAGC",0,0,0,3,0,3,65
"GCATCGGAGGTGCTTT",21,69,27,9,146,272,13860
"GCATCGGAGTCATAGA",0,0,0,0,0,0,38
"GCATCGGGTCATCCCT",3,8,2,0,3,16,214
"GCATCGGGTGCCCGTA",277,1986,483,126,383,3255,135256
"GCATCGGGTTGGGCCT",0,0,0,0,0,0,71
"GCATCGGTCAAGAGGC",57,368,108,18,76,627,25180
"GCATCGGTCCCTTTGG",0,2,0,0,0,2,41
"GCATCTCAGGACAACC",0,0,0,0,0,0,61
"GCATCTCAGTTGCCCG",3,19,6,2,3,33,555
"GCATGATAGACGATAT",0,25,6,3,5,39,709
"GCATGATAGTGCTACT",0,2,0,0,2,4,56
"GCATGATAGTGGACTG",0,4,0,0,2,6,126
"GCATGATAGTGTTGTC",0,13,0,2,9,24,347
"GCATGATCACATGTTG",0,3,0,0,0,3,115
"GCATGATCACCTTCCA",2,11,10,0,6,29,603
"GCATTAGAGCATGCGA",3,3,0,0,0,6,128
"GCATTAGAGGAGTATT",0,2,0,0,0,2,28
"GCATTAGAGGTAATCA",1,5,2,0,0,8,134
"GCATTAGAGTTGTAGA",0,8,0,0,0,8,16
"GCATTAGCAAACCGGA",2,8,2,0,0,12,203
"GCATTAGCAACTGATC",15,65,124,7,27,238,11509
"GCATTAGCAAGTGGCA",0,6,5,0,0,11,447
"GCATTAGCACGTAGTT",1,10,5,0,2,18,120
"GCATTAGGTACGAGTG",0,11,4,0,5,20,90
"GCATTAGGTGACATCT",5,16,3,2,6,32,134
"GCCAACGCAATACCCA",9,72,16,3,14,114,2983
"GCCAACGGTCCACATA",91,775,159,50,135,1210,50263
"GCCAACGGTCTCTCTG",29,247,66,18,47,407,16508
"GCCAACGGTGCATTAC",0,10,2,0,0,12,130
"GCCAACGGTTCCTAAG",0,5,2,0,2,9,102
"GCCAACGGTTTGTTCT",2,6,3,0,4,15,139
"GCCAACGTCAGGCGAA",0,6,0,0,2,8,81
"GCCAACGTCCTGTAGA",1,2,0,0,2,5,79
"GCCAACGTCGTGAGAG",0,4,0,0,3,7,95
"GCCAGCAAGCATTTGC",1,8,0,0,0,9,215
"GCCAGCAAGCCGCACT",1,9,0,0,0,10,124
"GCCAGCAAGGTAGATT",3,13,5,0,3,24,42
"GCCAGCACAGAGGAAA",2,10,0,0,0,12,412
"GCCAGCACATATAGCC",10,43,87,7,16,163,7189
"GCCAGCACATTAAAGG",0,3,0,0,0,3,10
"GCCAGCAGTAGTCACT",1,4,2,0,0,7,67
"GCCAGCAGTCAACCTA",0,5,0,0,0,5,144
"GCCAGCAGTCGAATTC",0,2,0,0,2,4,74
"GCCAGCAGTGGATTTC",10,46,21,8,62,147,6880
"GCCAGCAGTTCCACGG",0,3,2,0,0,5,95
"GCCAGGTAGACCATGG",2,11,10,2,3,28,117
"GCCAGGTAGATCCTAC",0,0,0,0,0,0,1
"GCCAGGTAGCAAATGT",112,746,202,44,174,1278,65778
"GCCAGGTCAACTGCCG",0,5,0,0,0,5,141
"GCCAGGTCAAGAGGTC",4,23,32,2,11,72,2906
"GCCAGGTCACAACGTT",40,123,135,18,236,552,24586
"GCCAGGTCAGCCCAGT",5,32,25,3,4,69,2503
"GCCAGGTGTAAGATTG",2,20,8,0,3,33,436
"GCCAGGTTCAAGGAGC",0,3,0,0,0,3,117
"GCCAGGTTCATAGACC",2,9,2,0,0,13,33
"GCCAGGTTCCCGAGAC",0,4,2,0,0,6,177
"GCCAGGTTCTAAGCCA",83,426,105,28,91,733,32485
"GCCAGGTTCTCAAAGC",0,4,0,0,0,4,53
"GCCAGTGAGTGAACAT",1,4,0,0,0,5,171
"GCCAGTGGTAGTGTGG",0,9,0,0,2,11,411
"GCCAGTGGTGGGACAT",1,2,0,0,0,3,17
"GCCAGTGGTTTCGATG",1,19,3,0,8,31,979
"GCCAGTGTCTGAGAAA",3,15,7,2,3,30,428
"GCCATGGAGAGAACCC",0,5,4,0,0,9,50
"GCCATGGCAAAGGGTC",2,2,4,0,0,8,56
"GCCATGGCACAGCCAC",0,15,2,0,3,20,403
"GCCATGGCAGGTTTAC",2,26,9,0,6,43,70
"GCCATGGGTACAAACA",0,0,0,0,0,0,15
"GCCATGGGTCGCCTAG",0,7,3,3,4,17,322
"GCCATGGTCCCTCAAC",2,21,38,4,9,74,2688
"GCCATGGTCGAGCTGC",1,8,0,0,52,61,500
"GCCATTCAGTGTAGAT",9,56,12,5,9,91,2420
"GCCATTCCAATGACCT",0,5,0,0,0,5,84
"GCCATTCCAGAAGTTA",3,5,0,0,0,8,95
"GCCATTCCAGACAAGC",6,31,9,2,30,78,2474
"GCCATTCCATGACAGG",0,16,2,0,7,25,600
"GCCATTCGTAGGTACG",0,0,0,0,3,3,5
"GCCATTCGTCCACACG",1,15,3,0,10,29,586
"GCCATTCGTGTTGATC",239,206,80,22,76,623,27126
"GCCATTCGTTCTCTAT",4,12,3,0,12,31,1552
"GCCATTCTCACGGGAA",4,18,7,0,6,35,614
"GCCATTCTCTATCCAT",1,0,0,0,0,1,13
"GCCCAGAAGGGTAATT",1,6,0,0,0,7,93
"GCCCAGACACCTAAAC",0,0,0,0,0,0,19
"GCCCAGAGTACCGGCT",0,8,5,0,2,15,531
"GCCCAGAGTTCAAAGA",6,20,12,0,4,42,1275
"GCCCAGATCCGTTGAA",1,5,2,0,0,8,79
"GCCCAGATCGTCTACC",334,243,90,24,73,764,25771
"GCCCAGATCTGATTCT",1,28,8,0,5,42,484
"GCCCGAAAGGGCAGTT",1,0,0,0,0,1,2
"GCCCGAACACGCGCTA",0,5,0,0,0,5,149
"GCCCGAACAGGGATAC",3,9,8,0,0,20,569
"GCCCGAAGTAATGTGA",2,8,0,0,2,12,128
"GCCCGAAGTAGCTTGT",0,3,0,0,0,3,30
"GCCCGAAGTTGCACGC",0,3,0,0,0,3,39
"GCCCGAAGTTGCATTG",2,20,4,0,6,32,699
"GCCCGAATCAATCTCT",4,16,7,0,2,29,943
"GCCCGAATCACCATCC",1,7,2,0,0,10,235
"GCCGATGAGCGATGCA",1,3,0,0,0,4,79
"GCCGATGAGCTGTGCC",0,4,0,0,0,4,56
"GCCGATGAGGAGTATT",0,4,0,0,0,4,109
"GCCGATGAGGGTAATT",3,14,2,0,0,19,368
"GCCGATGGTAGCTGAG",0,2,0,0,0,2,124
"GCCGATGTCGAAGGAC",0,2,0,0,0,2,62
"GCCGTGAAGTGAGCCA",1,6,3,0,3,13,209
"GCCGTGACAACACAAA",1,6,0,0,2,9,83
"GCCGTGACAAGGATGC",3,18,4,0,2,27,326
"GCCGTGAGTCGCTCGA",3,5,6,0,0,14,286
"GCCGTGATCACAATGC",3,19,5,0,5,32,528
"GCCGTGATCCTTCTAA",2,2,2,0,0,6,116
"GCCGTGATCGCCAATA",5,28,2,0,4,39,106
"GCCGTGATCGCGATCG",1,16,3,0,2,22,242
"GCCGTGATCTCGGTAA",0,3,0,0,0,3,55
"GCCTGTTCACAGTGTT",17,58,18,6,20,119,2801
"GCCTGTTCAGCGGTTC",1,12,0,0,0,13,244
"GCCTGTTGTCGTGGAA",1,9,0,0,2,12,225
"GCCTGTTGTGCGGCTT",1,11,3,0,0,15,243
"GCCTGTTTCAGTGCGC",2,4,0,0,0,6,209
"GCCTGTTTCGCGTAGC",1,8,4,0,0,13,147
"GCCTGTTTCTGGTGCG",19,61,15,4,14,113,5896
"GCGAGAACAACCACAT",0,5,2,0,2,9,122
"GCGAGAACAACTCGAT",9,46,34,6,63,158,5896
"GCGAGAACAATCTGCA",119,881,202,45,172,1419,71578
"GCGAGAACATCGATAC",2,27,9,0,4,42,1006
"GCGAGAAGTTTCAGAC",9,50,60,2,17,138,4611
"GCGATCGAGCCTGACC",2,24,10,0,5,41,852
"GCGATCGAGTGTAGAT",3,14,6,0,4,27,68
"GCGATCGTCAAGATAG",17,57,28,9,92,203,6531
"GCGATCGTCCTGGCTT",0,0,2,0,0,2,24
"GCGATCGTCGGACCAC",0,7,2,0,0,9,43
"GCGATCGTCGGTATGT",1,0,0,0,2,3,79
"GCGATCGTCTGTTGGA",0,7,3,0,3,13,83
"GCGGAAAAGTATGGAT",0,0,0,0,0,0,1
"GCGGAAACAACCGTAT",5,23,44,0,11,83,3641
"GCGGAAACAGACCGCT",0,0,0,0,2,2,21
"GCGGAAACATCGGAGA",4,5,2,2,0,13,80
"GCGGAAAGTGCAGTGA",21,122,35,9,23,210,6829
"GCGGAAATCATCGCTC",1,0,3,0,2,6,69
"GCGGAAATCCAGTGTA",0,0,0,0,0,0,0
"GCGGAAATCCCTCTTT",1,20,8,0,3,32,193
"GCGGAAATCGAAGCCC",18,147,24,5,29,223,7550
"GCGGATCAGCAATAGT",2,0,0,0,0,2,64
"GCGGATCAGTTCCATG",0,7,0,0,0,7,130
"GCGGATCCAGGAGACT",4,32,5,0,9,50,571
"GCGGATCGTCCTCATC",2,25,7,0,2,36,768
"GCGGATCGTCCTGGGT",4,26,35,4,8,77,2734
"GCGTGCAAGAAGTCCG",0,7,0,0,0,7,116
"GCGTGCAAGACCATTC",17,72,142,9,29,269,13551
"GCGTGCAAGATGGCGT",1,5,2,0,0,8,80
"GCGTGCAAGTCGAAAT",8,56,12,6,11,93,3292
"GCGTGCACATGCCATA",0,8,5,0,2,15,146
"GCGTGCATCGAACGCC",2,5,0,0,0,7,57
"GCGTGCATCGCGTGAC",2,14,5,0,0,21,316
"GCGTGCATCGCTAATG",3,14,4,0,0,21,501
"GCGTTTCAGCACTTTG",1,10,3,0,2,16,260
"GCGTTTCAGCTCCCTT",2,11,0,0,0,13,358
"GCGTTTCAGTACGTCT",3,20,8,4,2,37,342
"GCGTTTCAGTTGGAGC",1,25,5,0,4,35,778
"GCGTTTCCACAGTACT",0,12,2,0,3,17,391
"GCGTTTCCATCCGAAT",0,15,3,0,0,18,170
"GCGTTTCGTTATGGTC",1,4,0,0,0,5,141
"GCGTTTCTCCGCGAGT",1,22,10,0,3,36,610
"GCTACAAAGACGCCAA",1,8,0,0,0,9,174
"GCTACAAAGCCACCGT",3,11,3,0,3,20,113
"GCTACAACAACGGCTC",1,24,8,0,6,39,180
"GCTACAACACATATCG",1,7,0,0,0,8,255
"GCTACAACACTTACAG",1,6,0,0,0,7,84
"GCTACAACAGTAGGAC",0,0,0,0,2,2,144
"GCTACAAGTTAACCTG",53,298,100,29,77,557,18184
"GCTACAAGTTAGAAGT",72,561,135,41,117,926,43164
"GCTACAATCGGTAGAG",30,106,235,13,55,439,20389
"GCTACCTAGATCACTC",7,47,15,2,26,97,5745
"GCTACCTAGATCCTAC",2,36,5,2,6,51,597
"GCTACCTAGTCATCGT",2,8,0,0,2,12,336
"GCTACCTCAGGGAGAG",1,2,0,0,0,3,13
"GCTACCTCATTGTGCA",0,2,0,0,0,2,32
"GCTACCTGTAACATAG",12,49,21,5,69,156,8632
"GCTACCTGTATCGAGG",31,86,218,14,42,391,17540
"GCTACCTGTTCAACGT",1,9,2,0,0,12,331
"GCTACCTTCTTCGATT",0,0,0,0,0,0,94
"GCTCAAAAGCTGGTGA",0,5,0,0,0,5,56
"GCTCAAACAAATCGGG",0,0,0,0,0,0,7
"GCTCAAACAATTCGTG",6,20,10,2,7,45,491
"GCTCAAAGTACTTCCC",0,13,3,0,2,18,320
"GCTCAAATCGCTTAAG",0,3,0,0,0,3,139
"GCTCAAATCTGTTGGA",3,13,11,2,4,33,965
"GCTGAATAGATGCAGC",27,68,158,10,40,303,16838
"GCTGAATAGGTGCTTT",0,11,2,0,0,13,62
"GCTGAATCAAGTGTCT",1,3,3,0,0,7,63
"GCTGAATCAGAATTCC",1,19,4,0,4,28,465
"GCTGAATGTGGAATGC",20,51,16,3,14,104,6155
"GCTGAATGTGTTGACT",0,0,0,0,0,0,39
"GCTGAATGTTTCACTT",2,28,10,0,4,44,471
"GCTGAATTCATGAGAA",77,700,156,42,118,1093,55175
"GCTGCAGAGAAACCAT",2,7,2,0,3,14,124
"GCTGCAGAGAGGGTCT",1,21,0,0,0,22,331
"GCTGCAGCAATGTCAC",0,9,0,0,0,9,111
"GCTGCAGCACACTGGC",4,26,10,2,7,49,1130
"GCTGCAGCAGGTTACT",2,24,3,4,2,35,697
"GCTGCAGGTGATTGGG",0,0,0,0,0,0,209
"GCTGCAGGTTAGGGTG",1,5,3,0,0,9,141
"GCTGCAGTCAAAGGTA",0,4,0,2,3,9,82
"GCTGCAGTCGAGTCCG",11,110,19,6,19,165,8196
"GCTGGGTAGACGACTG",1,2,0,0,2,5,137
"GCTGGGTAGAGTACCG",16,62,17,76,17,188,6604
"GCTGGGTAGCAACAGC",0,0,0,0,0,0,94
"GCTGGGTAGGACAGCT",1,8,3,0,0,12,54
"GCTGGGTAGTGTGTTC",9,32,18,2,16,77,1697
"GCTGGGTCAACGTTAC",5,25,2,0,2,34,408
"GCTGGGTGTCTTCGAA",0,6,0,0,0,6,208
"GCTGGGTGTGAGCTCC",0,5,3,0,0,8,141
"GCTGGGTGTTAGCGGA",0,2,0,0,0,2,17
"GCTGGGTTCGCCGTGA",0,3,4,0,0,7,79
"GCTTCACAGCTTCGTA",5,19,25,2,8,59,2406
"GCTTCACAGGCACCAA",1,3,0,0,2,6,149
"GCTTCACAGTCGAGGT",1,5,0,0,0,6,114
"GCTTCACCACCTATCC",0,11,0,0,3,14,74
"GCTTCACCAGTCAACT",2,22,3,0,6,33,559
"GCTTCACCATTCGGGC",0,6,2,0,0,8,324
"GCTTCACGTATCGTAC",0,4,0,2,3,9,270
"GCTTGGGAGAGAGCGG",2,18,3,2,3,28,297
"GCTTGGGAGATGACAT",1,14,3,0,3,21,523
"GCTTGGGGTTCTTGTT",1,11,4,0,2,18,423
"GCTTGGGTCGAGAGAC",0,0,0,0,0,0,2
"GCTTGGGTCTGGCCGA",1,16,4,0,4,25,609
"GCTTTCGAGTGCAGGT",0,4,0,0,2,6,164
"GCTTTCGCAGATCATC",15,115,21,13,26,190,8836
"GCTTTCGTCGTCCTTG",1,4,2,0,4,11,303
"GCTTTCGTCTGACAGT",2,6,0,0,0,8,165
"GGAACCCCAGCAGATG",5,43,80,4,16,148,7034
"GGAACCCCATGCAGCC",0,0,0,0,0,0,12
"GGAACCCGTTGCGGCT",4,22,6,0,8,40,153
"GGAACCCTCGCGAAGA",0,5,0,0,0,5,73
"GGAACCCTCTAGAACC",2,6,2,0,0,10,121
"GGAACCCTCTTGAACG",0,2,0,0,0,2,102
"GGAAGTGAGAGGCTGT",6,18,4,2,5,35,1040
"GGAAGTGAGCCGCTTG",1,2,0,0,0,3,44
"GGAAGTGAGCGTGTCC",6,12,6,2,4,30,417
"GGAAGTGCAACTGCCG",22,79,161,17,97,376,17084
"GGAAGTGCATGCGTGC",4,22,4,3,4,37,1211
"GGAAGTGCATGTACGT",8,70,21,6,19,124,4837
"GGAAGTGGTAACACCT",1,2,0,0,0,3,69
"GGAAGTGGTCAAGCCC",0,3,0,0,0,3,173
"GGAAGTGGTCCATCTC",1,3,3,0,0,7,142
"GGAAGTGGTCGATTCA",14,138,17,5,20,194,7318
"GGAAGTGGTCGTGATT",0,2,0,0,0,2,23
"GGAAGTGGTCTACGAT",1,6,0,0,0,7,85
"GGAAGTGGTGACAGGT",1,7,2,0,3,13,398
"GGAAGTGGTTCTAACG",2,10,0,0,0,12,82
"GGAAGTGGTTGTTTGG",2,5,0,0,0,7,93
"GGAATCTAGCCTCTCT",0,3,0,0,0,3,91
"GGAATCTAGGGACACT",2,10,2,0,0,14,144
"GGAATCTAGTGCTCAT",7,49,11,2,9,78,1650
"GGAATCTCAAGTGGTG",3,11,7,0,2,23,715
"GGAATCTGTCAAGCGA",0,2,0,0,0,2,13
"GGAATGGAGCAGTAAT",1,5,0,0,0,6,57
"GGAATGGAGGAGGGTG",0,0,0,0,0,0,3
"GGAATGGCAAGCCATT",19,18,4,0,2,43,2428
"GGAATGGCAGTAACCT",2,11,3,2,2,20,321
"GGAATGGGTCGCGGTT",6,19,8,0,7,40,467
"GGACGTCAGTTGTAGA",0,2,0,0,0,2,4
"GGACGTCCAGAGTGTG",74,577,146,46,109,952,35775
"GGACGTCCAGGAACCA",3,9,6,0,0,18,248
"GGACGTCCAGGAGGTT",0,4,0,0,0,4,130
"GGACGTCTCAGACCGC",3,10,4,0,3,20,180
"GGACGTCTCATGAGAA",3,15,6,2,3,29,506
"GGACGTCTCCATCGTC",21,72,69,2,45,209,8314
"GGACGTCTCGATACTG",11,47,19,3,10,90,3837
"GGACGTCTCTCTGCTG",0,5,2,0,0,7,126
"GGAGAACAGCGCCTAC",4,27,17,2,3,53,1995
"GGAGAACAGGCCTGAA",0,2,0,0,0,2,10
"GGAGAACCAAAGGCAC",1,4,2,0,0,7,77
"GGAGAACCATCTGGGC",17,90,23,10,14,154,7532
"GGAGAACCATGTGCCG",0,10,0,0,0,10,208
"GGAGAACGTCGATTTG",0,0,0,0,0,0,7
"GGAGAACGTTCGCGTG",0,0,0,0,0,0,5
"GGAGAACTCATCTGTT",0,6,3,0,2,11,195
"GGAGATGAGTCAATCC",0,3,0,0,0,3,89
"GGAGATGCAGGTGACA",26,88,42,13,226,395,17523
"GGAGATGGTTCTCCTG",177,187,62,17,52,495,20028
"GGAGATGTCGGAGCAA",2,2,0,0,2,6,35
"GGAGCAAAGCTGCGAA",4,15,4,0,4,27,217
"GGAGCAACAAGCCCAC",0,11,5,0,3,19,455
"GGAGCAACATCTCATT",0,0,0,0,0,0,23
"GGAGCAATCACTACTT",2,17,10,0,4,33,388
"GGAGCAATCGTAGGGA",9,19,44,4,6,82,3041
"GGAGGATAGCATACTC",3,12,4,0,8,27,429
"GGAGGATCAAGTTGGG",0,4,2,0,2,8,118
"GGAGGATCACCCAATA",15,68,98,10,115,306,13511
"GGAGGATCACCGCTGA",1,6,0,0,0,7,57
"GGAGGATGTACCTATG",3,11,0,0,2,16,251
"GGAGGATGTATGCGGA",0,7,0,0,0,7,45
"GGAGGATGTGACCGAA",1,5,2,0,0,8,84
"GGAGGATTCCATAGAC",2,13,6,0,3,24,475
"GGAGGATTCCTTCGAC",0,6,0,0,0,6,176
"GGAGGTAAGGGATCGT",0,9,0,0,0,9,194
"GGAGGTAAGTTTCAGC",49,157,98,28,421,753,34405
"GGAGGTACACTACCGG",0,3,0,0,0,3,143
"GGAGGTACAGGTCAGA",0,5,0,0,0,5,186
"GGAGGTACATCCGCGA",1,3,3,0,2,9,601
"GGAGGTAGTAGCTTTG",0,8,0,0,0,8,80
"GGAGGTAGTCAACATC",0,4,0,0,0,4,81
"GGAGGTAGTGCTCTTC",3,17,6,5,6,37,502
"GGAGGTATCCGTGACG",0,0,0,0,2,2,62
"GGAGGTATCTTCGACC",1,17,5,0,6,29,373
"GGATCTACAAAGAACT",1,5,0,0,0,6,21
"GGATCTACAAGGGTCA",2,11,4,0,0,17,357
"GGATCTACAGATTAAG",7,27,17,4,57,112,5201
"GGATCTACAGTTACCA",3,26,0,3,4,36,748
"GGATCTAGTGACATCT",1,22,2,0,2,27,549
"GGATCTATCGTGCAGC",2,12,7,0,3,24,77
"GGATCTATCTATTGTC",0,0,0,0,0,0,9
"GGATCTATCTCATAGG",1,24,6,0,6,37,368
"GGATGTTCATGCACTA",0,7,7,0,0,14,156
"GGATGTTGTGATACTC",2,17,2,0,4,25,313
"GGATGTTGTTAGTCGT",62,465,107,49,92,775,31794
"GGATGTTTCAAGCCCG",0,0,0,0,0,0,1
"GGATGTTTCTCGGCTT",1,4,2,0,3,10,136
"GGCACGTAGCAAGCCA",1,3,0,0,0,4,56
"GGCACGTCAGCTGCCA",1,4,0,0,0,5,81
"GGCACGTCATGGGATG",0,0,0,0,0,0,9
"GGCACGTGTGGGACAT",6,37,14,4,36,97,3103
"GGCAGTCAGCACTAAA",0,4,0,0,0,4,61
"GGCAGTCAGCGCGTTC",27,23,15,5,9,79,1969
"GGCAGTCAGGAAAGAC",0,7,2,0,0,9,41
"GGCAGTCAGGGCAGGA",0,0,0,0,0,0,0
"GGCAGTCCAAAGCACG",0,3,2,0,0,5,45
"GGCAGTCCACTACACA",2,5,3,0,0,10,70
"GGCAGTCGTACGAGTG",0,2,0,0,0,2,26
"GGCAGTCGTAGGTCAG",1,3,0,0,0,4,33
"GGCAGTCGTGACACGA",0,0,0,0,0,0,36
"GGCAGTCGTTCATCTT",1,0,0,0,0,1,49
"GGCAGTCTCAAGCCAT",0,0,0,0,0,0,35
"GGCAGTCTCCGTGACG",0,5,2,0,0,7,37
"GGCAGTCTCTCCTGTG",1,10,3,0,2,16,197
"GGCAGTCTCTCTGACC",1,4,0,0,0,5,31
"GGCGTCACACGCCACA",7,34,50,5,44,140,6764
"GGCGTCACATCCTGTC",0,2,0,0,0,2,29
"GGCGTCACATGCCGCA",0,10,4,0,2,16,126
"GGCGTCACATGTACGT",0,8,20,0,6,34,1199
"GGCGTCAGTCCATAGT",1,11,0,0,0,12,248
"GGCGTCATCATCGCCT",0,14,2,0,3,19,110
"GGCGTCATCATTTCCA",3,43,9,0,8,63,2210
"GGCGTCATCCCAACTC",1,5,3,0,5,14,227
"GGCGTCATCGGTCAGC",1,0,0,0,2,3,19
"GGCTGTGAGACCTCCG",74,878,141,31,114,1238,39921
"GGCTGTGAGCCTGTGC",5,38,11,0,3,57,1820
"GGCTGTGCACTAGGCC",0,0,0,0,0,0,16
"GGCTGTGCAGTGACCC",0,2,0,0,0,2,240
"GGCTGTGTCTCGTCAC",0,11,3,0,0,14,234
"GGCTTGGAGGATATAC",2,2,0,2,0,6,52
"GGCTTGGCAAATTGCC",2,41,8,3,9,63,1078
"GGCTTGGCATGTGGTT",27,217,46,13,35,338,12853
"GGCTTGGTCCCAGGCA",0,0,0,0,0,0,2
"GGCTTGGTCCGGTTCT",1,12,2,0,6,21,342
"GGCTTGGTCGCAGTTA",1,3,0,0,0,4,28
"GGCTTTCAGGCCGCTT",3,26,2,0,0,31,264
"GGCTTTCCAACTCGTA",1,2,0,0,3,6,111
"GGCTTTCCATCAGCAT",0,2,0,0,0,2,196
"GGCTTTCGTGCCTGAC",61,506,108,29,94,798,25627
"GGGAAGTAGACTTCCA",0,5,3,0,4,12,97
"GGGAAGTAGCAGCAGT",6,90,25,6,16,143,5989
"GGGAAGTAGGGTACGT",2,3,0,0,0,5,25
"GGGAAGTAGGTTTACC",3,6,5,0,2,16,105
"GGGAAGTAGTGGCAGT",21,31,11,2,8,73,2043
"GGGAAGTCACAAATAG",1,15,4,2,8,30,506
"GGGAAGTCAGTGACCC",1,17,4,0,6,28,355
"GGGAAGTTCCTATTTG",3,2,2,0,0,7,220
"GGGAAGTTCTTAAGGC",3,13,5,0,3,24,417
"GGGACAAAGAGCATTA",0,4,0,0,2,6,55
"GGGACAAAGCATCAGG",1,15,4,0,0,20,475
"GGGACAAAGGCACTAG",0,3,0,0,2,5,37
"GGGACAAAGTATGGCG",1,5,2,0,3,11,174
"GGGACAAAGTCCTGTA",0,6,0,0,0,6,119
"GGGACAAAGTGTACAA",0,12,3,0,0,15,173
"GGGACAACACAGCCTG",46,34,13,3,9,105,3728
"GGGACAACACGTAACT",3,8,6,2,4,23,401
"GGGACAACAGCAGTGA",3,15,4,0,5,27,460
"GGGACAAGTGACAACG",0,6,0,0,3,9,84
"GGGACAAGTGGAACCA",0,4,2,0,4,10,83
"GGGACCTAGCGAGGAG",0,2,2,0,2,6,26
"GGGACCTAGGCATCTT",0,0,0,0,2,2,9
"GGGACCTAGTACGAGC",0,2,2,0,0,4,175
"GGGACCTTCCGAGATT",4,16,2,0,2,24,360
"GGGACCTTCGTGGCTG",1,7,2,0,0,10,118
"GGGACCTTCTTAATCC",1,2,0,0,0,3,65
"GGGACTCCAATAGAGT",1,2,0,0,0,3,34
"GGGACTCCAGAACTCT",1,6,0,0,0,7,230
"GGGACTCGTACCAGAG",7,100,26,4,22,159,6626
"GGGACTCGTTCAAACC",114,943,292,74,195,1618,66063
"GGGAGATAGCGTATAA",0,10,2,0,8,20,427
"GGGAGATAGTTCCGTA",4,27,20,3,9,63,779
"GGGAGATCACCTCTGT",0,2,0,0,0,2,62
"GGGAGATCAGCGATTT",0,0,0,0,0,0,8
"GGGAGTAAGCCATTTG",0,5,0,0,0,5,203
"GGGAGTACAGAATGTA",1,5,0,0,2,8,107
"GGGAGTAGTACCGGCT",1,15,2,0,0,18,275
"GGGAGTAGTTCCATTT",0,9,2,0,0,11,92
"GGGAGTATCCTTCTTC",3,12,4,0,4,23,287
"GGGAGTATCGACGACC",3,9,4,0,3,19,443
"GGGAGTATCGATTCCC",6,29,30,3,8,76,2421
"GGGATCCAGACGGTCA",0,0,0,0,0,0,197
"GGGATCCAGAGAAGGT",0,2,0,0,0,2,65
"GGGATCCAGCAAGTCG",2,12,8,0,5,27,438
"GGGATCCAGCTAGAAT",7,43,10,0,6,66,2038
"GGGATCCGTAAGACCG",12,139,25,4,24,204,9044
"GGGATCCGTCACGACC",1,14,2,0,2,19,608
"GGGATCCGTGATACAA",1,3,0,0,0,4,37
"GGGATCCTCCATTTCA",1,3,0,0,0,4,230
"GGGATGAAGAAAGTCT",18,17,2,2,7,46,943
"GGGATGAAGATCACCT",6,37,9,0,19,71,934
"GGGATGAAGCGTGAGT",0,2,3,0,0,5,38
"GGGATGAGTACGGCAA",0,0,0,0,0,0,44
"GGGATGAGTATCATGC",0,8,0,0,0,8,147
"GGGATGAGTGATACTC",4,15,6,2,4,31,767
"GGGATGAGTGCTGCAC",0,2,0,0,0,2,6
"GGGATGAGTTGAGTCT",2,19,4,3,6,34,294
"GGGATGATCACGGGCT",0,2,0,0,0,2,59
"GGGATGATCCTCTTTC",0,7,0,0,0,7,125
"GGGATGATCGACGTCG",0,0,0,0,0,0,82
"GGGATGATCTTCTGTA",0,15,7,0,2,24,87
"GGGCCATAGACTCAAA",13,43,77,6,15,154,4711
"GGGCCATAGATGAACT",0,2,0,0,0,2,3
"GGGCCATAGCACCCAC",2,25,3,3,5,38,564
"GGGCCATAGCCGGAAT",0,5,0,0,0,5,38
"GGGCCATAGGCTCACC",0,5,0,0,3,8,120
"GGGCCATAGGGTCAAC",0,0,5,0,0,5,163
"GGGCCATCAACTCCAA",1,0,0,0,3,4,110
"GGGCCATCAATAACCC",4,27,3,0,5,39,458
"GGGCCATCAGCATACT",3,22,5,0,5,35,594
"GGGCCATCAGTTGTTG",29,101,23,5,18,176,5650
"GGGCCATCATCGCTAA",2,6,0,0,2,10,133
"GGGCCATTCATTGTTC",0,5,2,0,0,7,34
"GGGCGTTAGGACCCAA",1,3,0,0,0,4,32
"GGGCGTTCAAACCATC",1,0,0,0,2,3,48
"GGGCGTTCACGGCCAT",4,24,10,2,8,48,486
"GGGCGTTCACTCAGAT",0,4,0,0,2,6,85
"GGGCGTTCAGGGTCTC",1,22,9,0,6,38,1041
"GGGCGTTCATGGCCCA",0,0,0,0,0,0,59
"GGGCGTTGTATCGTAC",0,0,0,0,0,0,20
"GGGCGTTGTATTCTCT",1,3,0,0,0,4,85
"GGGCGTTGTCCCACGA",3,13,2,0,4,22,398
"GGGCGTTGTCTAGATC",0,4,0,0,2,6,78
"GGGCGTTGTGAATAAC",0,5,0,0,0,5,76
"GGGCGTTGTGACTAAA",0,3,0,0,0,3,88
"GGGCGTTGTGTTTGCA",1,3,0,0,0,4,76
"GGGCGTTTCACTCACC",0,7,0,0,0,7,152
"GGGCTACAGATCCAAA",170,759,164,39,134,1266,51560
"GGGCTACAGCGAAACC",0,2,0,0,0,2,67
"GGGCTACAGCGTGCCT",1,4,2,0,2,9,146
"GGGCTACAGCTTTCCC",0,0,0,0,0,0,7
"GGGCTACCACAACGAG",2,0,3,0,0,5,42
"GGGCTACCATTGAGGG",0,3,2,0,0,5,102
"GGGCTACGTCTCAGAT",3,40,18,4,25,90,2233
"GGGCTACGTGCTTATG",211,1806,545,103,319,2984,130159
"GGGCTACGTTCCTTGC",0,2,0,0,0,2,145
"GGGCTACGTTGTCTAG",2,6,0,0,3,11,250
"GGGCTACTCAATCTTC",2,17,2,0,2,23,462
"GGGCTACTCATCGTAG",0,3,0,0,0,3,83
"GGGCTACTCGTCAAAC",0,5,0,0,0,5,191
"GGGCTCAAGGATTTCC",1,15,4,0,0,20,432
"GGGCTCAAGGCGAAGG",1,5,0,0,0,6,77
"GGGCTCAAGGCGTCCT",24,77,23,4,17,145,3435
"GGGCTCAGTATACCTG",4,11,7,2,3,27,876
"GGGCTCAGTATCTTCT",10,50,103,11,18,192,9397
"GGGCTCAGTCACTTCC",0,0,3,0,0,3,93
"GGGCTCAGTGTCCCTT",0,7,2,0,0,9,94
"GGGCTCAGTGTCTTAG",3,18,4,0,4,29,360
"GGGCTCAGTTACCCAA",23,79,200,8,39,349,15189
"GGGCTCAGTTCCCAAA",2,4,3,0,0,9,117
"GGGCTCATCACAATGC",2,10,7,0,2,21,577
"GGGCTCATCCTATGGA",0,7,2,0,0,9,131
"GGGTAGAAGAGAGTTT",1,9,2,0,3,15,161
"GGGTAGAAGAGGTTAT",2,6,2,0,6,16,198
"GGGTAGAAGGTAGGCT",0,2,0,0,2,4,15
"GGGTAGACAGTCGAGA",0,2,0,0,2,4,68
"GGGTAGACATCGGTTA",2,20,7,0,0,29,439
"GGGTAGAGTCGTCGGT",0,3,0,0,0,3,22
"GGGTAGAGTGGCTGAA",1,16,2,0,0,19,289
"GGGTAGATCCTCGCAT",0,12,7,0,2,21,262
"GGGTAGATCGAGCCAC",0,5,2,0,0,7,257
"GGGTATTCAAGTGACG",3,10,0,0,0,13,199
"GGGTATTCAAGTGGTG",7,25,31,2,9,74,1764
"GGGTATTCAATGCAGG",1,22,5,2,6,36,948
"GGGTATTCACTACAGT",0,5,2,0,2,9,147
"GGGTATTGTCGAAGCA",1,9,11,0,4,25,421
"GGGTATTTCTGACAGT",0,10,2,0,2,14,109
"GGGTCACAGACCGTTT",1,6,3,0,0,10,78
"GGGTCACAGGGTTTCT",2,29,13,0,8,52,775
"GGGTCACCAAACGTGG",65,367,127,32,380,971,43626
"GGGTCACCAGGTTCAT",5,12,6,0,4,27,477
"GGGTCACCATCCGGCA",0,0,0,0,0,0,9
"GGGTCACTCAGCTTGA",1,3,2,0,0,6,35
"GGGTCACTCATTTCGT",0,2,0,0,0,2,183
"GGGTCACTCTAGAGCT",1,5,0,0,2,8,42
"GGGTCTGAGCAACTTC",8,29,49,3,12,101,3421
"GGGTCTGAGCAGAAAG",0,4,0,0,2,6,249
"GGGTCTGCAAGAAATC",65,223,85,217,81,671,20454
"GGGTCTGCACTATCGA",0,6,3,0,0,9,64
"GGGTCTGCAGCAGAAC",0,0,0,0,0,0,22
"GGGTCTGCAGGGAGAG",0,3,3,0,0,6,100
"GGGTCTGCATGGAACG",0,2,2,0,0,4,69
"GGGTCTGGTCTTCATT",0,6,2,0,0,8,244
"GGGTCTGGTTGTGCCG",178,948,196,55,155,1532,63669
"GGGTGAAAGCACCAGA",1,3,0,0,0,4,76
"GGGTGAAAGCCATGCC",80,41,21,7,18,167,6279
"GGGTGAAAGCGTTCCG",1,6,0,0,2,9,48
"GGGTGAAAGCTAAGTA",55,506,151,27,102,841,38926
"GGGTGAAAGGTCATTC",1,5,0,0,0,6,117
"GGGTGAACAAACTGCT",0,11,4,0,0,15,147
"GGGTGAACACACCTAA",1,2,0,0,0,3,18
"GGGTGAACACGCCAGT",1,9,2,0,0,12,126
"GGGTGTCAGTCTGGTT",1,5,0,0,0,6,273
"GGGTGTCCAAATGAGT",1,3,0,0,0,4,13
"GGGTGTCCAGCACGAA",29,246,61,11,54,401,20121
"GGGTGTCGTGTTAACC",0,0,0,0,0,0,2
"GGGTGTCTCGTAACTG",1,8,2,0,0,11,283
"GGGTTATAGCGGCTCT",69,610,141,37,112,969,44670
"GGGTTATAGCTATCCA",14,27,14,2,12,69,1738
"GGGTTATAGGTTCCAT",1,10,4,0,2,17,309
"GGGTTATCAAGGCCTC",1,12,3,0,4,20,382
"GGGTTATGTACTCAAC",1,16,2,0,4,23,307
"GGGTTATGTCTGCATA",0,3,2,0,0,5,113
"GGGTTATGTGGTAATA",19,59,34,11,113,236,9192
"GGGTTTAAGAGCAACC",1,4,0,0,3,8,78
"GGGTTTAAGGACGCTA",3,31,2,0,3,39,387
"GGGTTTAAGGATGCGT",1,3,0,0,0,4,90
"GGGTTTACAAGACGGT",0,0,0,0,0,0,20
"GGGTTTACACATGTTG",0,0,0,0,0,0,30
"GGGTTTACACCTTCCA",0,17,2,0,9,28,488
"GGGTTTACAGAATGTA",2,27,4,0,0,33,549
"GGGTTTACAGCGGTTC",0,2,0,0,0,2,26
"GGGTTTACAGTTGAAA",0,4,2,0,0,6,97
"GGGTTTAGTGCCTAAT",0,5,0,0,0,5,82
"GGGTTTATCACCATAG",1,13,4,0,9,27,436
"GGGTTTATCCACAGGC",0,0,0,0,0,0,5
"GGTAACTAGATGCGAC",0,0,0,0,0,0,13
"GGTAACTAGCTTCTAG",0,6,3,0,2,11,427
"GGTAACTCAGTCAACT",52,145,332,23,62,614,28085
"GGTAACTGTCCAGAAG",1,11,5,0,2,19,419
"GGTAACTGTTCATCGA",2,18,4,0,6,30,934
"GGTAACTTCCGAGGCT",0,3,0,0,0,3,76
"GGTAATCAGCTGTGCC",4,4,0,0,2,10,291
"GGTAATCAGTCATAGA",2,12,2,0,5,21,194
"GGTAATCCAGAGACTG",2,4,0,0,0,6,102
"GGTAATCCATATTCGG",2,2,0,0,2,6,235
"GGTAATCGTCGACGCT",0,5,0,0,0,5,90
"GGTAATCGTTAGAGAT",10,72,22,0,17,121,4088
"GGTAATCTCCATAAGC",3,17,2,0,4,26,500
"GGTAATCTCCATCTCG",1,17,2,2,0,22,520
"GGTAATCTCCGTGCGA",0,6,0,0,0,6,12
"GGTAATCTCGACCCAG",1,4,0,0,0,5,54
"GGTAATCTCGTTAGAC",3,27,3,2,3,38,359
"GGTAGAGAGCAAACAT",0,6,0,0,0,6,66
"GGTAGAGGTAAGTTAG",15,73,20,5,22,135,3398
"GGTAGAGGTCGCCACA",0,4,0,0,2,6,170
"GGTAGAGGTGTCGCTG",1,4,2,0,0,7,102
"GGTAGAGTCCTAGCTC",0,5,0,0,0,5,85
"GGTAGAGTCCTGGCTT",1,8,6,0,0,15,86
"GGTAGAGTCGTTCAGA",0,0,0,0,0,0,11
"GGTAGAGTCTAGTGAC",1,8,2,0,6,17,636
"GGTCACGAGCATGATA",0,5,0,0,0,5,180
"GGTCACGCAACACAAA",4,34,24,3,5,70,2278
"GGTCACGCACTGTCCT",2,29,7,0,8,46,466
"GGTCACGCAGTTAGGG",0,5,0,0,0,5,54
"GGTCACGGTATAATGG",0,0,0,0,0,0,24
"GGTCACGGTTGGGATG",1,5,0,0,0,6,68
"GGTCACGTCATGCATG",0,2,0,0,0,2,53
"GGTCACGTCCGGCAAC",1,4,0,0,2,7,331
"GGTCTGGAGCCATCCG",0,0,2,0,0,2,88
"GGTCTGGAGCTCGACC",0,4,0,0,0,4,146
"GGTCTGGAGTGTAGAT",11,100,20,5,21,157,5832
"GGTCTGGGTCGCTCGA",0,0,0,0,0,0,12
"GGTCTGGGTGAGCAGT",1,6,0,0,0,7,134
"GGTCTGGTCATTCCTA",0,5,2,0,0,7,123
"GGTCTGGTCCATTGGA",1,2,0,0,0,3,100
"GGTCTGGTCTCCGAAA",0,11,3,0,0,14,253
"GGTGAAGAGAGGTTTA",1,6,0,0,0,7,110
"GGTGAAGGTATCAAGA",0,2,0,0,0,2,60
"GGTGAAGTCAAGAAAC",0,8,2,0,2,12,324
"GGTGAAGTCCGTGGTG",4,22,4,0,5,35,700
"GGTGAAGTCGCCTATC",0,5,0,0,0,5,60
"GGTGATTAGAAGTGTT",140,947,274,78,225,1664,72774
"GGTGATTAGTTGTACC",1,8,0,0,0,9,126
"GGTGATTCACAGAGAC",0,0,0,0,0,0,5
"GGTGATTCAGCTCGGT",4,20,6,0,2,32,476
"GGTGATTCAGGGTTGA",0,3,2,0,0,5,91
"GGTGATTCATCAACCA",1,4,0,0,0,5,56
"GGTGATTGTCTACGAT",2,24,2,0,0,28,449
"GGTGATTGTTCTCACC",2,11,0,0,0,13,230
"GGTGATTTCATGAGGG",0,5,0,0,0,5,92
"GGTGATTTCATTTGCT",0,5,3,0,4,12,126
"GGTGATTTCGCATAGT",0,13,3,0,4,20,119
"GGTGATTTCTTTGCGC",0,3,2,0,0,5,47
"GGTGGCTAGAGCCCAA",0,3,0,0,0,3,109
"GGTGGCTAGGGAGGCA",6,29,38,5,11,89,3869
"GGTGGCTCAAATAAGC",0,2,0,0,0,2,17
"GGTGGCTCAACTGGTT",0,5,0,0,0,5,73
"GGTGGCTGTGTTGAGG",2,12,0,0,4,18,346
"GGTGGCTTCCCATACC",1,4,0,0,0,5,32
"GGTGGCTTCGCCGAGT",2,17,2,0,2,23,321
"GGTGGCTTCGTTCGCT",0,18,4,0,4,26,391
"GGTGTCGAGGTGAGAA",0,0,0,0,0,0,20
"GGTGTCGCACAATGCT",51,149,37,9,36,282,12241
"GGTGTCGCAGCTCGGT",0,4,3,0,0,7,100
"GGTGTCGGTGGAAATT",1,4,0,0,0,5,30
"GGTGTCGGTTGGCTAT",2,0,0,0,0,2,47
"GGTGTCGGTTTGGGAG",0,5,2,0,5,12,355
"GGTGTCGTCAGGCGAA",27,67,16,4,13,127,3184
"GGTGTCGTCCATTTAC",37,140,370,23,85,655,27326
"GGTGTTAAGAACGTGC",9,46,112,6,23,196,9732
"GGTGTTAAGCATCGAG",3,3,4,0,0,10,134
"GGTGTTAAGGACTAAT",0,14,0,0,5,19,468
"GGTGTTAAGGATTACA",50,138,84,22,342,636,28714
"GGTGTTACAATCACGT",1,0,0,0,0,1,29
"GGTGTTAGTAATTGGA",0,3,2,0,0,5,154
"GGTGTTAGTAGTTACC",11,24,44,6,12,97,4092
"GGTGTTAGTCAACCAT",0,2,0,0,3,5,5
"GGTGTTATCAGTGGGA",2,0,2,0,2,6,40
"GGTGTTATCGGCACTG",1,16,3,0,0,20,120
"GGTTAACCAACGGCCT",0,0,0,0,2,2,57
"GGTTAACCATTAAAGG",3,7,0,0,2,12,161
"GGTTCTCAGAAATGGG",3,4,0,0,0,7,106
"GGTTCTCAGACCATAA",20,71,155,9,40,295,15161
"GGTTCTCAGGCACGAT",0,0,0,0,0,0,75
"GGTTCTCAGTTGGACG",1,31,8,0,16,56,1866
"GGTTCTCCACAGGATG",1,3,0,0,0,4,149
"GGTTCTCCAGTCAGCC",3,5,0,0,0,8,168
"GGTTCTCGTGTTACTG",0,2,0,0,0,2,7
"GGTTCTCTCCCGAGGT",0,5,0,0,0,5,47
"GGTTCTCTCCCTCTTT",2,2,2,0,0,6,209
"GGTTCTCTCTAGTCAG",6,27,2,0,0,35,437
"GGTTGTAAGGGTTGCA",1,0,0,0,0,1,17
"GGTTGTACAATAGTCC",0,0,0,0,0,0,4
"GGTTGTACAGTTAGGG",3,10,0,0,5,18,22
"GGTTGTATCACGGACC",7,36,7,2,9,61,352
"GTAACACAGGCTCTAT",0,3,2,0,0,5,170
"GTAACACAGTGATCGG",0,12,6,0,0,18,419
"GTAACACCACGACGCT",0,2,0,0,0,2,157
"GTAACACGTCCCGTGA",0,2,0,0,0,2,23
"GTAACACTCAGGAGAC",0,5,2,0,2,9,161
"GTAACACTCATGCATG",0,3,0,0,0,3,75
"GTAACACTCCAATCCC",1,18,2,0,4,25,38
"GTAACACTCGTTCTCG",0,0,0,0,0,0,7
"GTAACCAAGGTGCATG",0,0,0,0,0,0,28
"GTAACCAAGTAGCAAT",0,3,0,0,0,3,94
"GTAACCACAACGCCCA",1,34,25,2,15,77,1510
"GTAACCAGTCTTGCTC",1,17,5,0,5,28,87
"GTAACCAGTTCTTGCC",5,32,23,4,32,96,3265
"GTAACCATCAGTGGGA",1,0,0,0,0,1,58
"GTAACCATCCTACACC",6,63,14,0,15,98,1114
"GTAACCATCCTCCACA",3,39,12,0,7,61,1022
"GTAACCATCTACACTT",1,10,0,2,2,15,622
"GTAACCATCTCCGAAA",3,23,8,2,7,43,960
"GTAAGTCCATATGGCT",8,40,64,4,53,169,8638
"GTAAGTCCATTCTCTA",2,5,0,0,0,7,121
"GTAAGTCGTAGGCAGT",0,3,0,0,0,3,153
"GTAAGTCGTTCAACGT",2,10,0,0,2,14,154
"GTAAGTCTCCTCACCA",0,5,0,0,0,5,86
"GTAATCGAGCAGAAAG",3,34,7,3,3,50,619
"GTAATCGAGCCGATCC",2,10,0,2,4,18,327
"GTAATCGAGTACGAGC",8,7,3,0,2,20,486
"GTAATCGCAATTAGGA",1,2,0,0,0,3,92
"GTAATCGCACGTACAT",0,7,2,0,0,9,215
"GTAATCGCAGAGTAAT",85,281,165,42,657,1230,55489
"GTAATCGGTCTTCCGT",32,269,58,14,44,417,18192
"GTAATCGGTGGCTCTG",16,151,30,7,19,223,9353
"GTAATCGGTGGTCTAT",3,9,0,0,2,14,113
"GTAATCGTCCATACTT",0,4,0,0,0,4,168
"GTAATCGTCCCTCGTA",1,0,2,0,0,3,91
"GTAATCGTCGTAGGAG",62,390,124,38,84,698,19427
"GTAATGCAGCCTCGTG",0,2,0,0,0,2,15
"GTAATGCCAAGAAACT",8,43,44,5,16,116,4003
"GTAATGCCAATCTCGA",8,48,12,0,15,83,1282
"GTAATGCCACAAATCC",0,2,0,0,0,2,83
"GTAATGCCACAATCTG",29,84,140,18,121,392,17577
"GTAATGCCACACCGAC",2,12,2,0,0,16,581
"GTAATGCCACCGCTAG",0,3,0,0,0,3,263
"GTAATGCCAGTAACCT",2,18,5,0,7,32,374
"GTAATGCCATAGGTTC",0,2,0,0,0,2,136
"GTAATGCCATCGCTGG",2,11,2,2,2,19,401
"GTAATGCCATGAGAAT",0,6,3,0,0,9,84
"GTAATGCTCAAGCCCG",2,11,3,0,7,23,195
"GTACAACCACATTGTG",3,12,6,0,0,21,249
"GTACAACCACTGTGTA",21,66,59,9,120,275,14426
"GTACAACCATGACGAG",0,2,2,0,0,4,102
"GTACAACGTTTCCAAG",0,3,0,0,0,3,240
"GTACAACTCAGCGGAA",0,2,0,0,0,2,5
"GTACAACTCGGCAGTC",54,259,95,226,82,716,31927
"GTACAGTAGCTCCCTT",0,17,7,0,5,29,438
"GTACAGTAGGCTCTCG",0,4,0,0,0,4,123
"GTACAGTAGGTAAACT",2,12,4,2,0,20,722
"GTACAGTAGGTCCTGC",239,106,52,18,46,461,20467
"GTACAGTAGTGGATAT",2,3,3,0,2,10,89
"GTACAGTCAATGGCCC",2,24,4,2,3,35,519
"GTACAGTCACTGAGTT",2,18,7,3,3,33,486
"GTAGAAAAGCCTCAAT",0,10,2,0,0,12,346
"GTAGAAACACCGTACG",2,13,6,0,6,27,521
"GTAGAAACACTGGATT",2,10,9,0,4,25,582
"GTAGAAAGTGCATTAC",2,10,4,0,0,16,325
"GTAGAAAGTGGAACCA",2,28,7,2,7,46,868
"GTAGAAAGTTCCTAGA",4,33,41,4,12,94,2424
"GTAGAAATCAGATGCT",5,39,4,0,9,57,128
"GTAGAAATCGAACGGA",10,35,41,3,15,104,4001
"GTAGAGGAGGCCACCT",3,25,20,4,5,57,1511
"GTAGAGGAGTATTAGG",6,44,37,2,8,97,3841
"GTAGAGGCAGACACCC",0,0,0,0,0,0,9
"GTAGAGGGTAACGCGA",0,2,0,0,0,2,134
"GTAGAGGGTCTGTAAC",39,123,292,21,53,528,25882
"GTAGAGGGTTGTTTGG",1,27,7,0,3,38,512
"GTAGAGGTCCAAGAGG",0,10,0,2,2,14,76
"GTAGAGGTCCGATTAG",77,52,22,11,19,181,8113
"GTAGAGGTCGTTAGTG",0,0,0,2,0,2,22
"GTAGAGGTCTCAACCC",2,19,8,0,4,33,370
"GTAGATCGTGATCATC",1,9,2,0,3,15,243
"GTAGATCGTTTGCCGG",2,12,8,0,3,25,281
"GTAGATCTCTATTGTC",0,7,0,0,0,7,133
"GTAGCTAAGCTTACGT",0,2,0,0,3,5,50
"GTAGCTATCCGGTTCT",2,4,2,0,2,10,190
"GTAGGAGAGCGCTGAA",2,5,2,0,0,9,162
"GTAGGAGAGTCCCAAT",0,3,0,0,0,3,5
"GTAGGAGGTCCTATAG",2,3,2,0,2,9,419
"GTAGGAGGTGCCCACA",1,25,7,0,5,38,623
"GTAGGAGGTGGCCTCA",0,2,0,0,0,2,73
"GTAGGAGTCCATTTAC",0,6,4,0,0,10,135
"GTAGGAGTCCTCGATC",1,3,0,0,0,4,149
"GTAGGAGTCGGTAGGA",3,21,9,0,42,75,2215
"GTAGGAGTCTTGTTAC",10,47,60,7,13,137,4855
"GTAGGAGTCTTTGCAT",0,11,2,0,3,16,310
"GTAGGTTAGATGTAGT",1,0,0,0,0,1,16
"GTAGGTTAGCGCCTAC",7,33,16,6,69,131,7508
"GTAGGTTAGCTTACGT",4,27,12,0,3,46,637
"GTAGGTTAGTCCCAAT",3,9,2,0,0,14,300
"GTAGGTTAGTCCGCGT",7,53,19,2,16,97,4192
"GTAGGTTAGTTGGAGC",10,65,21,26,18,140,7105
"GTAGGTTCACACTTAG",1,4,0,0,0,5,89
"GTAGGTTCACTTGTCC",24,134,32,40,30,260,8742
"GTAGGTTCAGCGCGTT",0,2,0,0,2,4,48
"GTAGGTTGTCCAAAGG",3,19,4,0,3,29,554
"GTAGGTTGTTCACCGG",3,24,3,0,2,32,1688
"GTAGGTTTCAGAATAG",2,10,2,0,0,14,262
"GTAGTACAGACAGCGT",0,3,0,0,0,3,54
"GTAGTACAGGCGAAGG",0,20,7,0,3,30,513
"GTAGTACCAGGTGTTT",36,129,91,26,276,558,25343
"GTAGTACCATAAGCAA",0,2,0,0,2,4,177
"GTAGTACCATTCTGTT",1,26,4,0,2,33,1221
"GTAGTACGTAATTAGG",2,8,4,0,0,14,105
"GTAGTACGTACGAGCA",2,15,7,0,5,29,369
"GTAGTACGTAGCGCCT",18,68,29,10,95,220,8601
"GTAGTACGTAGTCGGA",0,0,0,0,0,0,27
"GTAGTACGTGAGACGT",1,20,10,0,0,31,894
"GTAGTACTCACCTCTG",1,8,0,0,0,9,143
"GTAGTACTCAGTGTCA",120,67,43,14,31,275,10791
"GTAGTACTCGCCTCTA",0,18,8,0,0,26,329
"GTAGTACTCTCTCTTC",1,2,0,0,0,3,6
"GTATTGGGTCCTTGTC",2,14,6,0,2,24,489
"GTATTGGGTGGTAATA",16,74,21,11,19,141,5992
"GTATTGGTCATTGTGG",3,25,4,0,5,37,609
"GTATTGGTCCAGTACA",31,116,256,13,45,461,24779
"GTATTGGTCGATACAC",1,6,0,3,2,12,88
"GTATTTCAGGCCTGAA",0,9,0,0,0,9,200
"GTATTTCAGGGCAATC",0,5,4,0,2,11,286
"GTATTTCCAACTTCTT",1,3,0,0,0,4,8
"GTATTTCCAGTGTACT",1,33,12,0,3,49,587
"GTATTTCGTATCGTAC",0,9,4,0,2,15,393
"GTATTTCGTGTCATCA",0,5,0,0,2,7,133
"GTATTTCTCAGTGGGA",91,273,743,45,159,1311,70648
"GTCAAACAGTCTGGAG",0,20,6,2,2,30,289
"GTCAAACCAACTCCAA",6,25,26,3,15,75,1593
"GTCAAACCAAGTTGGG",0,0,0,0,0,0,199
"GTCAAACCAATTGCGT",0,0,0,0,0,0,52
"GTCAAACCACTAAACC",0,0,2,0,0,2,3
"GTCAAACCATACTTTC",3,15,8,0,5,31,636
"GTCAAACCATGTCGTA",1,5,3,0,0,9,100
"GTCAAACTCGCATTAG",0,2,0,0,0,2,3
"GTCAAACTCGCCTTGT",0,22,3,0,3,28,791
"GTCAAACTCTGTCAGA",0,3,0,0,0,3,61
"GTCAAGTCACCGGAAA",0,15,9,2,4,30,309
"GTCAAGTCAGACCTGC",0,11,0,0,2,13,298
"GTCAAGTGTAGCCCTG",2,4,0,0,0,6,68
"GTCAAGTTCGCCTTGT",1,3,3,0,0,7,139
"GTCAAGTTCTGGGCAC",13,167,39,7,27,253,10875
"GTCACGGCAAAGTATG",1,7,2,0,2,12,325
"GTCACGGCACCCTATC",0,0,0,0,0,0,21
"GTCACGGGTACCTGTA",3,21,9,0,2,35,552
"GTCACGGGTGATTAGA",5,10,4,0,2,21,312
"GTCACGGGTGGCTTAT",2,31,8,0,5,46,653
"GTCACGGTCATAGACC",0,7,0,0,0,7,164
"GTCACGGTCCACTGGG",1,12,4,0,0,17,335
"GTCACGGTCCCACAGG",2,19,3,2,7,33,453
"GTCACGGTCGATTGGT",1,5,0,0,0,6,43
"GTCACTCAGCTAAACA",1,0,0,0,0,1,49
"GTCACTCCAGAGGACT",4,22,6,0,18,50,1426
"GTCACTCCATGACTTG",0,4,2,0,0,6,90
"GTCACTCGTACGAGCA",3,14,2,0,2,21,288
"GTCACTCGTATGCTAC",1,2,0,0,2,5,148
"GTCACTCGTTAGGCTT",10,113,31,9,22,185,8384
"GTCACTCGTTGCAAGG",0,0,0,0,0,0,4
"GTCACTCTCAACCCGG",3,9,2,0,0,14,787
"GTCACTCTCATAGAGA",4,19,7,4,6,40,434
"GTCACTCTCCGCTTAC",5,16,0,0,0,21,382
"GTCACTCTCTGCATGA",0,3,0,0,0,3,123
"GTCAGCGAGGTTGAGC",0,4,0,0,2,6,33
"GTCAGCGCACGACGCT",77,191,34,9,47,358,15476
"GTCAGCGCAGGCTCTG",7,3,0,0,3,13,860
"GTCAGCGGTGACCGAA",0,7,0,0,2,9,105
"GTCAGCGTCACCCTTG",0,0,2,0,0,2,76
"GTCAGCGTCATCACAG",0,5,2,0,0,7,63
"GTCAGCGTCCACGAAT",0,7,0,0,0,7,162
"GTCAGCGTCCATTCAT",0,5,2,0,0,7,126
"GTCATCCAGATACGAT",1,17,3,0,3,24,370
"GTCATCCAGCAGCCTC",0,0,0,0,0,0,6
"GTCATCCAGCCTGTGC",1,6,0,0,2,9,132
"GTCATCCAGGAGATAG",1,21,5,0,3,30,215
"GTCATCCAGGTTCTTG",0,5,2,0,0,7,144
"GTCATCCAGTAAGGGA",3,19,6,0,4,32,163
"GTCATCCCAACAACAA",1,6,0,0,0,7,41
"GTCATCCCAACACAGG",0,2,0,0,0,2,17
"GTCATCCCAAGGTCGA",1,0,0,0,0,1,24
"GTCATCCGTCTCACAA",21,199,62,6,36,324,12823
"GTCATCCGTTAGGGTG",7,13,3,0,4,27,386
"GTCATCCTCAGGACAG",0,0,0,0,2,2,22
"GTCATCCTCTTCACGC",3,25,5,0,0,33,157
"GTCATCCTCTTCGGTC",0,8,2,0,0,10,116
"GTCATGAAGCCACCGT",78,811,159,31,117,1196,42183
"GTCATGAAGCCGCACT",2,4,0,0,0,6,85
"GTCATGACATGCGGTC",0,0,0,0,0,0,8
"GTCATGACATGTGACT",0,5,2,0,0,7,49
"GTCATGACATTGAAAG",0,4,0,0,0,4,9
"GTCATGAGTAGGGTAC",4,52,89,8,17,170,5726
"GTCATGAGTGTTGACT",1,5,0,0,0,6,70
"GTCATGATCCGGACGT",0,6,0,0,0,6,16
"GTCATGATCGCTATTT",77,355,96,22,248,798,30916
"GTCATTTAGGAATCGC",1,17,8,0,3,29,482
"GTCATTTAGGCTTTCA",4,27,4,0,5,40,358
"GTCATTTGTCACTTCC",0,7,0,0,2,9,156
"GTCATTTTCGTGGGAA",0,0,0,0,0,0,2
"GTCCACTAGCGCCATC",0,3,0,0,0,3,142
"GTCCACTAGGATAATC",1,7,0,0,0,8,114
"GTCCACTCAGAGTAAT",0,2,0,0,0,2,54
"GTCCACTCATTGACCA",4,64,16,7,11,102,3748
"GTCCACTGTAACTTCG",6,8,3,0,2,19,411
"GTCCACTGTTCTCCTG",0,5,3,0,0,8,136
"GTCCACTTCAATCCGA",1,6,0,0,0,7,103
"GTCCACTTCCATGCAA",0,7,0,0,0,7,160
"GTCCCATAGAATCCCT",0,5,0,0,3,8,307
"GTCCCATAGTGAGGTC",0,8,2,0,0,10,91
"GTCCCATAGTGATAGT",0,2,0,0,0,2,48
"GTCCCATCATTCATCT",0,7,0,0,2,9,80
"GTCCCATGTAGACAGC",1,13,3,0,0,17,40
"GTCCCATGTAGCTGCC",0,0,0,0,2,2,60
"GTCCCATGTCACTCGG",10,47,9,0,10,76,2150
"GTCCCATGTTGCAAGG",1,8,0,0,0,9,524
"GTCCCATTCCAATCTT",4,21,5,0,3,33,122
"GTCCTCAAGAGTATAC",0,8,2,0,0,10,288
"GTCCTCAAGCATTGAA",0,3,0,0,0,3,66
"GTCCTCAAGCGCCCAT",1,17,7,2,3,30,405
"GTCCTCAAGGTGTGAC",1,4,0,0,0,5,225
"GTCCTCACAGGACATG",3,13,4,0,0,20,234
"GTCCTCAGTACTCAAC",0,4,2,0,2,8,25
"GTCCTCAGTACTCGCG",1,5,0,0,0,6,126
"GTCCTCAGTCTTGCGG",1,8,9,2,7,27,331
"GTCCTCAGTGTCTTCC",1,3,0,0,0,4,122
"GTCCTCAGTTGATGTC",0,5,0,0,0,5,35
"GTCCTCATCATCCCGT",0,3,0,0,2,5,81
"GTCCTCATCCGCATAA",0,6,0,0,3,9,312
"GTCGAATCAGGGTCTC",0,4,0,0,0,4,52
"GTCGAATGTCAACGCC",0,3,2,0,0,5,99
"GTCGAATTCACTTTGT",3,10,0,0,2,15,162
"GTCGAATTCAGCTTGA",0,4,0,0,2,6,65
"GTCGAATTCTGCATGA",4,29,6,2,4,45,557
"GTCGCGAAGCACTCAT",0,2,0,0,0,2,217
"GTCGCGAAGCTGTGCC",38,377,72,15,58,560,20460
"GTCGCGAAGGAAGTAG",1,11,11,0,7,30,670
"GTCGCGACACTCATAG",1,2,0,0,0,3,159
"GTCGCGAGTGAATTAG",2,3,4,0,2,11,171
"GTCGCGATCACCCTCA",1,19,5,0,4,29,193
"GTCGCGATCATGGCCG",2,3,2,0,2,9,115
"GTCGCGATCGATTGGT",0,0,0,0,0,0,12
"GTCGTAAAGAAGCGGG",0,0,2,0,0,2,237
"GTCGTAAGTGTGCCTG",0,15,8,0,5,28,679
"GTCGTAAGTTGCCGAC",0,13,5,0,2,20,295
"GTCGTAATCTAAGAAG",3,13,3,0,4,23,264
"GTCGTTCAGAGAACCC",3,0,0,0,2,5,30
"GTCGTTCAGGATTACA",2,4,3,0,0,9,143
"GTCGTTCAGGGATCAC",93,776,271,52,147,1339,48712
"GTCGTTCAGGTCACCC",0,4,0,0,4,8,230
"GTCGTTCCAAATGCGG",0,8,2,0,0,10,46
"GTCGTTCCAGTATTCG",0,5,0,0,0,5,30
"GTCGTTCCATCAGCTA",2,3,0,0,0,5,139
"GTCGTTCGTATGCTTG",0,3,0,0,0,3,60
"GTCTACCAGCACTAAA",1,3,2,0,0,6,162
"GTCTACCAGCTGCCAC",3,21,16,0,8,48,1599
"GTCTACCAGTAACCTC",3,22,6,0,4,35,590
"GTCTACCAGTCGCCCA",1,3,0,0,0,4,82
"GTCTACCCAGATCATC",0,3,0,0,0,3,63
"GTCTACCCATCCGGTG",0,2,0,0,0,2,33
"GTCTACCGTACCGTGC",5,19,4,0,4,32,123
"GTCTACCGTCCTACAA",1,2,3,0,2,8,116
"GTCTACCTCGTCCTCA",3,26,26,2,10,67,2056
"GTCTAGAAGATTGGGC",2,22,7,3,6,40,420
"GTCTAGACAAACGGCA",0,0,3,0,0,3,134
"GTCTAGACACTGGATT",9,44,45,4,48,150,6706
"GTCTAGACAGCCGTCA",0,8,0,0,0,8,117
"GTCTAGAGTGAGGCAT",0,3,2,0,0,5,59
"GTCTAGAGTGTTCAGT",1,8,4,0,6,19,304
"GTCTAGAGTTAAACCC",3,38,14,0,11,66,887
"GTCTAGATCCTTCGAC",0,9,2,0,2,13,233
"GTCTCACGTCCCACGA",1,6,2,0,0,9,515
"GTCTCACGTTGTGCCG",1,14,3,0,0,18,475
"GTCTCACGTTTCGACA",1,0,0,0,0,1,12
"GTCTCACTCAAGAAAC",1,3,0,0,0,4,117
"GTCTGTCAGCCTCTTC",2,21,5,3,6,37,409
"GTCTGTCAGGAAGAAC",1,6,2,0,2,11,78
"GTCTGTCCAACCACAT",3,12,0,0,5,20,500
"GTCTGTCCAAGCGCTC",0,0,0,0,0,0,22
"GTCTGTCCAGGCACAA",0,12,3,0,3,18,398
"GTCTGTCCATAGGTAA",2,18,14,0,5,39,1077
"GTCTGTCGTTCTTAGG",0,3,2,0,0,5,65
"GTCTGTCTCAGTCACA",0,4,0,0,0,4,129
"GTCTGTCTCTTTGCAT",4,12,7,0,26,49,2543
"GTCTTTAAGACCGTTT",1,7,3,0,0,11,309
"GTCTTTAAGCTGGTGA",4,24,4,2,8,42,690
"GTCTTTAAGTAAATGC",31,102,27,4,18,182,6856
"GTCTTTACAGCGTTGC",1,11,2,0,0,14,396
"GTCTTTAGTTGAGGAC",0,2,0,0,0,2,42
"GTCTTTATCACAACCA",2,16,3,0,3,24,271
"GTCTTTATCCGGTAGC",9,43,11,3,61,127,5029
"GTCTTTATCTAGTACG",0,0,0,0,0,0,6
"GTGACGCAGAGCAGTC",1,3,0,0,0,4,112
"GTGACGCAGATGGGCT",0,3,0,0,0,3,42
"GTGACGCAGCAATTCC",4,3,2,0,0,9,251
"GTGACGCAGGACTTCT",36,88,65,18,251,458,24029
"GTGACGCCACATTACG",0,0,0,0,0,0,84
"GTGACGCCATATACCG",0,2,0,0,2,4,78
"GTGAGCCCACAGCCAC",20,65,135,7,30,257,13383
"GTGAGCCCATACTTTC",3,28,7,0,6,44,855
"GTGAGCCGTCTCAAGT",1,4,0,0,0,5,133
"GTGAGCCGTTCGGTCG",39,57,13,3,20,132,3441
"GTGAGCCGTTGAGTCT",0,2,2,0,3,7,161
"GTGAGCCTCAGGAAAT",3,15,6,0,5,29,307
"GTGAGCCTCGCACTCT",0,0,0,0,0,0,33
"GTGAGCCTCTTAGTTC",0,8,0,0,0,8,191
"GTGAGGAAGCTCACTA",0,7,2,0,0,9,65
"GTGAGGATCAAGAGGC",2,5,2,0,0,9,258
"GTGAGGATCACTTTGT",2,13,5,0,2,22,260
"GTGAGGATCGAAGGAC",0,2,3,0,0,5,102
"GTGAGTTAGATCGCCC",1,12,4,0,2,19,525
"GTGAGTTAGGAACTAT",23,73,153,9,29,287,15039
"GTGAGTTCAAGTGTCT",1,9,2,0,0,12,129
"GTGAGTTCACGCTTAA",1,19,3,0,6,29,598
"GTGAGTTCAGTTTCAG",0,3,0,0,0,3,10
"GTGAGTTGTCTTGCGG",2,6,2,0,2,12,148
"GTGAGTTTCAGTGTCA",1,4,4,0,0,9,28
"GTGAGTTTCGTGGGTC",113,61,29,4,24,231,9474
"GTGATGTAGCTGTTAC",0,4,0,0,0,4,198
"GTGATGTAGGACACTG",1,12,6,0,2,21,377
"GTGATGTAGGGAGGAC",12,94,38,4,17,165,7245
"GTGATGTCACAGGATG",74,409,131,34,354,1002,47727
"GTGATGTCACCCTTGT",3,22,18,2,7,52,2266
"GTGATGTTCACCTACC",15,54,99,5,25,198,9738
"GTGATGTTCGGAGCAA",2,7,4,0,0,13,449
"GTGATGTTCTGTCTCG",0,2,0,0,0,2,13
"GTGCACGAGGTTCATC",2,18,6,0,5,31,455
"GTGCACGCAACTGAAA",1,7,2,0,0,10,128
"GTGCACGCAATTGCCA",63,543,124,56,97,883,41104
"GTGCACGGTCTAGTGT",0,0,0,0,2,2,26
"GTGCACGGTTCCCACT",2,20,12,0,10,44,1228
"GTGCACGTCATGCAGT",8,44,29,3,26,110,3791
"GTGCACGTCCACGAAT",3,12,6,0,0,21,475
"GTGCACGTCCCTCAAC",1,13,2,0,4,20,55
"GTGCACGTCGTCGGGT",0,4,3,0,4,11,230
"GTGCACGTCTCTTAAC",0,8,0,0,0,8,125
"GTGCACGTCTTCGGAA",3,7,2,3,2,17,471
"GTGCAGCAGCTTCATG",0,0,0,0,0,0,45
"GTGCAGCCAATAGGGC",1,14,5,0,3,23,323
"GTGCAGCCACAAATCC",0,0,3,0,0,3,66
"GTGCAGCCAGAGTGAC",0,3,2,0,0,5,42
"GTGCAGCCATCGCTGG",1,3,3,0,0,7,50
"GTGCAGCGTAATCAGA",1,5,0,0,0,6,69
"GTGCAGCTCACATCAG",21,120,143,16,37,337,13197
"GTGCAGCTCCGCATAA",4,28,4,0,4,40,660
"GTGCAGCTCCGTGCGA",0,7,0,0,0,7,307
"GTGCAGCTCCTAACAG",1,9,2,0,4,16,539
"GTGCGTGCACGCACCA",1,13,2,0,4,20,547
"GTGCGTGCAGATAAAC",1,6,0,0,0,7,264
"GTGCGTGCAGCAGACA",36,229,57,14,46,382,14255
"GTGCGTGCATTCTCTA",2,16,4,0,9,31,770
"GTGCGTGGTCACTCAA",0,3,0,0,0,3,30
"GTGCTGGAGTAATCCC",0,2,2,0,0,4,45
"GTGCTGGGTACGACAG",11,37,72,6,20,146,6744
"GTGCTGGGTCATCTAG",0,5,2,0,0,7,86
"GTGCTGGGTTTGACAC",0,7,8,0,6,21,509
"GTGCTGGTCGCGCTGA",1,4,0,0,0,5,113
"GTGCTTCAGTAGAGTT",1,3,2,0,2,8,88
"GTGCTTCCAGAACTCT",37,132,291,14,107,581,29207
"GTGCTTCCAGTCGTTA",1,2,0,0,9,12,441
"GTGCTTCGTGAAAGTT",6,56,15,4,10,91,4061
"GTGCTTCTCAAATGAG",2,18,14,2,5,41,1087
"GTGCTTCTCTGCATAG",0,6,3,0,2,11,140
"GTGGAAGGTGTCCAAT",0,6,0,0,0,6,204
"GTGGAAGTCCGGACGT",1,2,2,0,0,5,164
"GTGGAAGTCGGCTGGT",4,68,18,4,13,107,4781
"GTGGAGAAGAGAGCGG",2,15,2,0,2,21,271
"GTGGAGAAGCTCGTGC",2,13,2,0,2,19,155
"GTGGAGAAGGATATAC",0,11,3,0,2,16,417
"GTGGAGACAGGTTCAT",2,5,0,0,0,7,280
"GTGGAGACATGACAGG",0,3,0,0,0,3,38
"GTGGAGAGTGGATCAG",0,5,2,0,0,7,188
"GTGGAGAGTGGCTTAT",3,19,4,0,0,26,420
"GTGGAGATCCCAGCGA",12,166,31,10,22,241,10617
"GTGGAGATCCTCAGGG",3,11,3,0,6,23,93
"GTGGAGATCGGATTAC",10,105,32,10,79,236,11638
"GTGGCGTAGCCATTGT",1,12,3,0,2,18,391
"GTGGCGTCATAGTCAC",0,15,4,0,6,25,357
"GTGGCGTTCGGCATCG",4,12,5,0,2,23,319
"GTGGCGTTCTGCGGCA",2,4,3,0,3,12,333
"GTGGGAAAGATGGTAT",0,5,0,0,2,7,41
"GTGGGAAAGTATGATG",7,53,12,5,12,89,431
"GTGGGAAAGTCTAACC",1,19,3,0,7,30,578
"GTGGGAACACAAATAG",143,199,67,17,56,482,20807
"GTGGGAAGTTAGGGTG",361,586,206,58,172,1383,69823
"GTGGGAATCATAGACC",0,3,0,0,2,5,11
"GTGGGAATCGAACGCC",11,68,20,6,20,125,4407
"GTGGGAATCTGGGCCA",2,0,0,0,0,2,82
"GTGGTTAAGTAAACGT",18,130,23,6,21,198,9636
"GTGGTTAAGTCGGCCT",0,9,0,0,2,11,206
"GTGGTTACAACCAACT",2,11,4,0,5,22,458
"GTGGTTACATCTTAGG",1,6,4,0,2,13,211
"GTGGTTATCCTTTGAT",0,9,3,0,0,12,128
"GTGGTTATCGGCCTTT",0,5,0,0,0,5,56
"GTGGTTATCGTTCCTG",1,0,0,0,0,1,13
"GTGGTTATCTCTTAAC",0,2,0,0,0,2,8
"GTGGTTATCTGCTAGA",0,8,2,0,0,10,97
"GTGTAACAGAGTCTTC",0,9,2,0,0,11,143
"GTGTAACCACGCTGCA",1,3,0,0,0,4,108
"GTGTAACGTTTCGGCG",1,6,0,0,0,7,45
"GTGTAACTCGAATCCA",1,2,0,0,0,3,119
"GTGTAACTCGCGATCG",1,9,3,0,0,13,231
"GTGTAACTCGTACACA",4,17,9,0,3,33,573
"GTGTCCTAGCTCGAAG",25,44,17,63,23,172,5525
"GTGTCCTCAGGGATAC",4,29,32,2,31,98,3851
"GTGTCCTGTGCGCTCA",0,0,0,0,0,0,36
"GTGTCCTGTGGCTTGC",15,49,34,13,122,233,8364
"GTGTCCTTCCTCACTG",22,69,28,13,148,280,10780
"GTGTGATAGTCTCTGA",1,10,4,0,2,17,158
"GTGTGATCAATCGAAA",0,5,2,0,0,7,155
"GTGTGATGTGCCCTTT",0,0,0,0,0,0,91
"GTGTGATTCAGAGCGA",0,25,5,0,4,34,312
"GTGTGATTCAGTGTTG",3,25,7,3,4,42,127
"GTGTGGCAGATGATTG",8,38,43,6,62,157,7324
"GTGTGGCAGGATGCGT",3,6,3,3,0,15,398
"GTGTGGCAGGATTTGA",0,2,2,0,0,4,51
"GTGTGGCCAACCTAAC",0,0,0,0,0,0,22
"GTGTGGCCAGGGTCTC",3,39,8,0,3,53,782
"GTGTGGCTCATGCCAA",1,32,3,0,5,41,672
"GTGTGGCTCCAGTTCC",1,4,5,0,0,10,140
"GTGTGGCTCGCCGTGA",0,10,0,0,0,10,502
"GTGTTAGAGCTTCATG",3,18,2,0,4,27,291
"GTGTTAGCAATAAGGT",42,102,213,22,90,469,22112
"GTGTTAGTCACCACAA",4,27,8,3,7,49,671
"GTGTTAGTCGACGTCG",0,6,0,0,2,8,77
"GTGTTCCAGACGCATG",2,6,0,0,0,8,80
"GTGTTCCCAAGTACCT",3,7,0,0,0,10,263
"GTGTTCCCACACGGTC",0,7,0,2,2,11,73
"GTGTTCCGTAACTGCT",0,3,3,0,2,8,378
"GTGTTCCGTATTGGCT",3,23,5,3,6,40,90
"GTGTTCCTCCGGTAGC",0,2,0,0,0,2,8
"GTTACAGAGGTATCTC",1,8,3,0,3,15,358
"GTTACAGGTATGAGCG",1,7,4,0,0,12,148
"GTTACAGTCTGCATAG",1,4,0,0,3,8,347
"GTTACCCAGATTAGTG",5,24,21,0,6,56,1776
"GTTACCCAGGTAAACT",31,377,72,16,62,558,27716
"GTTACCCCAAACGTGG",2,16,9,0,16,43,1308
"GTTACCCCACTGTGTA",1,14,5,0,3,23,455
"GTTACCCCAGCATTGT",0,0,0,0,0,0,19
"GTTACCCCATATGGCT",0,4,0,0,0,4,108
"GTTACCCCATGTGGTT",0,5,0,0,0,5,21
"GTTACCCGTAATTAGG",3,13,7,2,10,35,994
"GTTACCCGTATCCCAA",1,11,3,0,0,15,288
"GTTACCCGTATCTCGA",5,35,15,2,34,91,3007
"GTTACCCGTATGTCTG",2,32,5,3,6,48,1050
"GTTACCCTCAGTGTTG",2,19,3,0,0,24,115
"GTTACCCTCGACATCA",25,210,47,10,47,339,13874
"GTTACCCTCGTGGAAG",1,8,0,0,2,11,188
"GTTACCCTCTCGAGTA",0,0,0,0,0,0,1
"GTTACGAAGCAGGTCA",0,8,0,2,0,10,78
"GTTACGACAGAGGTAC",1,10,4,0,0,15,285
"GTTACGACATCCGAAT",5,14,3,0,5,27,498
"GTTACGACATGACGGA",2,8,0,0,2,12,149
"GTTACGAGTCCACAGC",26,19,15,4,5,69,2185
"GTTACGAGTGCTGCAC",4,28,6,2,7,47,569
"GTTACGATCTCATGCC",7,45,15,2,47,116,4737
"GTTAGACAGTTAGTAG",0,4,0,0,0,4,112
"GTTAGACGTGAATATG",4,2,5,0,3,14,185
"GTTAGACGTGCCGTTG",2,15,5,0,4,26,123
"GTTAGACGTTATAGCC",0,3,0,0,2,5,91
"GTTAGACGTTGAGTCT",0,0,0,0,0,0,5
"GTTAGACTCACGGGAA",0,3,0,0,0,3,48
"GTTAGACTCACGGTCG",5,8,3,0,2,18,166
"GTTAGACTCTCTCGCA",1,8,4,0,0,13,50
"GTTAGTGCATAATGCC",0,4,0,0,3,7,86
"GTTAGTGGTCCACTCT",0,9,0,0,0,9,282
"GTTAGTGGTGTCCGTG",33,72,21,5,20,151,4194
"GTTAGTGTCATTATCC",0,2,0,0,3,5,72
"GTTAGTGTCTGTGTGA",0,0,0,0,0,0,28
"GTTAGTGTCTTAGGAC",3,22,5,0,4,34,740
"GTTAGTGTCTTCGGTC",6,15,2,2,3,28,598
"GTTATGGAGAGGCGTT",0,0,0,0,0,0,59
"GTTATGGGTGAGTAGC",83,672,176,58,127,1116,54065
"GTTATGGGTTGGGACA",3,20,4,3,3,33,436
"GTTCATTAGCGACATG",15,92,64,11,89,271,15917
"GTTCATTCACCCTCTA",0,2,2,0,0,4,34
"GTTCATTCACGCGGTT",1,8,0,0,4,13,181
"GTTCATTCACTTGGGC",1,5,0,0,0,6,189
"GTTCATTGTGACGCCT",51,240,109,30,270,700,35192
"GTTCATTGTGGCTAGA",19,71,18,7,16,131,3736
"GTTCATTTCAGTGTCA",0,0,0,0,0,0,16
"GTTCATTTCATAGAGA",3,29,18,3,10,63,1763
"GTTCATTTCGGTGTAT",2,16,6,5,5,34,1454
"GTTCATTTCTAGCCTC",4,4,0,0,3,11,186
"GTTCCGTAGTGATAGT",13,128,31,7,19,198,11310
"GTTCCGTCATCGGTTA",0,3,3,0,0,6,148
"GTTCCGTTCACGGTCG",0,0,0,0,0,0,31
"GTTCCGTTCTTCACGC",0,5,0,2,0,7,171
"GTTCGCTAGACTTCAC",2,23,9,6,3,43,488
"GTTCGCTAGCACTCGC",2,26,8,2,5,43,849
"GTTCGCTAGCTCGACC",3,14,2,0,9,28,562
"GTTCGCTCAAGAGTAT",3,16,3,0,6,28,574
"GTTCGCTCAGGTTACT",2,12,9,0,0,23,573
"GTTCGCTCATCGTCCT",0,0,0,0,0,0,11
"GTTCGCTGTGAGTTGG",4,26,5,0,8,43,872
"GTTCGCTGTTCTATCT",0,4,0,0,0,4,103
"GTTCTATCAGTCGCAC",23,192,49,10,40,314,16181
"GTTCTATCATGGGCAA",2,16,4,0,0,22,391
"GTTCTATGTCTCTCAC",3,26,8,2,6,45,1138
"GTTCTATGTTCTCGTC",1,3,2,0,0,6,32
"GTTCTATTCCGGTTCT",1,14,0,2,0,17,476
"GTTGAACAGACTAGAT",5,25,3,2,15,50,1366
"GTTGAACCAGTTTCGA",0,0,0,0,0,0,30
"GTTGAACCATAGAAAC",0,0,2,0,0,2,2
"GTTGAACGTACAGTAA",0,5,0,0,0,5,325
"GTTGAACGTGTACAGG",3,23,4,0,2,32,416
"GTTGCGGAGAGCCATG",1,3,2,0,0,6,148
"GTTGCGGAGTTTCGAC",22,161,38,7,26,254,11777
"GTTGCGGCAGTCAGAG",0,0,0,0,0,0,1
"GTTGCGGCATAATGAG",2,4,5,0,3,14,155
"GTTGCGGCATCGTCCT",0,0,0,0,0,0,70
"GTTGCTCAGTCCGTCG",0,4,2,0,0,6,88
"GTTGCTCAGTTACGAA",11,66,14,2,9,102,4290
"GTTGCTCCACTCGATA",1,5,0,0,2,8,96
"GTTGCTCCAGGTTCGC",0,0,0,0,0,0,28
"GTTGCTCCATAGGAGC",23,131,104,6,34,298,14667
"GTTGCTCCATCCGGTG",0,4,2,0,0,6,322
"GTTGCTCCATCGGAAG",2,3,0,0,0,5,130
"GTTGCTCGTCAGGTAG",1,0,0,0,0,1,38
"GTTGCTCGTCGTGGAA",0,0,0,0,0,0,20
"GTTGCTCGTGGCTCTG",0,0,0,0,0,0,19
"GTTGTAGAGAGAGCCT",9,31,9,0,8,57,725
"GTTGTAGCAGAGGACT",11,44,74,5,15,149,7250
"GTTGTAGCATCCTATT",2,6,4,0,3,15,453
"GTTGTAGGTCACTACA",0,7,3,0,0,10,159
"GTTGTAGTCGGATTAC",0,6,0,0,0,6,217
"GTTGTCCCAAGAGAGA",2,5,0,0,0,7,130
"GTTGTCCTCCAAGAGG",3,20,0,0,4,27,362
"GTTGTCCTCCTATGGA",2,20,6,2,5,35,643
"GTTGTGAAGCAGCCTC",6,20,19,2,7,54,1823
"GTTGTGAAGGGTACGT",25,258,102,8,47,440,20111
"GTTGTGACAAGACAAT",5,38,8,5,17,73,2906
"GTTGTGACAATCGAAA",2,15,4,0,3,24,344
"GTTGTGACATATCTGG",120,54,33,9,18,234,6899
"GTTGTGATCACGGACC",0,6,5,0,0,11,268
"GTTGTGATCACGTCCT",0,6,0,0,2,8,54
"GTTGTGATCGTGGCTG",0,6,0,0,0,6,47
"GTTTACTAGAATCTAG",26,81,194,11,33,345,13808
"GTTTACTAGCAAATCA",0,2,0,0,2,4,6
"GTTTACTAGTAGTCAA",2,0,0,0,0,2,69
"GTTTACTGTCTCTCTG",4,22,7,0,8,41,1145
"GTTTACTGTGCCTATA",0,6,0,0,2,8,208
"GTTTACTGTTAGAAGT",0,8,2,0,5,15,134
"GTTTACTGTTTCGTGA",2,6,0,0,0,8,167
"GTTTACTTCAATCGGT",0,5,0,0,0,5,78
"GTTTACTTCACTGAAC",2,9,3,0,0,14,139
"GTTTACTTCATGACAC",3,24,8,2,8,45,527
"GTTTACTTCGCCAGAC",1,11,4,0,2,18,326
"GTTTGGACAGATAAAC",1,14,4,0,3,22,345
"GTTTGGACAGCTGTAT",3,21,7,2,3,36,463
"GTTTGGACAGTAGAGC",0,0,0,0,0,0,23
"GTTTGGACATTACGGT",11,97,22,8,19,157,6853
"GTTTGGAGTAATGCTC",0,3,0,0,0,3,59
"GTTTGGAGTGCAGATG",0,11,2,0,0,13,233
"TAACACGAGCACCTGC",0,0,0,0,0,0,7
"TAACACGAGGGTGAGG",1,3,2,0,0,6,56
"TAACACGGTAGCGCTC",0,7,4,0,2,13,133
"TAACACGGTAGGTCAG",3,17,7,0,4,31,672
"TAACACGGTGAGATAT",0,13,3,0,0,16,328
"TAACACGGTGCGACAA",0,0,0,0,0,0,8
"TAACACGGTGTACGCC",6,22,5,0,5,38,262
"TAACACGTCTAGCCTC",6,30,8,0,31,75,3103
"TAACCAGAGACATAAC",3,21,6,0,4,34,771
"TAACCAGAGCGCCCAT",0,2,0,0,0,2,132
"TAACCAGAGGGACCAT",0,5,3,2,0,10,242
"TAACCAGCATGAAAGT",6,26,3,0,10,45,770
"TAACCAGGTGCGAGTA",1,20,7,0,5,33,455
"TAACCAGGTTAATGAG",15,60,139,10,25,249,10723
"TAACCAGTCAATGTCG",0,7,0,0,3,10,147
"TAACCAGTCGGCCAAC",14,57,117,5,22,215,10845
"TAACGACAGATAGCTA",0,3,0,0,0,3,47
"TAACGACCACCAACAT",0,3,0,0,0,3,151
"TAACTTCCACTGGATT",3,27,16,0,7,53,72
"TAACTTCGTAAGCGGT",0,0,0,0,3,3,18
"TAACTTCGTGCGAGTA",3,21,12,0,0,36,1233
"TAACTTCGTTATCTGG",0,0,0,0,0,0,7
"TAACTTCGTTGTATGC",2,29,8,0,6,45,894
"TAACTTCTCCGTGGCA",0,5,0,0,0,5,300
"TAACTTCTCGGAACTT",18,80,146,5,32,281,15503
"TAACTTCTCTTAGCTT",0,5,0,2,0,7,161
"TAAGCACAGCGAACTG",0,2,4,0,2,8,215
"TAAGCACCACGACGAA",1,3,0,0,0,4,208
"TAAGCACCACTTGGGC",0,5,0,0,0,5,19
"TAAGCACCAGGTGGAT",1,25,6,0,0,32,603
"TAAGCACCAGTCAGCC",1,8,6,0,6,21,727
"TAAGCACGTGCGCTCA",0,2,2,0,0,4,8
"TAAGCACGTGGCAGAT",3,11,0,0,0,14,378
"TAAGCACTCAATCGGT",6,5,0,0,0,11,149
"TAAGCCACAAGAGATT",2,9,5,0,3,19,448
"TAAGCCACACTTGAAC",0,9,2,0,0,11,300
"TAAGCCACAGAGAGGG",1,2,0,0,0,3,90
"TAAGCCACATCTAGAC",3,20,2,0,3,28,734
"TAAGCCATCGACATAC",0,3,0,0,0,3,160
"TAAGCGTAGAGGGTAA",0,0,0,0,0,0,4
"TAAGCGTAGCATGAAT",1,0,2,0,4,7,115
"TAAGCGTAGGCAGGTT",1,5,0,0,0,6,518
"TAAGCGTAGTCACTAC",0,3,0,0,0,3,83
"TAAGCGTCAAGGCTTT",0,0,0,0,0,0,6
"TAAGCGTCAAGTGACG",2,9,6,0,2,19,387
"TAAGCGTCAGACCGCT",28,216,65,20,46,375,13862
"TAAGCGTGTAGCTGCC",0,0,0,0,0,0,9
"TAAGCGTGTGCACGCT",1,8,0,0,0,9,459
"TAAGTCGAGGTCATTC",3,14,6,0,3,26,533
"TAAGTCGCAAAGCACG",1,7,0,0,0,8,146
"TAAGTCGCATTGCAAC",6,44,8,3,11,72,1736
"TAAGTCGGTTGGGCCT",0,5,0,0,0,5,94
"TAAGTCGTCGATGCAT",1,16,3,0,4,24,317
"TAAGTCGTCTCGACGG",1,3,0,0,0,4,84
"TAAGTCGTCTTGGTCC",2,39,54,3,9,107,3735
"TAATCTCAGTAAGAGG",3,16,6,2,6,33,326
"TAATCTCAGTCATACC",4,21,8,2,7,42,1239
"TAATCTCCAACATACC",1,11,3,0,0,15,160
"TAATCTCCATAGTCGT",5,28,5,0,10,48,852
"TAATCTCCATATCTGG",1,6,0,0,3,10,108
"TAATCTCTCGCTTGCT",43,400,87,24,65,619,28708
"TAATTCCAGATCGCTT",0,5,0,0,0,5,9
"TAATTCCAGCGGGTAT",1,2,0,0,2,5,180
"TAATTCCAGGCCTTCG",0,0,0,0,0,0,29
"TAATTCCCAAGGTCGA",3,31,10,0,3,47,932
"TAATTCCCAGAAATCA",1,0,0,0,0,1,36
"TAATTCCCAGTCTTCC",0,0,0,0,0,0,3
"TAATTCCGTAGTCGGA",1,24,2,5,3,35,750
"TAATTCCGTATCATGC",1,12,0,0,0,13,198
"TAATTCCGTTCGTAAC",0,0,2,0,0,2,127
"TAATTCCTCCAAGGGA",0,7,3,2,0,12,107
"TAATTCCTCCGGCAGT",1,2,0,0,2,5,31
"TAATTCCTCGTTGTTT",1,5,0,0,0,6,115
"TACAACGAGCAAGTCG",124,1552,289,84,228,2277,88281
"TACAACGAGGAGCAAA",6,23,30,0,7,66,2989
"TACAACGAGGTCACAG",0,0,0,0,0,0,3
"TACAACGCACAAAGTA",0,0,0,0,0,0,32
"TACAACGGTTAATGAG",0,10,2,0,0,12,263
"TACAACGTCATTACGG",1,5,0,0,2,8,146
"TACAACGTCGTTGTGA",1,18,3,0,4,26,338
"TACAACGTCTATCGCC",6,40,18,6,80,150,6725
"TACAACGTCTGTGCGG",282,103,66,14,47,512,22775
"TACACCCAGACATAGT",0,5,2,0,5,12,73
"TACACCCAGACGCTCC",1,22,4,2,5,34,704
"TACACCCAGACTCGAG",1,4,0,2,0,7,95
"TACACCCAGCATGCAG",0,10,0,0,2,12,254
"TACACCCAGCCTAGGA",4,15,5,2,2,28,503
"TACACCCAGGAATTAC",0,6,0,0,2,8,104
"TACACCCAGGCACCAA",0,0,0,0,0,0,5
"TACACCCCACCGTGCA",0,6,0,0,2,8,186
"TACACCCCACTACCGG",180,1361,397,76,282,2296,113298
"TACACCCCATAATGCC",2,4,2,0,0,8,131
"TACACCCGTGGACTGA",1,3,0,0,0,4,61
"TACACCCTCATGGGAG",0,0,0,0,0,0,18
"TACACCCTCTTGAGCA",4,34,60,5,18,121,4974
"TACAGGTAGCTGAGCA",35,93,145,18,147,438,21418
"TACAGGTAGGACAGCT",0,0,0,0,0,0,6
"TACAGGTAGGCGCTTC",1,7,3,0,2,13,173
"TACAGGTAGGTTCCAT",3,2,4,0,0,9,100
"TACAGGTAGTACAGCG",7,87,17,2,10,123,6898
"TACAGGTAGTACGTCT",51,342,83,36,77,589,26613
"TACAGGTTCACTGTTT",5,24,9,0,2,40,896
"TACAGGTTCGACCAAT",1,4,4,0,0,9,122
"TACATTCAGGTCACTT",47,128,308,22,77,582,31408
"TACATTCAGTAGTCAA",44,135,81,24,341,625,33313
"TACATTCCATCCTGTC",5,29,9,2,5,50,1137
"TACATTCGTGCCTGAC",23,61,31,20,151,286,14534
"TACATTCGTGGACCTC",51,113,40,7,24,235,9409
"TACATTCTCAATGTCG",7,31,19,2,18,77,1515
"TACATTCTCCTTCTTC",3,19,4,0,3,29,737
"TACATTCTCTTACCGC",1,5,0,0,0,6,105
"TACATTCTCTTACTGT",2,33,10,0,9,54,75
"TACATTCTCTTGTGCC",0,0,2,0,0,2,21
"TACCCACAGAGGGTAA",1,0,0,0,0,1,27
"TACCCACGTTGGACTT",10,23,5,0,4,42,1849
"TACCCACTCGCGTGCA",28,215,43,12,43,341,15380
"TACCCGTAGGTGCCTC",44,140,271,29,157,641,31793
"TACCCGTAGTAGTCTC",0,3,0,0,0,3,9
"TACCCGTGTATCTCTT",2,21,2,0,2,27,483
"TACCCGTTCCGTCACT",2,18,8,0,4,32,885
"TACCCGTTCGGAGCAA",0,0,0,0,0,0,11
"TACCCGTTCGGTCGGT",0,3,4,0,0,7,99
"TACCGAAAGATAGCAT",2,19,3,0,3,27,761
"TACCGAAAGCGACTAG",1,5,2,0,0,8,249
"TACCGAACAGGTTCGC",0,7,0,0,0,7,306
"TACCGAAGTCGATTTG",2,9,2,2,0,15,402
"TACCGAAGTTTCTATC",3,19,3,3,4,32,1177
"TACCGAATCGTAGTGT",0,15,6,2,3,26,458
"TACCGAATCTGTTGGA",0,41,3,0,4,48,1261
"TACCGAATCTTCTCAA",4,36,15,3,14,72,2289
"TACCGGGAGACTACGG",1,5,0,0,0,6,25
"TACCGGGAGATGCTAA",5,23,4,0,4,36,1271
"TACCGGGAGCCAAGTG",4,19,8,0,8,39,870
"TACCGGGAGGTTGGTG",0,14,3,0,4,21,561
"TACCGGGAGTATGACA",1,10,7,0,3,21,664
"TACCGGGCAGGTCTCG",0,0,0,2,0,2,12
"TACCGGGCAGTCGCTG",0,3,2,0,0,5,46
"TACCGGGGTAGGCTCC",3,6,13,0,0,22,817
"TACCGGGGTCAGACTT",19,148,34,8,39,248,12324
"TACCGGGTCGTGCGAC",31,79,20,11,19,160,5108
"TACCGGGTCTACACAG",2,16,10,2,8,38,1027
"TACCTCGAGATTGACA",10,25,9,0,11,55,1185
"TACCTCGAGCTGAGTG",3,22,6,0,6,37,738
"TACCTCGCACCTGCTT",4,15,3,0,3,25,839
"TACCTCGGTATCTCTT",4,48,9,3,10,74,3036
"TACCTCGGTGCTGCAC",2,6,0,0,2,10,113
"TACCTCGGTGGTCTTA",2,7,0,0,2,11,149
"TACCTCGGTTCTTCAT",1,9,0,0,6,16,402
"TACCTCGTCCTGGGAC",2,17,7,0,3,29,1138
"TACCTGCAGACAACTA",0,12,2,0,2,16,317
"TACCTGCAGTCCCAAT",158,316,106,27,80,687,27728
"TACCTGCGTTGGACTT",0,2,0,0,2,4,141
"TACCTGCTCTTCGGAA",0,7,4,0,2,13,428
"TACCTGCTCTTTGGAG",1,4,0,2,0,7,195
"TACGCTCAGGTCCCTG",28,198,78,15,37,356,17602
"TACGCTCCAATGGCCC",0,5,2,0,2,9,12
"TACGCTCCACATATGC",4,39,83,7,16,149,7860
"TACGCTCCAGAGTTCT",1,9,4,2,0,16,279
"TACGCTCCATCGGCCA",0,6,2,0,0,8,98
"TACGCTCTCCTACCAC",1,17,0,0,5,23,880
"TACGGGCCAAGCAGGT",0,0,0,0,0,0,20
"TACGGGCGTAAGACCG",7,35,39,0,11,92,3762
"TACGGGCTCATTCGGA",1,32,8,0,7,48,635
"TACGGGCTCGCTGTTC",0,3,0,0,0,3,13
"TACGGGCTCTTCTTCC",0,3,4,0,0,7,351
"TACGGTACATCGGAGA",25,78,228,7,43,381,19597
"TACGGTAGTGAACCGA",27,92,128,13,170,430,20506
"TACGGTAGTGTGTCCG",8,33,30,3,12,86,3528
"TACGGTATCACCACAA",1,12,2,0,0,15,307
"TACGGTATCGGTCGAC",0,0,0,0,0,0,10
"TACGGTATCTAAGGAA",0,2,0,0,0,2,171
"TACGTCCAGACGCCCT",80,221,273,45,516,1135,58371
"TACGTCCAGACTCAAA",72,116,35,10,31,264,9797
"TACGTCCAGTGTTCCA",0,4,0,0,2,6,111
"TACGTCCCAAAGGCAC",0,3,0,0,5,8,230
"TACGTCCGTAATGTGA",2,25,5,0,4,36,910
"TACGTCCTCACTCTTA",0,5,0,0,0,5,200
"TACGTCCTCACTTTGT",0,4,0,0,2,6,107
"TACTGCCAGCCTGAGA",1,19,5,0,4,29,283
"TACTGCCGTGACGTCC",0,0,0,0,0,0,24
"TACTGCCGTTGTATGC",0,5,2,0,3,10,191
"TACTGCCTCACTGATG",1,6,2,0,0,9,100
"TACTGCCTCCCAGCGA",2,9,0,0,0,11,250
"TACTGCCTCTGTAAGC",5,20,23,2,7,57,1687
"TACTTACAGACATCAA",2,13,5,0,4,24,467
"TACTTACCAGTAGGAC",0,7,3,0,0,10,243
"TACTTACGTCGCAGTC",0,8,3,0,0,11,234
"TACTTACTCCTCTTTC",6,44,19,3,9,81,104
"TACTTACTCCTGTTAT",13,24,8,0,3,48,1153
"TACTTACTCTGGACTA",0,5,2,0,0,7,236
"TACTTCAAGGAGGCAG",2,4,0,0,2,8,157
"TACTTCAAGGGTAGCT",0,0,0,0,0,0,6
"TACTTCAAGTAAGACT",2,9,0,0,0,11,93
"TACTTCACACGGCACT",0,3,0,0,0,3,14
"TACTTCACATGGATCT",1,0,0,0,0,1,132
"TACTTCAGTCCCTCAT",0,0,0,0,0,0,4
"TACTTCAGTCGACTGC",2,4,0,0,0,6,185
"TACTTCAGTTATTCCT",0,0,0,0,0,0,17
"TACTTCATCATTCATC",0,7,2,0,0,9,205
"TACTTCATCCATTTCA",7,54,16,5,16,98,3907
"TACTTCATCGATGCAT",5,27,6,0,7,45,1121
"TACTTCATCGCTTACC",14,110,26,7,27,184,8472
"TACTTCATCGTTCTGC",3,27,31,5,7,73,3107
"TACTTCATCTGCCTGT",2,28,7,3,9,49,1176
"TACTTGTAGCTACTAC",0,4,3,0,0,7,495
"TACTTGTCACTGCATA",34,106,188,11,81,420,22461
"TACTTGTGTACAAGCG",0,4,0,0,0,4,146
"TACTTGTGTCTAGGCC",12,43,68,6,18,147,7226
"TACTTGTTCACCCTCA",4,3,0,0,0,7,227
"TACTTGTTCATCAGTG",0,0,0,0,0,0,8
"TAGACCAAGAACTCCT",1,11,5,0,5,22,549
"TAGACCAAGAGCATTA",8,11,0,0,3,22,374
"TAGACCAGTAAGGCTG",23,65,132,8,26,254,11382
"TAGACCAGTTAGTTCG",2,4,0,0,0,6,112
"TAGACCATCCGGACTG",1,16,6,0,3,26,519
"TAGACCATCTCTGAGA",1,6,0,0,3,10,146
"TAGACTGCAGAACTCT",0,0,0,0,0,0,36
"TAGACTGCAGAGGTAC",2,4,2,0,0,8,176
"TAGACTGCAGTCGCAC",0,6,0,0,3,9,117
"TAGACTGGTATCGTAC",0,3,0,0,0,3,64
"TAGACTGGTGACATCT",43,105,283,17,49,497,24930
"TAGACTGGTGTAGCAG",3,12,9,0,5,29,674
"TAGACTGTCGTTACCC",0,0,2,0,0,2,48
"TAGACTGTCTGTACAG",2,10,2,0,3,17,121
"TAGAGTCAGACCAGCA",10,91,18,6,13,138,7485
"TAGAGTCCAAGATTGA",0,9,5,0,2,16,164
"TAGAGTCGTACGATGG",1,2,2,0,0,5,58
"TAGAGTCGTCGTGGAA",0,0,0,0,0,0,18
"TAGATCGAGCATTTCG",17,24,7,0,6,54,2245
"TAGATCGAGGTCGCCT",0,7,2,0,0,9,273
"TAGATCGCAACCGCTG",0,0,0,0,0,0,78
"TAGATCGCACATTACG",2,10,5,0,3,20,246
"TAGATCGCACTCAGAT",0,2,0,0,0,2,29
"TAGATCGCAGCTCCTT",13,46,15,15,11,100,3732
"TAGATCGTCCAAGAGG",0,0,0,0,0,0,10
"TAGATCGTCCCGAATA",2,20,3,0,3,28,363
"TAGATCGTCGAAGAAT",0,2,0,0,0,2,42
"TAGCACAAGATTGCGG",2,27,4,0,2,35,433
"TAGCACAAGTTAGAAC",0,0,0,0,0,0,83
"TAGCACAGTCCGGTCA",41,304,76,20,61,502,20425
"TAGCACAGTTAGAGAT",0,3,3,0,0,6,75
"TAGCACATCACCTGGG",1,20,3,0,6,30,590
"TAGGAGGAGACTACGG",1,27,4,0,13,45,315
"TAGGAGGAGGTTACAA",0,2,0,0,0,2,19
"TAGGAGGCAACAGATA",0,12,3,0,5,20,364
"TAGGAGGCATCGAGCC",1,5,0,0,0,6,161
"TAGGAGGGTAGGTTTC",0,5,0,0,0,5,62
"TAGGAGGGTGCGGATA",0,2,0,0,0,2,6
"TAGGAGGTCCTGGCTT",8,32,12,5,6,63,828
"TAGGGTTAGCCAGAGT",5,9,6,0,0,20,226
"TAGGGTTAGCCTAGGA",78,617,147,43,119,1004,52397
"TAGGGTTCAGAATGTA",24,78,52,14,107,275,12506
"TAGGGTTCATAGCTGT",4,45,11,0,9,69,1107
"TAGGGTTCATATACCG",3,31,11,3,5,53,1174
"TAGGGTTGTAGTCCTA",0,5,2,0,0,7,103
"TAGGGTTGTATCTCTT",1,2,0,2,2,7,321
"TAGGGTTTCATTACTC",9,67,34,7,15,132,6898
"TAGGGTTTCCATTGTT",0,5,0,0,0,5,126
"TAGGGTTTCTGCGGGT",7,37,4,2,6,56,2597
"TAGGTACAGACTCTAC",5,32,7,0,7,51,1083
"TAGGTACAGCCTGACC",6,27,11,0,19,63,1744
"TAGGTACCACCTGCAG",0,5,2,0,0,7,204
"TAGGTACGTAGTCGGA",39,335,72,19,52,517,26021
"TAGGTACGTTCCGGTG",5,14,10,0,11,40,1890
"TAGGTACGTTCTCTCG",2,21,2,0,4,29,777
"TAGGTACTCCTTCGAC",2,17,0,0,3,22,403
"TAGGTTGAGAGGTCAC",100,200,572,51,129,1052,50551
"TAGGTTGAGCGATGGT",6,60,16,3,6,91,3625
"TAGGTTGAGTTCATGC",0,24,3,2,4,33,425
"TAGGTTGCACGCTGTG",0,0,0,0,2,2,15
"TAGGTTGCATGTGGTT",12,36,15,5,6,74,2779
"TAGGTTGGTACAGAAT",1,7,3,0,0,11,143
"TAGGTTGGTACCTAAC",0,0,0,0,0,0,23
"TAGGTTGTCGCTTGAA",1,0,0,0,0,1,49
"TAGTGCAAGTAGGAAG",0,10,0,0,2,12,225
"TAGTGCACAAGGGCAT",1,8,0,0,0,9,123
"TAGTGCAGTTAAGAAC",2,4,2,0,3,11,99
"TAGTGCATCAACTTTC",0,4,2,0,2,8,50
"TATACCTAGAGAGGTA",1,5,0,0,0,6,44
"TATACCTCACCAAAGG",2,11,4,2,5,24,188
"TATACCTCATCTTAGG",2,2,0,0,0,4,60
"TATACCTGTCTGTTAG",16,103,29,8,14,170,5299
"TATACCTGTGATAGTA",2,6,2,0,2,12,153
"TATACCTTCGACCTAA",2,25,8,2,3,40,220
"TATACCTTCTCGCCTA",5,47,12,6,5,75,2788
"TATATCCAGACATACA",1,25,5,2,4,37,524
"TATATCCAGCGGGTTA",117,279,202,27,145,770,35023
"TATATCCAGTTACGTC",0,4,3,0,0,7,130
"TATATCCCAGAGGACT",148,850,261,65,175,1499,78280
"TATATCCCAGTTACCA",6,37,20,2,6,71,1769
"TATATCCGTACCATAC",0,16,0,0,4,20,156
"TATATCCGTTAGAAAC",3,2,0,0,0,5,421
"TATATCCTCTACTCAT",0,10,0,0,3,13,339
"TATCAGGAGCATGATA",0,7,6,0,10,23,693
"TATCAGGGTCAGACTT",5,4,3,0,0,12,347
"TATCAGGTCACGTAGT",3,30,4,0,7,44,704
"TATCAGGTCTGCTAGA",1,36,11,2,8,58,949
"TATCAGGTCTGTAACG",0,22,6,0,6,34,532
"TATCCTAAGAGTCCGA",0,0,0,0,0,0,11
"TATCCTACAGGATGAC",0,4,0,0,0,4,118
"TATCCTAGTAACACGG",1,7,0,0,0,8,194
"TATCCTAGTTAGGGAC",114,150,75,12,34,385,16460
"TATCCTAGTTGACTGT",1,0,2,0,4,7,179
"TATCCTATCAAGTGGG",3,3,0,0,0,6,363
"TATCCTATCGACTCCT",1,12,0,0,2,15,531
"TATCGCCAGCTTTCCC",65,198,533,33,125,954,51103
"TATCGCCAGGCCACCT",1,3,0,0,0,4,139
"TATCGCCAGGTGCCAA",53,135,374,27,92,681,37401
"TATCGCCAGTGGAAAG",2,4,3,0,0,9,228
"TATCGCCAGTTGCCTA",8,32,15,7,41,103,3871
"TATCGCCCAAGCCCAC",2,14,3,0,2,21,588
"TATCGCCCACCCAACG",1,3,4,0,0,8,148
"TATCGCCCAGCAGAAC",0,2,0,0,0,2,36
"TATCGCCCAGTTCACA",152,1321,265,64,210,2012,101339
"TATCGCCGTACGGCAA",0,2,0,0,0,2,90
"TATCGCCGTCTGGTTA",0,0,2,0,2,4,92
"TATCGCCGTGGTACAG",0,7,0,0,0,7,75
"TATCGCCGTGTATTGC",0,8,0,0,0,8,95
"TATCGCCGTTTGGCTA",18,226,32,9,29,314,7371
"TATCGCCTCATGGCCG",0,0,0,0,2,2,21
"TATCGCCTCGGCCCAA",2,27,5,0,3,37,579
"TATCTGTCAAGTCCAT",0,0,0,0,3,3,121
"TATCTGTGTGATAGAT",0,9,0,0,0,9,211
"TATCTGTGTTAGTCGT",1,5,0,0,4,10,118
"TATCTGTTCACTTATC",0,0,0,0,0,0,136
"TATCTGTTCCGGTAAT",4,27,5,0,8,44,905
"TATCTGTTCTCGTTTA",1,0,0,0,0,1,5
"TATCTGTTCTTACTGT",0,8,2,0,3,13,199
"TATCTTGCAACACAAA",0,3,0,0,0,3,12
"TATCTTGCAAGAGCTG",13,52,14,4,11,94,1675
"TATCTTGCAGGACTTT",0,0,0,0,0,0,2
"TATCTTGGTAGCACAG",6,43,24,5,67,145,6309
"TATCTTGGTCAATGGG",84,298,226,44,577,1229,57723
"TATCTTGGTTTGGGAG",2,9,2,0,2,15,659
"TATCTTGTCATGTCAG",16,68,56,6,21,167,6552
"TATCTTGTCGCGTGAC",3,17,2,2,7,31,663
"TATCTTGTCTTCTGTA",0,0,0,0,0,0,10
"TATGTTCAGATAGTCA",1,7,3,0,0,11,109
"TATGTTCAGGTTGAGC",1,2,0,0,0,3,165
"TATGTTCCAACCGCCA",0,14,4,0,3,21,606
"TATGTTCCACGATAGG",29,87,80,10,123,329,12110
"TATGTTCCATGACGGA",7,44,12,0,6,69,880
"TATGTTCCATTCGATG",1,8,3,0,0,12,241
"TATGTTCGTACCACGC",37,145,155,23,294,654,36068
"TATGTTCGTCTGTTAG",1,2,0,0,0,3,75
"TATGTTCTCGGATTAC",1,2,0,0,0,3,162
"TATGTTCTCTGGACTA",18,17,5,0,6,46,1343
"TATTCCAAGGGCAACT",0,3,0,0,0,3,13
"TATTCCAGTTAGAAAC",8,80,21,6,24,139,5853
"TATTGCTAGTGGACTG",1,18,11,2,4,36,1028
"TATTGCTCACTCTCGT",3,21,2,0,3,29,99
"TATTGCTCAGCAGGAT",79,657,150,40,120,1046,50465
"TATTGCTCAGGTGGAT",6,72,15,3,17,113,4492
"TATTGCTCAGTCGTTA",0,7,4,0,0,11,112
"TATTGCTCAGTGCCTG",11,43,36,9,86,185,10380
"TATTGCTGTCGCGGTT",16,86,23,7,18,150,6137
"TATTGCTGTGCTCTCT",16,59,33,13,102,223,11768
"TATTGCTGTTCAAGTC",24,29,20,2,10,85,2302
"TATTGCTTCCGTCCTA",0,0,0,0,0,0,101
"TATTGCTTCGCTCTAC",3,32,18,3,41,97,3895
"TATTGCTTCTGAGCAT",1,26,7,0,4,38,365
"TATTGGGAGAGAACCC",5,33,25,2,8,73,2039
"TATTGGGAGCGGGTAT",19,72,23,9,109,232,12115
"TATTGGGCACCAATTG",0,3,2,0,0,5,83
"TATTGGGGTATCTCTT",3,20,5,0,5,33,81
"TATTGGGGTGGACAGT",0,2,0,0,0,2,13
"TATTTCGAGAGCCTGA",3,15,3,0,4,25,304
"TATTTCGAGGCATGCA",4,29,6,2,3,44,1004
"TATTTCGAGGGACCAT",3,30,9,0,6,48,1312
"TATTTCGAGGGTCTTT",3,46,12,2,9,72,2272
"TATTTCGCATGCAGCC",5,42,19,3,8,77,3029
"TATTTCGGTCCACTCT",2,5,3,0,0,10,106
"TATTTCGTCGGTAGAG",2,17,4,0,4,27,324
"TATTTCGTCTAGACCA",79,158,50,12,47,346,16935
"TATTTCGTCTATACTC",1,2,6,0,0,9,344
"TATTTCGTCTCTATAC",1,14,7,0,3,25,104
"TATTTCGTCTTGGAAC",1,4,0,0,2,7,200
"TCAAGACAGCCTTCTC",2,6,2,0,0,10,180
"TCAAGACAGCTCCACG",11,60,11,4,14,100,3412
"TCAAGACCAAGAAATC",0,2,0,0,0,2,83
"TCAAGACCAGCGGTCT",0,3,0,2,0,5,125
"TCAAGACCATCATTGG",1,2,0,0,0,3,11
"TCAAGACCATTCCTAT",2,24,11,0,3,40,845
"TCAAGACCATTCCTCG",19,118,30,8,26,201,9882
"TCAAGACGTGAACTAA",8,40,16,3,15,82,3050
"TCAAGACTCATAGACC",0,9,2,0,3,14,395
"TCAAGACTCCCAAGTA",5,15,9,5,3,37,441
"TCAAGACTCTTCGGAA",0,3,0,0,0,3,55
"TCAAGCAAGCCAAGCA",7,27,48,3,9,94,4338
"TCAAGCAAGCGATGGT",0,0,0,0,2,2,14
"TCAAGCAAGCTCTTCC",1,16,2,0,0,19,178
"TCAAGCAAGGGATCTG",1,4,3,0,0,8,89
"TCAAGCAAGTATAGAC",1,24,5,3,4,37,909
"TCAAGCACACTTCAGA",0,3,0,0,0,3,23
"TCAAGCAGTCAAGCCC",4,20,6,0,4,34,904
"TCAAGCAGTGGACTAG",1,8,3,0,7,19,308
"TCAAGCAGTTGGGCCT",0,2,0,0,0,2,37
"TCAAGCAGTTGTATGC",0,4,0,0,0,4,165
"TCAAGCATCTTACCGC",0,0,0,0,0,0,15
"TCAAGTGAGACGCCCT",7,44,12,0,10,73,2147
"TCAAGTGAGGCGAACT",3,16,6,0,5,30,559
"TCAAGTGCAGACTCTA",1,3,0,0,0,4,31
"TCAAGTGGTCGGAAAC",0,7,3,0,0,10,129
"TCAAGTGGTCGTACAT",0,16,7,2,0,25,442
"TCAAGTGGTGGCATCC",0,0,0,0,0,0,5
"TCAAGTGGTTCTCCTG",1,3,0,0,0,4,179
"TCAAGTGTCAATCTCT",0,5,2,0,0,7,106
"TCAAGTGTCAGCGCGT",2,18,22,4,6,52,1431
"TCAATCTAGACTGTTC",9,55,10,3,20,97,143
"TCAATCTAGGTATAGT",0,0,0,0,0,0,45
"TCAATCTCATCGTTCC",10,44,47,4,14,119,4178
"TCAATCTGTCGAACAG",99,90,31,7,26,253,8958
"TCAATCTGTTGCCATA",165,906,205,63,178,1517,67697
"TCAATCTTCCATTCGC",24,173,49,11,39,296,13001
"TCAATCTTCGACCCAG",31,176,77,16,45,345,15037
"TCAATTCAGGAAACGA",14,58,78,4,92,246,13829
"TCAATTCCAACAGCTT",0,5,0,0,0,5,137
"TCAATTCCAGAGCCCT",1,13,3,0,3,20,767
"TCAATTCGTCCGAAAG",1,5,4,3,2,15,816
"TCAATTCGTCTCTCAC",14,43,19,7,77,160,6266
"TCAATTCTCTCGGGAC",1,11,3,0,2,17,26
"TCAATTCTCTTCCTAA",0,6,0,0,2,8,74
"TCACAAGCACAATGTC",0,16,3,0,5,24,298
"TCACAAGCAGTAGAAT",0,0,0,0,0,0,22
"TCACAAGGTCTAGGCC",6,33,55,2,12,108,5062
"TCACAAGGTTCGGTCG",0,0,0,0,0,0,114
"TCACAAGTCCTTACCG",1,5,0,0,2,8,327
"TCACAAGTCTACACTT",71,696,131,38,139,1075,46623
"TCACACCAGTCATTGC",0,5,0,0,2,7,334
"TCACACCAGTCCCGGT",4,18,14,0,12,48,375
"TCACACCCAAATCGGG",23,82,223,16,40,384,18719
"TCACACCCACCAGGTC",250,2319,439,165,360,3533,164341
"TCACACCGTTTAAGGA",8,26,7,0,3,44,871
"TCACACCTCATTTGTC",55,194,103,25,326,703,31714
"TCACACCTCTATACGG",78,275,67,42,59,521,17476
"TCACATTAGACCATTC",4,25,9,0,6,44,1449
"TCACATTCAAGGCCTC",0,5,0,0,0,5,157
"TCACATTCATACTTTC",0,6,0,0,0,6,123
"TCACATTCATGTGCCG",0,8,0,0,2,10,446
"TCACATTGTTAGGGTG",2,20,7,0,3,32,117
"TCACATTTCCGTACGG",4,2,2,0,2,10,428
"TCACATTTCTTAATCC",2,27,7,0,7,43,788
"TCACGCTAGGAGTATT",1,7,2,0,0,10,217
"TCACGCTCAACAGCCC",0,0,0,0,0,0,6
"TCACGCTCATACCGTA",0,2,0,0,0,2,126
"TCACGCTGTAGAGCTG",2,4,2,0,0,8,72
"TCACGCTGTTGCCATA",1,9,2,0,0,12,244
"TCACGCTTCAAATGCC",0,2,2,0,2,6,153
"TCACGCTTCTACAGGT",0,0,0,0,0,0,29
"TCACGGGAGCCATCCG",8,40,30,7,68,153,6210
"TCACGGGCATCGAACT",7,30,15,6,41,99,3051
"TCACGGGGTCGTTGCG",13,46,124,11,32,226,10539
"TCACGGGGTGTAGGAC",77,317,182,43,458,1077,53235
"TCACGGGTCGATCCAA",1,9,0,0,0,10,129
"TCACTATAGCTCGGCT",0,2,0,0,0,2,16
"TCACTATAGCTGACAG",4,30,36,2,10,82,2728
"TCACTATAGGCATCAG",1,21,9,0,6,37,807
"TCACTATCACGACGTC",1,0,0,0,0,1,49
"TCACTATGTAAGGCCA",145,392,357,62,903,1859,87132
"TCACTATGTCGACTTA",3,15,7,0,4,29,538
"TCACTATGTTACACAC",0,4,0,0,0,4,224
"TCACTATGTTATGACC",3,9,4,0,2,18,525
"TCACTCGAGAATCCCT",2,3,0,0,0,5,83
"TCACTCGAGATAGCAT",3,60,9,3,12,87,3197
"TCACTCGAGCTGTCCG",0,3,0,0,0,3,70
"TCACTCGAGTCTTCCC",3,13,5,0,7,28,634
"TCACTCGCAGGACGAT",0,5,0,0,0,5,128
"TCACTCGGTCTGATAC",36,265,53,11,48,413,18344
"TCACTCGTCATTCGGA",0,5,0,0,0,5,44
"TCAGCAAAGAGCCATG",4,26,5,0,3,38,531
"TCAGCAAAGCGGATCA",10,40,73,5,38,166,5672
"TCAGCAACATCGGTTA",0,3,0,0,2,5,48
"TCAGCAAGTGAGACCA",1,4,2,0,3,10,111
"TCAGCAAGTGGGTTGA",2,10,2,0,0,14,128
"TCAGCAAGTGTCCGGT",1,12,6,0,7,26,466
"TCAGCAATCACTGCTC",8,28,38,0,7,81,3073
"TCAGCAATCAGCGCGT",9,45,39,3,15,111,2511
"TCAGCAATCTTGGTGA",0,3,0,0,0,3,92
"TCAGCCTCATCACAGT",0,0,0,0,3,3,347
"TCAGCCTGTCATCACA",2,6,2,0,0,10,151
"TCAGCCTTCACAGTGT",4,21,2,0,3,30,881
"TCAGCCTTCAGTGTCA",0,3,0,0,0,3,6
"TCAGCCTTCGAGATGG",0,2,0,0,0,2,112
"TCAGGGCAGCCTCAGC",2,9,0,0,0,11,114
"TCAGGGCAGTACCATC",0,4,0,0,2,6,206
"TCAGGGCCAAGTTTGC",0,3,0,0,3,6,227
"TCAGGGCCACCTAAAC",2,11,0,3,4,20,74
"TCAGGGCCAGTTAGGG",1,19,9,0,4,33,728
"TCAGGGCGTCCTGGTG",0,3,3,0,2,8,25
"TCAGGGCGTGGGTATG",0,4,0,0,0,4,122
"TCAGGGCGTGGGTCAA",0,7,0,0,2,9,187
"TCAGGGCTCACACGAT",73,199,77,232,70,651,23000
"TCAGGGCTCGAATCCA",2,7,5,0,2,16,226
"TCAGGGCTCGCAGATT",1,11,2,2,3,19,39
"TCAGGTAAGACTGTTC",1,6,2,0,2,11,203
"TCAGGTACAACCCGCA",2,9,4,0,0,15,82
"TCAGGTACAACCCTAA",176,732,164,48,118,1238,53774
"TCAGGTACAAGTGGGT",1,7,0,0,0,8,149
"TCAGGTACACCTATCC",1,12,3,0,5,21,548
"TCAGGTAGTAGGCAAC",87,47,21,6,24,185,6813
"TCAGGTAGTCCTGTTC",32,92,221,12,46,403,18689
"TCAGGTAGTTCTCCTG",0,3,2,0,0,5,65
"TCAGGTATCGAGTACT",0,3,0,0,2,5,82
"TCAGTCCAGATGAATC",3,17,2,0,3,25,571
"TCAGTCCGTCATATGC",22,134,31,8,23,218,8502
"TCAGTCCGTCGCGTCA",0,5,0,0,0,5,191
"TCAGTCCGTCGGCTAC",1,3,0,0,0,4,18
"TCAGTCCGTCTCAGAT",0,20,7,0,5,32,797
"TCAGTCCGTTCGGTAT",64,460,88,31,81,724,33793
"TCAGTCCTCGCAAGAG",0,3,0,0,2,5,44
"TCAGTCCTCGGTGCAC",2,26,8,0,0,36,555
"TCAGTCCTCGTACACA",0,0,0,0,0,0,92
"TCAGTGAAGAGAGCGG",13,91,21,6,20,151,5259
"TCAGTGAAGCCATTCA",1,20,4,0,6,31,609
"TCAGTGACAAACGTGG",0,8,4,0,0,12,106
"TCAGTGAGTACCCGCA",0,4,3,0,0,7,102
"TCAGTGAGTGTACGCC",2,10,0,0,0,12,119
"TCAGTGAGTTAGCGGA",0,7,2,0,0,9,580
"TCAGTGATCGCTAATG",1,7,5,0,4,17,766
"TCAGTTTAGAAACTAC",0,4,4,0,3,11,60
"TCAGTTTAGATACTGA",37,100,203,20,99,459,21430
"TCAGTTTCAAGATGGC",0,3,2,0,0,5,64
"TCAGTTTGTAGTCGTT",0,6,3,0,0,9,145
"TCAGTTTGTATTCCTT",5,29,6,3,4,47,700
"TCAGTTTGTCCTCCAT",3,3,2,0,0,8,197
"TCAGTTTTCACCTGGG",204,335,89,25,76,729,31157
"TCAGTTTTCTGAGATC",551,236,133,45,123,1088,44327
"TCATACTAGCACTCAT",0,4,2,0,0,6,80
"TCATACTAGCGTCTCG",1,2,0,0,4,7,126
"TCATACTAGGTGCAGT",0,0,0,0,0,0,11
"TCATACTAGTGGAAGA",0,3,0,0,2,5,172
"TCATACTCAGGCCTGT",88,228,151,37,641,1145,65469
"TCATACTCATCCTAAG",0,4,0,0,0,4,157
"TCATACTCATTCAGGT",3,45,6,0,6,60,1250
"TCATACTGTGCGTCGT",3,15,8,2,29,57,836
"TCATACTGTGTCACAT",5,33,10,0,23,71,1794
"TCATATCAGAAGAACG",0,10,2,0,0,12,105
"TCATATCAGATGATTG",0,0,0,0,0,0,14
"TCATATCAGATGTAGT",0,4,0,0,2,6,85
"TCATATCAGTCTGCAT",0,8,0,0,3,11,241
"TCATATCCAAGTAGTA",0,0,0,0,0,0,31
"TCATATCCACGTATAC",16,53,90,8,19,186,10266
"TCATATCCATGAAGCG",0,3,0,0,0,3,23
"TCATATCGTAGCTCGC",0,3,4,0,0,7,67
"TCATATCGTCGTGATT",4,39,50,0,30,123,3045
"TCATATCGTGGGTTGA",7,38,7,2,10,64,1816
"TCATATCTCACTACTT",1,12,2,0,2,17,262
"TCATATCTCCTTGACC",115,53,30,14,22,234,9324
"TCATCATGTAAGATAC",0,3,0,0,0,3,110
"TCATCATGTGCGTCGT",0,6,0,0,0,6,25
"TCATCCGAGTACTGGG",1,4,0,0,0,5,29
"TCATCCGCAAATGAAC",2,3,0,0,2,7,165
"TCATCCGCACCAGCCA",1,17,0,2,6,26,787
"TCATCCGCACTAGGCC",26,146,162,17,51,402,19633
"TCATCCGCAGACCAAG",0,7,0,0,0,7,137
"TCATCCGCAGAGATTA",0,2,0,0,2,4,62
"TCATCCGGTACGTTCA",1,18,5,0,2,26,565
"TCATCCGGTATGCGTT",1,6,2,0,0,9,171
"TCATCCGTCATGACAC",0,0,0,0,0,0,199
"TCATCCGTCATTACTC",1,19,4,0,5,29,487
"TCATCCGTCGATCCCT",2,24,3,0,2,31,51
"TCATCCGTCTACGCGG",2,3,0,0,0,5,191
"TCATGAGAGAAATTGC",13,62,104,14,21,214,9733
"TCATGAGAGGGTTAAT",16,90,26,9,12,153,5980
"TCATGAGAGTCGCCAC",0,5,3,0,2,10,141
"TCATGAGCAAGCACCC",1,6,0,0,0,7,114
"TCATGAGGTGGTCTGC",0,0,0,0,0,0,130
"TCATGAGTCCAATCTT",0,8,2,0,0,10,96
"TCATGAGTCCTCTCGA",7,38,25,6,78,154,7634
"TCATGCCAGCCTCACG",0,0,0,0,0,0,250
"TCATGCCAGTTGCTCA",0,3,0,0,3,6,95
"TCATGCCCAACGTATC",0,2,0,0,0,2,89
"TCATGCCCAAGAAATC",0,5,0,0,2,7,155
"TCATGCCCACTACCCT",1,28,4,2,3,38,908
"TCATGCCGTAACGATA",0,0,0,0,0,0,24
"TCATGCCGTCGCAACC",0,2,0,0,0,2,7
"TCATGCCGTGACTGAG",0,11,4,0,5,20,475
"TCATGCCTCAAGTGTC",1,26,12,0,9,48,686
"TCATGGACAACAGCTT",0,21,5,0,0,26,414
"TCATGGACAAGTACCT",1,0,2,0,0,3,122
"TCATGGACAATAGTAG",1,18,3,0,4,26,427
"TCATGGACACTCCACT",8,5,3,0,0,16,535
"TCATGGACAGACAATA",18,70,144,15,68,315,14973
"TCATGGACATTGAGCT",0,0,0,0,0,0,19
"TCATGGAGTCAACATC",3,19,0,0,2,24,553
"TCATGTTAGATAGTGT",0,5,2,0,2,9,68
"TCATGTTAGGGAGAAT",2,39,11,0,9,61,709
"TCATGTTCAACCAACT",86,261,326,51,538,1262,57604
"TCATGTTCACAGTGAG",0,2,2,0,0,4,233
"TCATGTTGTATCAAGA",1,3,0,0,0,4,152
"TCATGTTGTATGAGCG",0,5,2,0,0,7,98
"TCATGTTTCCATCGTC",1,9,0,0,4,14,402
"TCATGTTTCCATTCGC",1,4,2,0,0,7,376
"TCATGTTTCGTGGCTG",0,9,2,0,2,13,22
"TCATTACAGCTCTATG",1,3,0,0,2,6,131
"TCATTACAGTCTCTGA",1,27,7,0,5,40,728
"TCATTACCACATTCGA",0,5,0,0,0,5,381
"TCATTACGTCAAGCCC",1,3,0,0,2,6,64
"TCATTACGTGCGTTTA",0,3,0,0,0,3,113
"TCATTACGTGTCACAT",1,8,0,0,2,11,126
"TCATTACTCAAGCTGT",0,4,0,0,0,4,87
"TCATTACTCTATGCCC",60,392,99,16,73,640,27033
"TCATTCAAGAAGTCAT",3,22,8,0,4,37,553
"TCATTCAAGAATTTGG",9,26,20,2,42,99,4086
"TCATTCAAGCCGGAAT",1,27,8,0,5,41,688
"TCATTCAAGCGACCCT",0,6,0,0,3,9,234
"TCATTCACAAATGGAT",89,63,18,2,25,197,8136
"TCATTCAGTACAACGG",21,218,43,16,30,328,13938
"TCATTCATCGAGAATA",1,11,2,0,2,16,119
"TCATTCATCTCGGTAA",1,8,2,0,3,14,637
"TCATTGTAGCAAATCA",0,0,3,0,0,3,55
"TCATTGTAGGTCCTGC",37,302,67,18,56,480,24163
"TCATTGTAGTCACAGG",5,24,8,0,5,42,807
"TCATTGTAGTGTTGTC",80,616,126,48,109,979,45860
"TCATTGTCACCTAAAC",3,8,3,0,3,17,375
"TCATTGTCAGAAGTGC",2,11,0,0,0,13,230
"TCATTGTTCAGCCTCT",1,5,2,0,0,8,486
"TCATTTGAGGTGAGAA",0,5,0,0,0,5,54
"TCATTTGAGTATAACG",4,24,2,2,6,38,629
"TCATTTGAGTGATGGC",0,21,6,0,3,30,1415
"TCATTTGGTGACCGTC",0,2,0,2,0,4,68
"TCATTTGGTGATGGCA",0,4,2,0,0,6,82
"TCCACCAAGCTCCACG",4,24,8,0,3,39,1038
"TCCACCACAAGAGATT",1,0,0,0,0,1,13
"TCCACCACACCGTACG",2,17,6,0,5,30,92
"TCCACCACAGCAGATG",3,4,3,0,2,12,162
"TCCACCACAGGACTAG",15,120,25,8,24,192,7196
"TCCACCAGTAACAGTA",12,54,87,7,56,216,11324
"TCCACCATCCAGTGTA",1,13,0,0,0,14,513
"TCCACCATCCTACCAC",1,6,0,0,0,7,182
"TCCACCATCGGATAAA",0,3,2,0,0,5,76
"TCCACCATCGGTCTGG",1,14,2,0,4,21,500
"TCCACCATCGTGGACC",1,18,5,2,2,28,1459
"TCCACCATCTAACGCA",0,4,5,0,0,9,161
"TCCACGTAGGACAAGA",0,24,13,2,4,43,549
"TCCACGTAGGTCGTAG",2,8,0,0,2,12,317
"TCCACGTCAGCATACT",0,15,3,2,5,25,889
"TCCACGTCATAGGTTC",60,138,89,33,380,700,33145
"TCCACGTGTATTGACC",0,7,0,0,3,10,74
"TCCACGTTCAGCTGAT",3,20,7,2,7,39,991
"TCCACGTTCTGGACCG",37,120,60,20,314,551,24594
"TCCACGTTCTTGCAGA",0,0,2,0,0,2,10
"TCCAGAAAGGGCCCTT",3,17,0,0,4,24,404
"TCCAGAACACGCGTCA",1,16,5,0,6,28,345
"TCCAGAACATCGAACT",0,11,3,0,2,16,256
"TCCAGAAGTTGAGGAC",1,4,0,0,0,5,188
"TCCAGAATCATTGGTG",1,10,2,0,2,15,256
"TCCAGAATCCAATCCC",0,10,2,0,4,16,66
"TCCAGAATCGTTCATT",18,140,29,7,18,212,8525
"TCCATCGAGCTCGACC",0,2,0,0,5,7,417
"TCCATCGCAAATGGAT",0,5,0,0,0,5,60
"TCCATCGCAGAGGCAT",0,5,3,0,3,11,187
"TCCATCGTCCTAGAGT",0,0,0,0,0,0,9
"TCCATCGTCGTCTAAG",9,110,16,4,12,151,6831
"TCCATGCAGCCAAGGT",1,15,2,0,0,18,731
"TCCATGCCAAGAATAC",1,12,2,0,3,18,255
"TCCATGCCAGGCGTTC",49,97,24,15,21,206,6885
"TCCATGCCATGAGGGT",0,4,0,0,0,4,96
"TCCATGCGTAGAGACC",6,22,6,0,8,42,850
"TCCATGCGTCAGACTT",4,37,51,4,9,105,4227
"TCCATGCTCCATCAGA",3,7,4,0,0,14,134
"TCCATGCTCGCAATTG",3,28,8,4,7,50,567
"TCCATGCTCTTGGTCC",0,6,0,0,0,6,236
"TCCCACAAGTGCACCC",15,106,31,8,23,183,8490
"TCCCACACAGCTGAAG",0,0,0,0,0,0,24
"TCCCACATCCGTCAAA",2,28,6,2,9,47,1412
"TCCCACATCTGGTGCG",0,3,0,0,2,5,98
"TCCCAGTAGCATCAAA",1,4,0,0,0,5,100
"TCCCAGTAGCTAAACA",2,3,0,0,0,5,246
"TCCCAGTGTCGGTGTC",3,19,5,0,5,32,540
"TCCCAGTGTTACGGAG",0,4,0,0,0,4,144
"TCCCAGTTCAGGAACG",2,15,4,0,3,24,122
"TCCCAGTTCCACTTCG",0,0,0,0,0,0,101
"TCCCAGTTCCAGGACC",0,5,0,0,0,5,18
"TCCCAGTTCCATTGTT",0,3,0,0,0,3,126
"TCCCATGAGCCAAGTG",549,208,123,40,109,1029,38315
"TCCCATGCAGTGTGGA",0,4,0,0,0,4,67
"TCCCATGGTTGCTCCT",8,34,54,7,10,113,2799
"TCCCATGTCATGTCTT",0,7,5,0,2,14,230
"TCCCATGTCATTCGGA",1,23,6,0,4,34,1170
"TCCCATGTCCATAGGT",2,27,11,0,6,46,1113
"TCCCATGTCTCTAGGA",1,12,10,2,5,30,422
"TCCCATGTCTGCTCTG",2,16,8,0,4,30,774
"TCCGAAAAGCAGTCTT",1,0,2,0,0,3,44
"TCCGAAAAGCGCCTAC",14,70,120,12,28,244,11401
"TCCGAAACAATCCTAG",1,4,0,0,0,5,234
"TCCGAAACAGATACCT",0,2,0,0,0,2,101
"TCCGAAACATCCTTCG",3,14,6,0,0,23,672
"TCCGAAAGTCCTTTGC",0,6,0,0,2,8,205
"TCCGAAAGTTAGAGTA",2,22,4,0,7,35,543
"TCCGAAAGTTGTCCCT",2,23,9,2,13,49,1450
"TCCGAAATCGAAATCC",0,15,6,0,0,21,428
"TCCGATCAGCGTCTCG",13,9,3,0,6,31,699
"TCCGATCCAGGCTATT",0,0,0,0,0,0,40
"TCCGATCCAGTCACGC",41,343,64,22,59,529,26629
"TCCGATCCATGACAAA",1,14,7,0,4,26,658
"TCCGATCGTATGTCTG",1,3,3,0,3,10,337
"TCCGATCGTCACTACA",1,20,2,0,4,27,622
"TCCGATCGTGACACGA",40,137,406,26,81,690,36992
"TCCGATCGTTAGGCCC",2,17,5,2,4,30,455
"TCCGATCTCAATCGGT",1,14,7,0,0,22,109
"TCCGGGAAGAAACACT",0,0,0,0,0,0,6
"TCCGGGAAGGTAGCCA",0,0,0,0,0,0,4
"TCCGGGACACGCTGAC",1,15,0,0,2,18,186
"TCCGGGACATAATGCC",1,14,6,0,0,21,58
"TCCGGGAGTATAGGGC",1,3,0,0,0,4,33
"TCCGGGAGTTTGCAGT",0,2,0,0,2,4,11
"TCCGGGATCATGGCCG",6,23,5,0,3,37,791
"TCCGGGATCCGCTGTT",22,195,51,10,46,324,17103
"TCCGGGATCCTACGGG",3,32,7,0,6,48,2175
"TCCGGGATCGCGTAGC",0,4,0,0,2,6,262
"TCCGGGATCTCCGCAT",1,2,0,0,2,5,66
"TCCGGGATCTCTGCCA",0,3,0,0,0,3,100
"TCCGGGATCTTCCTAA",6,31,11,0,5,53,121
"TCCGTGTCAAGTTCGT",0,0,0,0,0,0,47
"TCCGTGTCATCAACCA",2,5,0,0,0,7,196
"TCCGTGTCATCATCTT",71,380,89,23,74,637,31326
"TCCGTGTGTAACGGTG",1,3,0,0,2,6,151
"TCCGTGTGTGCGCTCA",4,11,0,0,2,17,437
"TCCGTGTTCAGCGCAC",225,409,107,27,81,849,43854
"TCCTAATCATGGCCAC",0,5,0,0,0,5,76
"TCCTAATGTGCTATTG",3,18,8,0,6,35,154
"TCCTAATTCGCGGACT",5,31,21,2,6,65,1997
"TCCTAATTCGGTCGGT",2,18,4,2,3,29,523
"TCCTCCCCAGCTTCCT",0,0,0,0,0,0,8
"TCCTCCCGTACTTGTG",3,17,7,0,15,42,1198
"TCCTCCCTCAAGTGGG",1,4,0,0,0,5,119
"TCCTCCCTCATAGGCT",3,3,0,0,2,8,100
"TCCTCCCTCTGCTTAT",2,9,0,0,0,11,145
"TCCTCGAAGGACTAAT",7,62,15,4,15,103,4391
"TCCTCGACAAGTCCCG",1,5,0,0,0,6,105
"TCCTCGACAGTTTCAG",0,8,0,0,0,8,180
"TCCTCGACATCGATAC",5,40,9,4,21,79,1582
"TCCTCGAGTCAAGCCC",22,205,38,12,30,307,12897
"TCCTCGAGTGTCCGGT",5,30,14,0,8,57,1469
"TCCTCTTGTACGGTTT",2,15,3,0,0,20,493
"TCCTCTTTCCAAGCCG",2,2,0,0,0,4,67
"TCCTGCAAGTCGAAAT",5,18,4,2,2,31,722
"TCCTGCACAGAGGGTT",422,187,85,22,70,786,34429
"TCCTGCAGTGCCTGCA",1,7,2,0,0,10,198
"TCCTGCAGTTTACGTG",9,43,56,4,18,130,6430
"TCCTGCATCACCATCC",0,0,0,0,0,0,14
"TCCTGCATCCGACGGT",0,2,0,0,0,2,17
"TCCTTCTAGGATGAGA",2,5,0,0,0,7,129
"TCCTTCTCAAGAATAC",3,28,5,0,3,39,984
"TCCTTCTGTAGCTGAG",12,36,17,7,75,147,6210
"TCCTTCTGTCCTCCAT",0,0,2,0,0,2,47
"TCCTTCTTCAGAGTGG",1,0,3,2,2,8,122
"TCCTTCTTCGTGCTCT",1,6,2,0,3,12,142
"TCCTTCTTCGTTAGTG",0,4,0,0,0,4,12
"TCCTTCTTCTTCCCGA",9,30,17,9,51,116,6687
"TCCTTTCAGCTTCTAG",17,129,37,14,56,253,13346
"TCCTTTCAGTTGTCGT",1,11,4,0,2,18,481
"TCCTTTCCACGTCGTG",12,61,19,5,13,110,3089
"TCCTTTCCAGTCTTCC",1,5,0,0,0,6,44
"TCCTTTCCATACCAGT",3,7,0,0,0,10,156
"TCCTTTCCATTACTCT",1,21,6,0,9,37,702
"TCCTTTCCATTCTCTA",6,41,7,3,9,66,622
"TCCTTTCGTTCTCTAT",48,214,84,104,57,507,23890
"TCCTTTCGTTCTTAGG",68,221,531,38,116,974,51400
"TCCTTTCTCAAAGCCT",1,10,2,0,3,16,421
"TCCTTTCTCAAAGGTA",0,6,0,0,4,10,190
"TCCTTTCTCCAAAGGG",2,24,3,0,4,33,544
"TCGAACAAGTCTGCAT",3,5,0,0,0,8,186
"TCGAACACAAACACGG",3,29,14,0,2,48,1020
"TCGAACACACCCTAAA",3,11,2,0,0,16,261
"TCGAACACACCTTCGT",0,0,0,0,0,0,5
"TCGAACACACTGCATA",0,6,0,0,2,8,242
"TCGAACACATGACGGA",0,5,0,0,0,5,195
"TCGAACAGTACCATAC",2,8,2,0,2,14,493
"TCGAACAGTGGTTTAC",2,22,5,0,5,34,557
"TCGAACAGTTGAAGTA",0,11,2,0,2,15,124
"TCGAAGTAGTCAGCCC",3,25,7,6,6,47,908
"TCGAAGTCAATCTCGA",0,2,0,0,0,2,32
"TCGAAGTCACCCAATA",0,3,6,0,0,9,112
"TCGAAGTCAGAAATTG",0,2,0,0,0,2,6
"TCGAAGTCAGTTGAAA",1,0,0,0,0,1,116
"TCGAAGTGTCGAGCAA",0,3,0,0,0,3,66
"TCGAAGTTCATGGTAC",4,30,18,2,4,58,1119
"TCGAAGTTCCGTATAG",4,39,6,2,8,59,932
"TCGAAGTTCGTGTGGC",77,566,151,32,115,941,41597
"TCGACCTAGACAGCGT",2,10,3,0,4,19,386
"TCGACCTAGCAACTTC",4,9,7,2,4,26,913
"TCGACCTAGTGCAACG",1,2,0,0,0,3,7
"TCGACCTCAAAGGTTA",0,7,2,0,2,11,65
"TCGACCTCACCCGTAG",10,44,101,3,15,173,7267
"TCGACCTCACTAAACC",2,11,2,0,2,17,386
"TCGACCTCAGCGAGTA",1,7,5,0,0,13,319
"TCGACCTCATGGCTAT",34,286,102,19,52,493,26580
"TCGACCTGTGCCTATA",3,28,25,3,8,67,3081
"TCGACCTTCCCATAAG",0,7,2,0,0,9,44
"TCGACCTTCTCGTCAC",1,8,2,0,2,13,161
"TCGACCTTCTTAAGGC",1,18,3,2,2,26,93
"TCGACGGAGACCCTTA",2,8,0,0,0,10,159
"TCGACGGCAGATGCGA",0,3,2,0,2,7,108
"TCGACGGCATTAGGAA",2,41,8,0,8,59,1632
"TCGACGGGTAGCTCGC",4,31,34,2,10,81,2014
"TCGACGGGTCAACGCC",1,16,0,0,0,17,168
"TCGACGGGTCTAGGCC",1,6,0,0,0,7,170
"TCGACGGGTTGCCGAC",0,6,3,0,2,11,110
"TCGACGGTCATTACGG",5,44,7,0,11,67,937
"TCGACGGTCCAGTTCC",0,19,4,2,3,28,649
"TCGACGGTCGGAGCAA",0,9,2,0,2,13,283
"TCGACGGTCTGCCCTA",2,12,2,0,0,16,411
"TCGATTTAGAAGCTGC",2,13,2,0,6,23,513
"TCGATTTAGTTTAGGA",0,0,0,0,0,0,81
"TCGATTTCAATCTCTT",0,0,3,0,3,6,123
"TCGATTTCACGCCAGT",1,17,12,0,9,39,135
"TCGATTTCAGACGCTC",4,32,10,2,3,51,659
"TCGATTTGTAACCAGG",0,2,2,0,0,4,10
"TCGATTTGTACCTGTA",17,63,21,43,17,161,5784
"TCGATTTGTACGAGCA",3,13,5,0,6,27,507
"TCGATTTTCCACAGGC",1,4,0,2,0,7,41
"TCGCACTAGACGTCCC",47,357,73,22,64,563,19748
"TCGCACTAGGTATTGA",3,11,3,0,0,17,88
"TCGCACTCAGCTACAT",3,17,2,2,0,24,677
"TCGCACTCATGGCGCT",0,4,0,0,0,4,100
"TCGCAGGAGCGTTAGG",2,4,4,2,0,12,254
"TCGCAGGCAGGAGGAG",0,0,0,0,0,0,15
"TCGCAGGCATCAGCTA",1,3,2,0,0,6,319
"TCGCAGGCATGCACTA",0,0,0,0,0,0,12
"TCGCAGGTCATTGTGG",5,30,15,3,7,60,112
"TCGCAGGTCGTAATGC",0,0,0,0,0,0,40
"TCGCTCAAGATCCCGC",0,4,2,0,0,6,183
"TCGCTCAAGCGCTGAA",0,7,0,0,0,7,139
"TCGCTCAAGGTTATAG",146,78,47,22,40,333,13578
"TCGCTCACAATCGCCG",0,15,4,0,3,22,46
"TCGCTCACAATGCAGG",2,21,7,0,6,36,1190
"TCGCTCACACGGCCAT",33,105,107,22,235,502,24164
"TCGCTTGAGCACCGAA",1,0,0,0,0,1,49
"TCGCTTGAGTGAATAC",0,2,0,0,0,2,56
"TCGCTTGCAACTACGT",1,21,2,0,0,24,666
"TCGCTTGCATGGAACG",2,15,5,2,3,27,579
"TCGCTTGTCGAAGTGG",0,9,0,0,0,9,149
"TCGCTTGTCGAGTGGA",11,35,63,5,18,132,5475
"TCGCTTGTCGGTCATA",0,0,0,0,0,0,10
"TCGGATAAGGTGCCAA",22,170,30,43,40,305,11978
"TCGGATACACGCGCTA",3,37,8,3,6,57,616
"TCGGATACACGTCGTG",0,0,0,0,0,0,24
"TCGGATACATAGGAGC",1,17,3,0,0,21,716
"TCGGATACATATACCG",1,7,0,0,3,11,70
"TCGGATAGTGCTATTG",1,2,0,0,0,3,65
"TCGGATATCAAACTGC",1,7,0,0,0,8,114
"TCGGATATCACTGGGC",179,748,264,55,147,1393,61512
"TCGGATATCCTCGCAT",1,5,0,0,0,6,115
"TCGGATATCGTGCATA",5,42,11,4,10,72,2718
"TCGGGACAGATGCTTC",0,23,8,3,2,36,460
"TCGGGACAGCGGACAT",1,7,0,0,0,8,191
"TCGGGACAGGAAAGTG",0,6,2,0,2,10,279
"TCGGGACAGGCTCAAG",1,4,2,0,0,7,159
"TCGGGACAGGTCCGAA",4,13,4,0,4,25,670
"TCGGGACAGTTACGGG",0,20,7,0,3,30,612
"TCGGGACCATAAGCGG",0,2,2,0,2,6,126
"TCGGGACTCAAAGGTA",0,0,0,0,0,0,80
"TCGGGACTCCTCCACA",0,2,0,0,0,2,7
"TCGGGACTCGTTACCC",1,20,4,0,0,25,371
"TCGGGACTCTCGTGGG",1,4,0,0,2,7,148
"TCGGGCAAGAAATGGG",0,2,3,0,0,5,86
"TCGGGCAAGTCACGAG",310,312,89,20,86,817,30674
"TCGGGCACATCGATCA",1,18,4,0,3,26,355
"TCGGGCAGTCTTGAGT",5,20,10,2,6,43,638
"TCGGGCAGTTGCATGT",0,2,0,0,3,5,35
"TCGGGCAGTTTGAAAG",3,8,4,0,5,20,56
"TCGGGCATCGTAATGC",0,3,0,0,2,5,55
"TCGGGTGCACAGCTGC",0,0,0,0,0,0,1
"TCGGGTGGTCTCACAA",5,38,12,2,3,60,635
"TCGGTCTAGCGTCGAA",0,42,5,2,2,51,411
"TCGGTCTAGCTTTGTG",0,6,0,0,0,6,189
"TCGGTCTAGTAACGTA",18,54,94,3,24,193,8276
"TCGGTCTCAGAGAATT",2,11,3,0,0,16,352
"TCGGTCTCAGCTCTGG",1,2,0,0,0,3,84
"TCGGTCTGTACTGCCG",10,58,131,9,25,233,7579
"TCGGTCTGTGGTCCCA",2,12,2,2,2,20,824
"TCGGTCTGTGTTACTG",2,28,5,0,5,40,719
"TCGGTCTTCCATTGGA",0,5,0,0,0,5,97
"TCGGTCTTCGGCATTA",0,4,0,0,2,6,228
"TCGTAGAAGCGTTCCG",1,10,2,0,0,13,378
"TCGTAGAAGGGTGAGG",0,0,0,0,0,0,1
"TCGTAGACAAAGGCGT",1,23,0,0,3,27,548
"TCGTAGACAATCCAGT",0,3,0,0,0,3,78
"TCGTAGACACTAACCA",31,165,207,13,63,479,21294
"TCGTAGACATCTCAAG",1,17,0,0,2,20,49
"TCGTAGATCACCCTTG",0,7,2,0,2,11,166
"TCGTAGATCAGCTTGA",0,5,0,0,0,5,60
"TCGTCCAAGGCTGGAT",0,2,0,0,0,2,140
"TCGTCCAAGGGCCTCT",2,7,0,0,0,9,215
"TCGTCCACACCAAAGG",14,46,27,8,92,187,7635
"TCGTCCACATCAGCGC",1,15,2,0,3,21,312
"TCGTCCAGTATCAGGG",0,8,0,0,0,8,137
"TCGTCCAGTCGCAACC",0,5,0,0,0,5,97
"TCGTCCATCACCCTTG",23,83,153,16,99,374,16150
"TCGTCCATCGCTACGG",228,2063,538,122,436,3387,119382
"TCGTCCATCTACCAGA",0,5,0,0,0,5,57
"TCGTCCATCTCAGTCC",0,4,0,0,0,4,71
"TCGTGCTAGAGGATCC",0,13,0,0,2,15,93
"TCGTGCTCAATTGCGT",1,2,0,0,0,3,54
"TCGTGCTCACAGGATG",0,5,0,2,2,9,70
"TCGTGCTGTCATTGCA",0,3,0,0,0,3,53
"TCGTGCTGTTGATGTC",1,4,0,0,0,5,44
"TCGTGCTTCCTTATGT",30,313,66,11,58,478,15324
"TCGTGGGAGTATTCCG",0,0,0,0,0,0,32
"TCGTGGGCATCACGGC",0,0,0,0,2,2,70
"TCGTGGGCATCCGATA",1,4,0,0,0,5,59
"TCGTGGGTCATCGCTC",0,0,2,0,0,2,69
"TCGTGGGTCCGTCAAA",0,8,3,0,0,11,188
"TCGTGGGTCGATAACC",0,6,0,0,0,6,61
"TCGTGGGTCTTTGGAG",0,3,0,0,0,3,58
"TCTAACTAGGATTCCT",6,12,4,0,5,27,587
"TCTAACTCATACCACA",0,5,2,0,3,10,242
"TCTAACTCATAGGCGA",6,31,10,2,10,59,87
"TCTAACTGTAGGATAT",1,11,0,0,0,12,153
"TCTAACTGTATACCTG",9,47,25,7,12,100,3055
"TCTAACTGTCACTACA",0,4,0,0,2,6,83
"TCTAACTGTTCAGTAC",31,161,180,19,48,439,24505
"TCTAACTTCACGTCCT",0,5,0,0,0,5,237
"TCTAACTTCCGTAGGC",0,11,0,0,0,11,183
"TCTAACTTCGGTATGT",5,21,3,0,6,35,407
"TCTAACTTCTATCACT",1,12,2,0,3,18,180
"TCTAACTTCTCTCGAC",0,3,0,0,0,3,112
"TCTAACTTCTGGGCAC",0,6,0,0,0,6,42
"TCTACATAGAGCATAT",4,49,6,2,17,78,2140
"TCTACATAGCCTATCA",4,6,2,0,0,12,257
"TCTACATAGGCAGTCA",0,2,0,0,0,2,21
"TCTACATCAATAGGAT",0,6,2,0,2,10,194
"TCTACATCATGGCTGC",15,44,25,63,41,188,8922
"TCTACATCATTCACAG",12,108,25,4,16,165,6956
"TCTACATGTCTTTCAT",29,91,126,13,41,300,13202
"TCTACCGAGGATCACG",1,6,0,0,2,9,312
"TCTACCGAGTCTCCTC",0,4,3,0,7,14,531
"TCTACCGGTTCCAAAC",0,7,0,0,0,7,65
"TCTACCGTCAATGCAC",0,4,0,0,0,4,348
"TCTACCGTCTACCTTA",1,8,0,0,0,9,414
"TCTATACAGAAACCCG",0,0,0,0,0,0,15
"TCTATACAGGCCCACT",3,9,0,0,2,14,189
"TCTATACAGGTCATCT",89,494,490,59,193,1325,68730
"TCTATACCACAGCTTA",1,5,3,0,0,9,173
"TCTATACCAGACAAAT",7,23,7,2,8,47,585
"TCTATACCATCGTGGC",9,42,59,3,20,133,5696
"TCTATACGTCCATACA",5,34,4,3,3,49,700
"TCTATACGTGCAATAA",0,5,0,0,2,7,297
"TCTATACGTGGAGGTT",6,81,23,8,16,134,5661
"TCTATACTCACTGAAC",0,5,0,0,0,5,86
"TCTATACTCAGACATC",0,0,0,0,0,0,19
"TCTATACTCCTACGGG",1,8,2,0,2,13,116
"TCTATACTCGCTTTAT",11,82,21,7,27,148,7209
"TCTATCAAGGTTCTTG",0,8,0,0,0,8,183
"TCTATCACAACTTGGT",2,2,0,0,0,4,81
"TCTATCACACGGCTAC",0,3,0,0,0,3,71
"TCTATCACACTGGCGT",0,7,0,0,0,7,133
"TCTATCACAGGTAGTG",1,20,4,0,2,27,682
"TCTATCAGTGCTAGCC",1,2,0,0,0,3,206
"TCTATCAGTTTAGAGA",548,2139,595,151,451,3884,112283
"TCTATCATCAACGAGG",0,3,2,0,0,5,113
"TCTATCATCAGATTGC",3,11,6,0,6,26,445
"TCTATCATCCGAAGGA",5,11,0,0,2,18,188
"TCTATCATCCGCCTAT",309,2382,628,169,461,3949,208236
"TCTCACGAGTGATGGC",3,19,4,0,7,33,116
"TCTCACGCAAACTCGT",68,559,116,32,105,880,38275
"TCTCACGCAAGAGTTA",1,0,0,0,0,1,56
"TCTCACGCACGGTCTG",1,13,5,0,4,23,802
"TCTCACGGTAGAATAC",2,9,5,0,0,16,118
"TCTCACGGTGTTTCTT",0,6,5,0,0,11,133
"TCTCACGTCACTTATC",0,0,0,0,0,0,32
"TCTCACGTCGTCTACC",1,4,0,0,0,5,88
"TCTCACGTCTGAGATC",1,18,4,2,3,28,488
"TCTCAGCAGCCTATCA",1,15,4,0,2,22,863
"TCTCAGCAGTCGAAGC",0,8,0,0,2,10,55
"TCTCAGCCAATTGTGC",5,26,4,0,5,40,1563
"TCTCAGCCATTCGGGC",1,5,4,0,0,10,242
"TCTCAGCGTGTTTACG",2,7,2,0,0,11,124
"TCTCAGCGTTACGTAC",35,26,12,19,9,101,5014
"TCTCAGCTCACGGTCG",5,17,0,2,2,26,1146
"TCTCAGCTCCTCGCAT",0,4,0,0,0,4,89
"TCTCAGCTCGTTAGTG",27,224,65,15,47,378,14711
"TCTCCGACAATTGCCA",0,2,0,0,0,2,314
"TCTCCGACAGAGCCCT",38,134,402,20,52,646,33490
"TCTCCGACAGCGTAGA",1,5,0,0,0,6,59
"TCTCCGACAGTTACCA",1,4,2,0,2,9,168
"TCTCCGAGTACAAGTA",1,11,6,2,7,27,1151
"TCTCTGGCACGACTAT",27,187,29,6,35,284,15685
"TCTCTGGCACGGGCTT",6,32,8,0,9,55,1647
"TCTCTGGCACTTGGCG",158,81,35,10,37,321,13538
"TCTCTGGCAGTGCGCT",2,12,3,0,8,25,844
"TCTCTGGCATCGCTAA",1,3,4,0,0,8,361
"TCTCTGGTCATGGATC",0,2,0,0,0,2,80
"TCTCTGGTCTTTGCGC",62,300,107,25,58,552,26813
"TCTGCCACAAATAAGC",2,7,2,0,0,11,240
"TCTGCCACAGTTAGGG",3,2,0,0,0,5,179
"TCTGCCACATTGTGCA",1,5,0,0,2,8,201
"TCTGCCAGTGGCCTCA",9,47,93,7,20,176,7657
"TCTGCCATCGGAAGGT",0,5,0,2,0,7,34
"TCTGCCATCTCAACCC",2,33,8,0,9,52,1741
"TCTGGCTAGCAAACAT",3,15,10,0,5,33,1095
"TCTGGCTAGCAAGGAA",0,0,0,0,0,0,5
"TCTGGCTAGGCTTTCA",12,28,9,3,4,56,1729
"TCTGGCTCAAAGCTCT",0,0,0,0,0,0,3
"TCTGGCTCAGAATTCC",4,15,2,0,0,21,419
"TCTGGCTCATGTGCTA",0,7,4,0,2,13,361
"TCTGGCTGTGTTGCCG",13,37,48,9,50,157,6439
"TCTGGCTGTTACGATC",1,6,2,0,0,9,149
"TCTGGCTGTTCAAACC",0,2,0,0,0,2,76
"TCTGGCTTCACTTGTT",3,22,6,0,7,38,1585
"TCTGTCGAGCACTGGA",6,16,7,0,3,32,537
"TCTGTCGCAAGTGACG",1,5,0,0,0,6,74
"TCTGTCGCAGCTGAAG",1,29,7,0,17,54,1631
"TCTGTCGTCTACCAGA",0,0,3,0,0,3,175
"TCTGTCGTCTTCGACC",1,5,0,0,2,8,131
"TCTTAGTAGGAGTCTG",4,41,10,3,8,66,772
"TCTTAGTAGGGTGGGA",5,20,7,3,5,40,826
"TCTTAGTAGTAAATGC",1,0,2,0,0,3,169
"TCTTAGTAGTCGAATA",0,4,2,0,0,6,113
"TCTTAGTAGTCGTCTA",1,9,3,2,4,19,428
"TCTTAGTCACAAGTGG",0,6,0,0,0,6,169
"TCTTAGTCACACTGGC",11,30,3,4,5,53,1294
"TCTTAGTCACAGTCGC",0,12,0,0,2,14,148
"TCTTAGTCACCCAACG",11,56,24,7,43,141,4234
"TCTTAGTGTCGGATTT",1,2,0,0,0,3,28
"TCTTAGTGTCTGTGTA",0,0,0,0,0,0,15
"TCTTAGTGTGCTATTG",4,34,19,3,8,68,1642
"TCTTAGTGTTATTCCT",1,4,0,0,0,5,42
"TCTTAGTTCCACGGAC",0,12,2,0,3,17,535
"TCTTAGTTCGATAACC",1,3,0,0,0,4,57
"TCTTCCTAGCCGTAAG",1,8,5,0,2,16,493
"TCTTCCTAGGAGTCTG",0,20,6,0,2,28,722
"TCTTCCTCACGAAGAC",1,11,0,0,0,12,159
"TCTTCCTCAGCCTATA",1,5,3,0,2,11,370
"TCTTCCTCATGACGAG",35,286,72,81,48,522,23326
"TCTTCCTGTCAACACT",2,39,6,3,4,54,980
"TCTTCCTTCCCTAGGG",1,0,0,0,0,1,31
"TCTTCCTTCCTGTAAG",0,3,0,0,0,3,59
"TCTTCCTTCTACACTT",0,3,0,0,0,3,229
"TCTTGCGAGACGCATG",0,0,0,0,0,0,16
"TCTTGCGAGATTGACA",1,4,0,0,2,7,209
"TCTTGCGAGCGCCCAT",3,24,6,3,2,38,571
"TCTTGCGAGTAGCTCT",3,17,3,0,5,28,1064
"TCTTGCGGTGACAGCA",1,6,4,0,0,11,148
"TCTTGCGTCGCTTACC",0,3,0,0,0,3,39
"TCTTTGAAGAGGTTAT",2,7,0,0,2,11,98
"TCTTTGAAGCCTCTCT",2,9,0,0,0,11,328
"TCTTTGAAGGTGATAT",1,22,2,0,5,30,615
"TCTTTGAAGTGCACCC",0,0,0,0,0,0,26
"TCTTTGACACGAAAGC",0,4,0,0,0,4,45
"TCTTTGACAGATACCT",1,12,0,0,0,13,139
"TCTTTGACAGCCGGTT",3,28,6,0,7,44,1086
"TCTTTGACATTCTTCA",0,4,3,0,3,10,162
"TCTTTGAGTATCGTGT",0,3,0,0,0,3,20
"TCTTTGAGTCACAGAG",16,68,128,6,36,254,14495
"TCTTTGAGTCTTCATT",36,36,9,0,7,88,3927
"TCTTTGATCGCATAGT",2,6,0,0,0,8,193
"TCTTTGATCTGATTCT",1,2,2,0,0,5,125
"TGAACGTAGAGGTCGT",17,74,134,6,65,296,12531
"TGAACGTCACCAATTG",0,5,2,0,2,9,259
"TGAACGTGTATTGGCT",1,10,0,0,0,11,129
"TGAACGTGTCATACCA",2,16,3,0,4,25,428
"TGAACGTGTCCTGGGT",1,5,0,0,0,6,204
"TGAACGTGTGTCGCTG",3,27,36,2,8,76,3959
"TGAATCGAGCAGGCTA",1,6,0,0,0,7,161
"TGAATCGAGTCATCCA",1,6,2,0,0,9,178
"TGAATCGCACATTCTT",1,6,0,0,4,11,169
"TGAATCGCACTGCGTG",1,6,3,0,0,10,200
"TGAATCGCAGCGACAA",1,7,3,0,2,13,154
"TGAATCGCAGGAATAT",0,2,0,0,0,2,107
"TGAATCGCAGGCGAAT",0,6,0,0,0,6,70
"TGAATCGGTCCTACAA",1,6,0,0,0,7,119
"TGAATCGGTCTCGGAC",0,7,0,0,3,10,108
"TGAATCGTCAGCTCTC",6,10,3,4,3,26,419
"TGAATCGTCCACGGAC",2,13,10,2,3,30,568
"TGAATGCAGTAATTGG",0,10,3,0,0,13,448
"TGAATGCCAGGGTTGA",3,4,0,0,2,9,203
"TGAATGCCATCTGTTT",0,7,0,0,0,7,258
"TGAATGCGTAATGCGG",0,4,0,0,0,4,155
"TGAATGCGTATCTCGA",0,5,0,0,0,5,210
"TGAATGCGTTGTTGCA",27,93,221,13,50,404,19283
"TGAATGCTCAACTGGT",1,29,4,0,6,40,207
"TGAATGCTCGATGCTA",4,26,8,0,6,44,683
"TGAATGCTCTAGATCG",2,13,2,0,3,20,642
"TGACAGTAGAACCCGA",1,6,2,0,0,9,221
"TGACAGTAGACCATAA",1,4,0,0,0,5,60
"TGACAGTAGGAAGTGA",0,2,3,0,0,5,12
"TGACAGTAGGGCCCTT",0,3,3,0,2,8,217
"TGACAGTCAGTGTATC",1,5,0,0,0,6,198
"TGACAGTGTCACAGAG",0,8,2,0,0,10,162
"TGACAGTTCACTGCTC",28,94,51,8,200,381,21125
"TGACAGTTCATACAGC",0,12,0,0,0,12,368
"TGACAGTTCCGCAACG",2,5,3,0,0,10,343
"TGACAGTTCTCTTGCG",2,18,4,4,5,33,616
"TGACCCTCAACGGCCT",0,5,0,0,0,5,182
"TGACCCTGTCCGGTCA",0,8,0,0,0,8,169
"TGACCCTTCCAATCTT",0,11,2,0,0,13,187
"TGACCCTTCCTAGCGG",145,1318,249,137,232,2081,87671
"TGACCCTTCTGAGGCC",1,6,2,0,0,9,126
"TGACGCGAGAACGTGC",1,0,0,0,0,1,5
"TGACGCGAGACCATTC",30,101,171,13,159,474,25284
"TGACGCGAGACTGAGC",1,4,3,0,0,8,129
"TGACGCGAGCCGATAG",0,15,6,0,3,24,491
"TGACGCGAGCCTCAGC",0,0,0,0,0,0,33
"TGACGCGGTACTGCGC",3,20,2,0,4,29,832
"TGACGCGGTCTACAGT",2,7,3,0,6,18,397
"TGACGCGGTGGTGATG",0,5,0,2,0,7,249
"TGACTCCAGCTCTATG",3,4,0,0,0,7,148
"TGACTCCAGTATGAGT",3,22,5,0,7,37,535
"TGACTCCCAAGCGAGT",1,9,0,0,2,12,267
"TGACTCCCACTGTCCT",0,7,2,0,0,9,203
"TGACTCCCAGGCACAA",0,2,0,0,0,2,81
"TGACTCCGTACACGTT",1,4,2,0,2,9,124
"TGACTCCGTAGAATAC",4,20,5,0,3,32,651
"TGACTCCGTGTCCAAT",1,10,0,0,0,11,170
"TGACTCCGTTCCACAA",1,4,0,0,3,8,162
"TGAGACTAGATGAATC",13,102,18,4,21,158,6993
"TGAGACTAGCTGACCC",2,6,0,0,0,8,171
"TGAGACTAGTGCGCTC",2,3,0,3,0,8,133
"TGAGACTCACGCACCA",0,19,8,0,2,29,621
"TGAGACTCATACAGGG",28,272,60,27,56,443,18705
"TGAGACTGTACGCTAT",2,10,3,0,2,17,179
"TGAGACTGTATAATGG",5,30,25,3,11,74,3302
"TGAGACTGTCTCGCGA",0,2,2,0,0,4,37
"TGAGACTGTGGCTACC",0,3,3,0,0,6,94
"TGAGACTGTGGTCAAG",1,7,0,0,0,8,20
"TGAGACTGTTTCTATC",0,4,0,0,0,4,47
"TGAGACTTCGCTTAAG",1,22,2,0,3,28,92
"TGAGACTTCTGGCCAG",100,467,164,374,144,1249,60859
"TGAGCATAGCTCATAC",35,86,217,16,42,396,20254
"TGAGCATAGGAGAGGC",1,9,0,0,0,10,284
"TGAGCATAGGGTGAAA",3,41,10,0,6,60,1456
"TGAGCATAGTTCCTGA",19,53,13,0,16,101,1797
"TGAGCATCAACAGCTT",1,7,2,0,0,10,147
"TGAGCATCAAGAATAC",35,141,33,10,28,247,6879
"TGAGCATCAGGCAATG",2,25,5,5,3,40,1000
"TGAGCATGTGTTCGAT",0,0,0,0,2,2,10
"TGAGCATTCAGCTGAT",0,5,0,0,0,5,42
"TGAGCATTCATGGTAC",49,319,71,19,68,526,23196
"TGAGCGCCAATGGCAG",3,0,0,0,2,5,97
"TGAGCGCCACCGTGCA",3,17,2,2,0,24,305
"TGAGCGCGTAAGATAC",24,103,37,13,87,264,11993
"TGAGCGCGTGTAACGG",1,4,0,0,0,5,168
"TGAGCGCTCACATACG",0,7,2,0,2,11,139
"TGAGCGCTCGAGTACT",2,20,5,0,3,30,48
"TGAGGAGAGTGCCTCG",0,6,3,0,0,9,203
"TGAGGAGCAAGGTACG",1,7,4,0,4,16,305
"TGAGGAGCAGCGACAA",10,15,8,2,18,53,1779
"TGAGGAGTCTTAAGGC",3,28,7,4,5,47,777
"TGAGGGAAGTCACTGT",30,95,52,192,37,406,17949
"TGAGGGACACATGACT",1,18,2,0,2,23,480
"TGAGGGACAGCACCCA",1,20,3,0,2,26,514
"TGAGGGAGTATGTGTC",23,87,218,10,43,381,19596
"TGAGGGAGTCACCGCA",0,3,0,0,0,3,9
"TGAGGGAGTGCGAGTA",0,10,3,0,2,15,98
"TGAGGGATCACACGAT",16,66,151,6,24,263,13576
"TGAGGGATCCAACCGG",0,2,0,0,0,2,69
"TGAGGGATCGTCAAAC",0,6,0,0,2,8,100
"TGAGGTTAGACGAAGA",0,6,2,0,3,11,213
"TGAGGTTAGCCAAGTG",3,22,3,0,5,33,708
"TGAGGTTAGCTGGTGA",19,86,22,7,17,151,6289
"TGAGGTTAGTGAGTGC",0,0,0,0,0,0,5
"TGAGGTTCAGAACGCA",1,4,0,0,3,8,138
"TGAGGTTGTCATTGCA",9,70,13,2,9,103,5315
"TGAGGTTGTTGAGAGC",0,0,2,0,0,2,29
"TGAGGTTGTTTGGAAA",11,101,21,5,19,157,6099
"TGAGTCACAGCGAGTA",15,54,26,97,41,233,9376
"TGAGTCACAGTCACGC",17,134,27,7,21,206,8082
"TGAGTCATCGGAAGGT",5,30,52,3,12,102,4749
"TGATCAGAGAACTCCT",2,7,3,0,0,12,206
"TGATCAGCATGACGGA",14,46,20,10,88,178,7929
"TGATCAGGTAGTAAGT",1,17,8,0,4,30,436
"TGATCAGTCCTTACCG",4,23,7,0,9,43,685
"TGATCTTAGTAGGTTA",5,32,7,3,9,56,843
"TGATCTTCAATCGCCG",2,25,4,0,4,35,802
"TGATCTTGTGATAGAT",28,211,53,12,50,354,17691
"TGATCTTTCGAAGTGG",2,14,7,2,5,30,414
"TGATCTTTCGCCACTT",1,2,0,0,0,3,190
"TGATGCAAGGCTGGAT",0,6,3,0,0,9,81
"TGATGCACACTAAACC",0,4,0,0,0,4,40
"TGATGCAGTCCTGGTG",1,7,3,0,0,11,454
"TGATGCAGTCGTTGCG",0,2,0,0,0,2,112
"TGATGCATCATCTATC",1,8,0,0,0,9,130
"TGATGCATCGAGATAA",0,3,0,0,2,5,33
"TGATGGTAGCCTTTGA",0,4,0,0,0,4,118
"TGATGGTAGGGAGAAT",3,26,3,0,8,40,478
"TGATGGTAGGGTACAC",21,79,37,7,148,292,13522
"TGATGGTCACGCTATA",0,3,2,3,0,8,72
"TGATGGTGTCACTTAG",2,0,2,0,2,6,74
"TGATTCTAGCCGTTAT",13,69,109,8,76,275,11159
"TGATTCTAGCTCCATA",44,327,79,35,68,553,26251
"TGATTCTAGGATGGCT",1,3,0,0,0,4,161
"TGATTCTAGGTAGCCA",5,24,5,0,9,43,629
"TGATTCTAGGTCCGAA",3,3,0,0,2,8,195
"TGATTCTAGTGCTACT",0,5,0,0,0,5,236
"TGATTCTCACTGCGTG",29,198,44,11,41,323,18365
"TGATTCTCAGTATGAA",0,8,0,0,0,8,213
"TGATTCTGTCGCCACA",0,0,0,0,0,0,3
"TGATTCTTCGCGTGCA",1,23,6,0,2,32,884
"TGATTCTTCTTCCAGC",0,2,0,0,0,2,54
"TGATTTCAGACGGATC",1,7,0,2,2,12,115
"TGATTTCCACCTGAAT",2,25,10,2,6,45,1016
"TGATTTCCAGCGATTT",3,24,5,0,3,35,323
"TGATTTCCAGTAGGAC",53,157,302,31,206,749,38382
"TGATTTCGTACAGGTG",1,12,2,0,0,15,170
"TGATTTCGTCCTTGTC",0,2,0,0,2,4,4
"TGATTTCTCACGATAC",4,15,4,0,3,26,516
"TGCACGGAGACATAGT",6,49,12,0,6,73,1814
"TGCACGGAGAGGGTAA",1,7,2,0,0,10,196
"TGCACGGCAAAGCTAA",4,30,7,0,3,44,510
"TGCACGGCAACACAGG",3,28,5,2,8,46,123
"TGCACGGCAATTGCGT",1,2,0,0,0,3,9
"TGCACGGCACGCTGCA",71,579,95,25,89,859,40524
"TGCACGGCAGCATTGT",62,164,52,26,36,340,12556
"TGCACGGGTAACGATA",10,37,37,5,33,122,4379
"TGCACGGTCCCATAGA",1,4,0,0,0,5,403
"TGCAGATAGTCACGCC",23,72,161,17,34,307,13778
"TGCAGATAGTTTCTTC",4,58,27,5,17,111,3643
"TGCAGATCAAATGCGG",0,10,0,0,0,10,99
"TGCAGATCAGTAACGG",0,0,0,0,0,0,2
"TGCAGATCATGACGTT",0,4,0,0,2,6,64
"TGCAGGCAGCGCATCC",4,25,28,2,8,67,1110
"TGCAGGCAGGTAAAGG",0,2,0,0,2,4,89
"TGCAGGCCAATAAGGT",4,23,3,0,8,38,404
"TGCAGGCGTGTATTCG",0,5,0,0,5,10,107
"TGCAGGCGTTGGGAAC",1,6,2,0,2,11,163
"TGCAGGCTCACGGACC",3,18,7,2,6,36,1313
"TGCAGGCTCGACCAAT",1,0,3,0,0,4,20
"TGCAGGCTCTACCACC",0,6,0,0,3,9,196
"TGCAGTACATTGAGGG",1,2,2,0,0,5,53
"TGCAGTAGTCAGGAGT",64,514,115,32,90,815,39249
"TGCAGTATCACTTGGA",2,5,0,0,2,9,54
"TGCAGTATCCGTATGA",3,25,7,2,3,40,97
"TGCAGTATCTTCGACC",0,8,4,0,0,12,268
"TGCATCCAGCTGAAAT",23,56,117,12,28,236,10158
"TGCATCCCACATATGC",0,0,2,0,0,2,11
"TGCATCCGTAAGCTCT",0,4,0,0,0,4,51
"TGCATCCGTCGCAGTC",0,8,4,0,0,12,192
"TGCATGAAGGTTGAGC",0,0,0,0,0,0,30
"TGCATGACATCAGTGT",3,8,3,0,0,14,91
"TGCATGAGTAACTAAG",1,17,5,2,8,33,512
"TGCATGAGTACTCCCT",20,167,26,11,26,250,9882
"TGCATGATCATTGTTC",0,4,0,2,0,6,135
"TGCATGATCCCAGCGA",1,7,3,0,0,11,208
"TGCATGATCGAAGAAT",3,38,16,0,8,65,708
"TGCATGATCTGCGATA",0,6,2,0,0,8,194
"TGCCGAGCACAGCTTA",6,16,8,4,2,36,708
"TGCCGAGGTAGTGATA",0,3,0,0,0,3,13
"TGCCGAGGTGCCTGAC",1,16,5,0,3,25,599
"TGCCGAGGTTGCATCA",20,179,31,10,35,275,13437
"TGCCGAGGTTTGGGTT",4,17,8,0,4,33,956
"TGCCGAGTCACCTCAC",1,0,0,0,0,1,58
"TGCCGAGTCCTCAGAA",0,4,0,0,3,7,78
"TGCCGAGTCTCCGATC",0,3,2,0,2,7,113
"TGCGACGAGCGACTTT",0,5,4,0,0,9,121
"TGCGACGCAGGTCAAG",1,14,6,0,8,29,667
"TGCGACGCATCATCTT",1,3,0,0,0,4,135
"TGCGACGGTGAGTTGG",0,2,0,0,0,2,8
"TGCGACGGTTGTCTAG",1,7,0,0,2,10,137
"TGCGACGTCATCGCAA",2,7,0,0,0,9,168
"TGCGACGTCCGTGTAA",2,12,4,3,2,23,907
"TGCGACGTCCTAGCCT",3,11,2,2,7,25,349
"TGCGACGTCCTTATGT",1,7,0,0,2,10,104
"TGCGACGTCTGCCCTA",7,64,21,4,15,111,3413
"TGCGATAAGCATCTTG",71,54,18,6,20,169,5617
"TGCGATAAGGCCGCTT",59,634,164,92,111,1060,38150
"TGCGATAAGTCATAGA",1,5,2,0,2,10,116
"TGCGATACACCGGTCA",3,18,4,0,0,25,325
"TGCGATACACGACGAA",0,3,0,0,0,3,60
"TGCGATACAGTCAGTT",1,3,0,0,0,4,118
"TGCGATACATATGCGT",2,18,9,0,6,35,779
"TGCGATAGTACGATGG",0,15,3,0,4,22,310
"TGCGATAGTCACTTAG",1,5,0,0,0,6,213
"TGCGATATCCTCTGCA",3,19,10,3,15,50,1506
"TGCGGCAAGTCACAGG",0,2,0,0,2,4,82
"TGCGGCACAAGTATAG",3,6,0,0,0,9,122
"TGCGGCACACGGATCC",0,4,0,0,0,4,176
"TGCGGCACATTCTCTA",0,0,0,0,0,0,5
"TGCGGCAGTACTGCGC",1,17,4,3,8,33,119
"TGCGGCAGTCATGACT",0,0,0,0,0,0,62
"TGCGGCAGTCCTTAAG",1,5,0,0,0,6,119
"TGCGGCATCCGACGGT",0,8,0,0,0,8,213
"TGCGGCATCCGCTTAC",20,172,48,7,26,273,14878
"TGCGGGTAGCGTTGTT",0,0,0,0,0,0,103
"TGCGGGTAGGAGTCTG",6,38,46,0,13,103,3146
"TGCGGGTTCCCGTTCA",0,5,0,0,0,5,174
"TGCGGGTTCGCTCTAC",1,2,0,0,0,3,146
"TGCGGGTTCTCCCATG",1,13,4,0,5,23,268
"TGCTCCACAGAGGACT",1,5,0,0,0,6,105
"TGCTCCAGTCGGTGTC",2,11,4,0,3,20,358
"TGCTCCATCTTCTCAA",0,4,3,0,2,9,91
"TGCTCGTAGCAACTCT",0,4,0,0,0,4,45
"TGCTCGTAGTCATAGA",12,25,6,2,9,54,813
"TGCTCGTAGTTCCTGA",1,18,7,0,6,32,744
"TGCTCGTGTCGCGGTT",0,2,0,0,0,2,40
"TGCTCGTGTGAGAACC",50,84,27,10,44,215,8000
"TGCTCGTGTTGGCCGT",1,13,2,0,0,16,153
"TGCTCGTTCTCGGCTT",1,6,0,0,0,7,97
"TGCTGAAAGTAACAGT",0,5,5,0,0,10,142
"TGCTGAAGTAACCAGG",4,26,10,0,8,48,1283
"TGCTGAAGTCGTTATG",43,283,84,305,79,794,31404
"TGCTGAAGTGACTCGC",0,0,0,0,0,0,22
"TGCTGAAGTTTGGGTT",1,7,0,0,2,10,98
"TGCTGAATCAACTGAC",14,78,13,4,19,128,4984
"TGCTGAATCTCCCTAG",4,19,34,2,4,63,2162
"TGCTGAATCTCTCTTC",1,18,4,2,6,31,858
"TGCTTCGCAATCTCGA",72,444,124,37,292,969,53818
"TGCTTCGCACAGCATT",5,30,10,0,3,48,1014
"TGCTTCGCACCTTCCA",0,7,0,0,0,7,91
"TGCTTCGCACGATAGG",1,7,2,2,0,12,135
"TGCTTCGGTCAAACGG",1,4,0,0,0,5,150
"TGCTTCGGTTGGAGGT",5,28,47,5,8,93,3933
"TGCTTCGTCACGTAGT",0,5,3,0,0,8,338
"TGCTTCGTCAGCTAGT",2,0,3,0,3,8,218
"TGCTTGCAGCTTAAGA",3,4,0,0,0,7,119
"TGCTTGCAGGACGGAG",1,15,4,3,2,25,512
"TGCTTGCCAAGACGAC",3,11,0,0,4,18,492
"TGCTTGCCATTGACTG",0,2,0,0,2,4,19
"TGCTTGCGTCCTGGGT",0,3,0,0,0,3,111
"TGGAACTCAGCTCCTT",10,98,22,6,35,171,8294
"TGGAACTCAGCTGTGC",0,6,0,0,3,9,228
"TGGAACTTCATCCTAT",0,4,2,0,2,8,178
"TGGAACTTCGCAGTCG",39,113,390,19,52,613,20341
"TGGAACTTCTATCGGA",11,49,22,4,66,152,6201
"TGGAACTTCTCTGCTG",0,0,0,0,0,0,4
"TGGAGAGAGAAGTATC",0,7,2,0,0,9,254
"TGGAGAGAGATGGCGT",0,5,2,0,2,9,269
"TGGAGAGAGGCCTTGC",4,17,7,0,6,34,668
"TGGAGAGCACCGCTAG",4,14,5,0,0,23,561
"TGGAGAGGTGTTAAAG",0,0,0,0,0,0,34
"TGGAGAGTCTGCGGCA",1,14,7,0,0,22,584
"TGGAGGAAGGCAGGTT",1,8,0,0,3,12,275
"TGGAGGAAGGTCGCCT",0,6,0,0,0,6,87
"TGGAGGAAGTAACCTC",3,32,4,0,4,43,654
"TGGAGGACAGAAGTTA",0,19,6,4,8,37,584
"TGGAGGAGTACAAACA",1,7,2,0,0,10,109
"TGGAGGAGTTGTCCCT",3,18,3,2,2,28,410
"TGGATCAAGTCTACCA",1,17,4,0,2,24,457
"TGGATCAGTTACACTG",94,1045,193,54,161,1547,80030
"TGGATCAGTTGCGAAG",0,0,0,0,0,0,49
"TGGATCATCGAATGCT",5,6,2,0,0,13,162
"TGGATGTAGAGGTCGT",0,2,0,0,0,2,77
"TGGATGTAGGATGCGT",155,432,280,1046,241,2154,100848
"TGGATGTAGGTGCTGA",5,36,7,0,8,56,1136
"TGGATGTCAAGTTCCA",1,7,2,0,2,12,195
"TGGATGTCAGTAACGG",0,0,0,0,0,0,105
"TGGATGTGTGTTTACG",4,26,5,3,3,41,793
"TGGATGTGTTACCCAA",49,126,171,23,234,603,31188
"TGGATGTTCAACTGAC",4,14,0,0,6,24,568
"TGGATGTTCGCCTCTA",1,3,2,0,0,6,168
"TGGCGTGAGGTGCAGT",0,18,4,2,3,27,475
"TGGCGTGAGTACCATC",0,0,0,0,0,0,46
"TGGCGTGAGTAGCATA",1,9,0,0,2,12,102
"TGGCGTGAGTCCCAGC",2,18,9,0,3,32,207
"TGGCGTGAGTGTTGAA",1,11,2,0,2,16,778
"TGGCGTGCAAGATGGC",2,3,0,0,0,5,92
"TGGCGTGCAATGGCAG",3,7,5,3,3,21,581
"TGGCGTGGTCACAGAG",0,2,0,0,0,2,24
"TGGCGTGGTGATGTAA",5,25,20,2,8,60,1789
"TGGCGTGGTGCATTAC",10,37,17,5,72,141,6299
"TGGCGTGTCTTACCAT",0,16,5,0,5,26,518
"TGGGAAGCAACTCGAT",0,0,0,0,0,0,6
"TGGGAAGCACATATCG",0,7,0,0,2,9,122
"TGGGAAGCAGTGAGCA",0,6,2,0,4,12,180
"TGGGAAGGTCCACTCT",59,249,64,23,59,454,18203
"TGGGAAGGTCGAGTGA",2,11,6,0,0,19,154
"TGGGAAGGTTTAGACC",0,5,3,0,8,16,659
"TGGGAAGTCACATACG",8,122,19,7,24,180,9985
"TGGGAAGTCATGGCCG",12,37,68,5,17,139,4558
"TGGGAAGTCCTATTGT",0,9,0,0,0,9,189
"TGGGAAGTCGGCATCG",0,10,3,0,0,13,260
"TGGGAGAAGAACGCGT",3,19,0,2,2,26,390
"TGGGAGAAGATTGAGT",2,15,10,3,10,40,782
"TGGGAGACAATACGCT",2,5,3,0,0,10,154
"TGGGAGACAATCTCGA",0,3,3,0,0,6,94
"TGGGAGACAATTGGTC",4,26,3,2,6,41,505
"TGGGAGACACCAGCCA",0,8,2,0,0,10,87
"TGGGAGACATCTCGTC",0,2,0,0,0,2,9
"TGGGAGAGTGGTCCGT",159,393,926,77,470,2025,105793
"TGGGAGATCAAGTTGC",0,11,3,0,0,14,98
"TGGGAGATCCGAAGGA",18,68,124,10,72,292,14070
"TGGGAGATCCGAGCTG",2,12,2,0,3,19,97
"TGGGAGATCGTCGGGT",0,0,0,0,0,0,16
"TGGGATTAGCGTCAGA",0,3,0,0,0,3,35
"TGGGATTCAGGACAGT",0,4,2,0,4,10,213
"TGGGATTCATATGCGT",2,14,2,0,4,22,579
"TGGGATTGTGGCATCC",0,6,0,0,2,8,130
"TGGGATTGTGTGCCTG",1,2,0,0,0,3,13
"TGGGATTGTTAGGAGC",0,0,0,0,0,0,21
"TGGGATTGTTCGGACC",0,8,0,0,2,10,144
"TGGGATTTCCATCTCG",0,6,0,0,0,6,209
"TGGGCGTAGAAAGTCT",1,4,0,0,0,5,12
"TGGGCGTAGCGTTCAT",20,59,104,8,52,243,9916
"TGGGCGTCACGAAGAC",0,0,0,0,0,0,5
"TGGGCGTCAGGGAATC",2,41,10,0,10,63,2503
"TGGGCGTCATCTAACG",2,8,2,0,0,12,144
"TGGGCGTGTCACATTG",0,0,0,0,0,0,32
"TGGGCGTTCCTTATCA",0,3,0,0,2,5,188
"TGGGCGTTCTCCAAGA",1,3,2,0,0,6,81
"TGGGCGTTCTTCCGTG",8,5,0,0,0,13,534
"TGGGCTGAGCTGAAGC",91,315,76,22,61,565,22303
"TGGGCTGAGGCCCAAA",1,10,2,0,2,15,152
"TGGGCTGCAAAGGATT",2,6,2,0,0,10,131
"TGGGCTGGTCCAGCGT",1,18,2,0,2,23,507
"TGGGCTGGTGACATCT",0,3,0,0,0,3,105
"TGGGCTGGTGTCTAAC",0,2,0,0,0,2,5
"TGGGCTGTCAAGAGTA",2,3,0,0,0,5,74
"TGGGTTAAGACAACAT",0,0,0,0,0,0,5
"TGGGTTACAGAATGTA",0,2,2,0,0,4,79
"TGGGTTACAGGAGACT",1,6,0,0,3,10,760
"TGGGTTAGTCAGCGTC",1,4,0,0,0,5,445
"TGGGTTAGTCGCGTTG",2,6,2,2,3,15,328
"TGGGTTAGTGCCGAAA",0,9,2,0,3,14,225
"TGGGTTAGTTTACTTC",2,27,4,2,5,40,797
"TGGGTTATCTTACTGT",8,39,9,2,5,63,1322
"TGGTACAAGCGCCGTT",1,0,0,0,0,1,61
"TGGTACACACGCTGCA",12,44,24,6,95,181,8617
"TGGTACACACGGGTAA",29,189,47,13,32,310,13879
"TGGTACACAGGTGTTT",4,18,4,0,3,29,425
"TGGTACACATTGCCGG",0,9,0,0,2,11,124
"TGGTACAGTACTCCGG",1,2,4,0,0,7,230
"TGGTACAGTTCGAGCC",8,27,17,0,6,58,1330
"TGGTACATCAGAGCAG",1,2,0,0,0,3,55
"TGGTACATCTGGTTGA",9,10,3,0,7,29,1008
"TGGTACATCTTCGATT",13,85,38,6,22,164,7270
"TGGTAGTAGACTGTTC",14,52,17,5,65,153,5673
"TGGTAGTAGCTATCTG",0,4,0,0,0,4,99
"TGGTAGTCAGCCTTCT",1,7,2,0,0,10,144
"TGGTGATAGCATTTCG",2,5,0,0,3,10,234
"TGGTGATCACGCGGTT",4,24,5,0,4,37,1738
"TGGTGATGTGAACTAA",0,5,0,0,0,5,204
"TGGTGATGTTCCCACT",4,24,3,0,6,37,772
"TGGTGATTCATCGCTC",0,0,3,0,0,3,42
"TGGTGATTCTCATGCC",0,8,4,0,0,12,437
"TGGTTAGAGACTTCAC",3,26,10,0,4,43,1608
"TGGTTAGAGAGTTGCG",0,10,0,0,2,12,63
"TGGTTAGGTTAAGAAC",1,7,4,0,0,12,138
"TGGTTAGTCCCAAGCG",0,3,3,0,0,6,133
"TGGTTAGTCGCTTGCT",1,8,0,0,0,9,159
"TGTAACGAGAATTGCA",0,4,0,0,0,4,23
"TGTAACGAGGATTACA",1,10,5,0,0,16,99
"TGTAACGAGTTAGTAG",1,3,0,0,0,4,63
"TGTAACGCACCTATCC",0,0,0,0,0,0,8
"TGTAACGGTGCATCTA",2,15,4,0,4,25,688
"TGTAACGTCATTACTC",0,4,0,0,0,4,105
"TGTAACGTCTGAATCG",0,0,2,0,0,2,11
"TGTAAGCCAAAGGATT",6,40,55,3,15,119,5347
"TGTAAGCCAAGATGGC",0,2,0,0,0,2,78
"TGTAAGCCATGTAACC",4,12,4,0,4,24,575
"TGTAAGCGTACGTGTT",0,2,0,0,2,4,89
"TGTAAGCTCAGACTGT",0,4,0,0,0,4,13
"TGTAAGCTCCCGAGAC",31,105,126,15,176,453,19287
"TGTAAGCTCCTATGGA",148,1146,276,81,266,1917,105171
"TGTAAGCTCTCATTGT",0,2,0,0,2,4,93
"TGTACAGAGCGTTAGG",26,158,30,8,29,251,11072
"TGTACAGCACAGCATT",0,4,0,0,0,4,109
"TGTACAGGTGGTTCTA",1,16,2,3,3,25,502
"TGTACAGGTTTCTATC",0,2,0,0,2,4,68
"TGTACAGTCAACCGAT",1,4,0,0,0,5,63
"TGTACAGTCGTGTTCC",28,102,481,15,45,671,13670
"TGTAGACCAAATGGTA",0,2,0,0,0,2,55
"TGTAGACGTCCTCATC",48,396,94,29,78,645,34209
"TGTAGACGTTTCAGAC",3,14,2,0,2,21,746
"TGTAGACTCCATAAGC",74,200,290,46,385,995,47352
"TGTCAGAAGGGTCAAC",2,6,2,0,0,10,69
"TGTCAGAAGTGGGAAA",19,145,36,10,23,233,11759
"TGTCAGACAACAACAA",0,3,4,0,0,7,119
"TGTCAGACACTAGTAC",9,51,81,8,15,164,6855
"TGTCAGATCCCGGTAG",0,5,0,0,0,5,105
"TGTCAGATCTGCACCT",1,5,0,0,0,6,222
"TGTCCACAGTCCTACA",0,0,0,0,0,0,10
"TGTCCACAGTCCTGTA",12,48,80,5,16,161,5999
"TGTCCACAGTGTTCCA",1,13,0,0,4,18,363
"TGTCCCAAGACTAAGT",1,4,0,0,2,7,156
"TGTCCCAAGCAGGTCA",0,0,0,0,0,0,22
"TGTCCCAAGCTCATAC",0,0,0,0,0,0,61
"TGTCCCAAGGAAAGGT",1,0,0,0,0,1,123
"TGTCCCACAAGGAGTC",1,3,0,0,0,4,65
"TGTCCCAGTAGTCTGT",2,9,3,0,0,14,440
"TGTCCCATCGAAACAA",0,0,0,0,0,0,79
"TGTCCCATCTAGAGCT",168,152,44,13,43,420,20868
"TGTCCTGAGACCTTTG",33,41,12,3,13,102,3704
"TGTCCTGCACTGTTCC",1,17,7,0,0,25,521
"TGTCCTGCATGACTCA",1,3,0,0,2,6,65
"TGTCCTGGTGGTGATG",7,22,9,0,5,43,817
"TGTCCTGTCCACGGGT",0,4,0,0,3,7,64
"TGTCCTGTCGATTTCT",2,24,5,0,3,34,810
"TGTCCTGTCTAATTCC",0,10,2,0,3,15,170
"TGTGAGTAGACTTCAC",0,2,0,0,0,2,257
"TGTGAGTAGAGTTGAT",1,0,0,0,0,1,58
"TGTGAGTGTAGAATGT",0,2,0,0,0,2,10
"TGTGAGTGTCGAGTGA",5,14,4,0,8,31,583
"TGTGAGTGTTATGACC",2,5,0,0,0,7,232
"TGTGAGTTCTGTCAGA",0,2,0,0,0,2,13
"TGTGATGAGCGACATG",34,100,94,19,151,398,17416
"TGTGATGAGTGGCGAT",0,6,0,0,0,6,54
"TGTGATGCAAGCGCTC",1,19,8,0,6,34,534
"TGTGATGCACTGAATC",7,49,92,5,21,174,7218
"TGTGATGGTTCCACGG",0,3,0,0,0,3,73
"TGTGCGGAGCTGGCCT",0,2,0,0,0,2,86
"TGTGCGGAGTCTCCTC",3,15,7,0,3,28,418
"TGTGCGGCAAAGGCGT",32,96,183,11,35,357,20539
"TGTGCGGCAAGTGACG",8,30,49,5,15,107,5240
"TGTGCGGCATGAGAAT",0,5,0,0,0,5,191
"TGTGCGGGTGGATCGA",0,0,2,0,0,2,133
"TGTGCGGTCAGGGATG",2,8,0,0,0,10,212
"TGTGGCGAGACGACGT",1,24,5,0,6,36,653
"TGTGGCGCACGCGGTT",1,14,3,0,0,18,417
"TGTGGCGGTATCGGTT",3,26,6,0,0,35,748
"TGTGGCGGTGACGTCC",2,3,0,0,0,5,194
"TGTGGCGGTTGAGGAC",0,3,2,0,0,5,103
"TGTGGCGTCTGTTCAT",2,10,0,0,2,14,195
"TGTGGCGTCTTCACGC",4,19,10,3,6,42,913
"TGTGTGACAAAGCACG",0,5,4,0,4,13,76
"TGTGTGACACAGACGA",0,12,2,0,0,14,282
"TGTGTGACATAGCTGT",3,4,3,0,4,14,122
"TGTGTGAGTAGTCACT",1,2,0,0,0,3,181
"TGTTACTAGCGCATCC",5,51,10,2,9,77,3346
"TGTTACTAGTTGCCTA",1,10,2,2,0,15,257
"TGTTACTCATGAATAG",0,7,2,0,0,9,112
"TGTTACTGTATGCTTG",0,10,2,0,0,12,155
"TGTTACTGTCCAGAAG",1,21,6,0,6,34,508
"TGTTACTGTCCATACA",4,30,7,0,9,50,872
"TGTTACTGTGGTAATA",5,33,22,2,10,72,1742
"TGTTACTGTTCTTAGG",1,3,0,0,0,4,695
"TGTTACTTCCGTGACG",0,6,3,0,2,11,124
"TGTTACTTCCTCACGT",1,7,0,0,3,11,102
"TGTTCATAGCTAGTTC",1,6,0,0,0,7,51
"TGTTCATAGTAAGCAT",0,11,0,0,0,11,115
"TGTTCATCAGCCGGTT",0,6,2,0,2,10,206
"TGTTCATCAGGAGGTT",4,33,6,2,5,50,445
"TGTTCATCATTCTTCA",7,18,7,0,3,35,682
"TGTTCATGTAGGAAAG",21,78,105,8,35,247,8936
"TGTTCATGTATACCCA",18,70,92,10,39,229,9146
"TGTTCATGTGAAGCGT",1,2,0,0,0,3,10
"TGTTCATGTTAGGAGC",2,19,7,2,6,36,168
"TGTTCATGTTGTATGC",4,8,8,3,4,27,1766
"TGTTCATTCAGAGCAG",0,5,0,0,0,5,173
"TGTTCATTCGAAACAA",0,0,0,0,0,0,6
"TGTTCCGAGAGGTCGT",1,4,2,0,2,9,161
"TGTTCCGAGCAGCGAT",21,132,34,6,30,223,12139
"TGTTCCGAGGGAGTGG",3,21,5,5,3,37,1268
"TGTTCCGAGTGCGCTC",3,16,10,2,5,36,575
"TGTTCCGCAATTGGTC",0,5,0,0,0,5,149
"TGTTCCGCAGCTACAT",1,10,4,0,0,15,148
"TGTTCCGCATACATCG",2,24,6,0,3,35,815
"TGTTCCGCATCAACCA",0,5,3,0,0,8,243
"TGTTCCGGTCCCTGTT",0,4,0,0,0,4,123
"TGTTCCGTCAAATGAG",9,61,16,3,13,102,2926
"TGTTCTAAGCATAGGC",5,35,12,5,28,85,2354
"TGTTCTAGTAGACGTG",1,12,6,0,5,24,380
"TGTTCTAGTCGATTAC",1,6,6,0,2,15,395
"TGTTCTAGTCGTTCAA",2,10,3,0,7,22,394
"TGTTCTAGTCTGCCTT",1,2,0,0,0,3,34
"TGTTCTAGTTGGGTTT",0,10,4,0,2,16,368
"TGTTCTATCATTACGG",1,5,0,0,0,6,142
"TGTTCTATCTCACGAA",1,21,2,4,0,28,394
"TGTTCTATCTCGCCTA",33,118,233,18,51,453,23405
"TGTTGAGAGAAGTCTA",3,4,0,0,3,10,226
"TGTTGAGAGATACATG",2,5,0,0,2,9,69
"TGTTGAGAGTCACTCA",1,2,0,0,0,3,19
"TGTTGAGCATCTTTCA",0,2,0,0,8,10,390
"TGTTGAGCATGGGTCC",0,2,0,0,0,2,10
"TGTTGAGGTCTCAGAT",1,7,4,0,3,15,148
"TGTTGAGTCAATCCAG",0,4,0,0,0,4,7
"TGTTGAGTCCCAAGTA",10,41,54,6,11,122,5238
"TGTTGGAAGGAGTACC",2,12,8,0,5,27,499
"TGTTGGAAGTAGGTTA",8,21,15,2,8,54,2238
"TGTTGGATCATGCGGC",17,50,91,7,18,183,7632
"TGTTGGATCATTCACT",2,14,2,0,2,20,246
"TGTTGGATCTTTGCTA",0,2,2,0,0,4,42
"TGTTTGTAGTATAGGT",2,11,3,2,0,18,238
"TGTTTGTCACGGTGAA",1,23,4,2,2,32,348
"TGTTTGTCAGACTCTA",258,1866,440,148,386,3098,157842
"TGTTTGTCAGCTGTTA",13,63,116,8,18,218,11207
"TGTTTGTTCAGACCGC",6,21,14,3,50,94,4499
"TGTTTGTTCTACACAG",39,104,186,12,87,428,20165
"TTAATCCAGCGAGAAA",27,96,248,16,81,468,24505
"TTAATCCGTTAAGGAT",2,21,6,0,7,36,689
"TTAATCCTCGAAGGAC",0,2,0,0,3,5,44
"TTAATCCTCTATCACT",1,4,4,0,0,9,175
"TTACAGGCACGAAGAC",0,17,3,0,3,23,77
"TTACAGGCAGGCGTTC",1,2,0,0,0,3,141
"TTACAGGCATAGGTTC",8,38,8,2,8,64,782
"TTACAGGCATGCCGAC",4,22,20,2,7,55,1981
"TTACAGGGTATGTCAC",0,6,3,0,3,12,173
"TTACAGGGTATTCCTT",1,7,0,0,0,8,154
"TTACAGGGTCAGGAGT",1,4,2,0,0,7,190
"TTACAGGGTGAGATCG",2,3,0,0,2,7,259
"TTACAGGTCACCCATC",1,20,7,0,5,33,789
"TTACCATCATAAGATG",23,96,46,13,148,326,12345
"TTACCATCATCCGGCA",1,11,9,0,5,26,652
"TTACCATCATGTGACT",0,0,0,0,0,0,39
"TTACCATGTAGGCAAC",2,6,3,0,0,11,170
"TTACCATGTCGAACAG",5,61,13,3,10,92,2866
"TTACCATGTCTGTGAT",1,0,0,0,0,1,6
"TTACCATGTGCCTGCA",7,23,64,3,9,106,4866
"TTACCATTCAAACCTG",0,9,0,0,0,9,111
"TTACCATTCGGTAAGG",9,73,14,5,13,114,5033
"TTACCATTCGTCGCTT",2,12,4,0,0,18,545
"TTACCATTCTCCCTAG",0,4,2,0,0,6,182
"TTACCGCAGGATATGT",26,68,161,10,36,301,13110
"TTACCGCAGTACCATC",2,4,0,0,2,8,136
"TTACCGCAGTTAGTGA",1,6,2,0,0,9,129
"TTACCGCCAAAGGTTA",0,0,2,0,0,2,43
"TTACCGCCACAAAGTA",1,7,0,0,3,11,109
"TTACCGCCAGAACTCT",0,3,0,0,2,5,187
"TTACCGCCAGTAACAA",0,0,0,0,0,0,22
"TTACCGCCATATCTGG",0,4,0,0,0,4,49
"TTACCGCGTCCAATCA",1,6,0,0,0,7,381
"TTACCGCGTTCTCCTG",1,18,4,0,4,27,508
"TTACGCCAGAGTGTTA",11,89,21,2,17,140,4338
"TTACGCCAGGATTCAA",0,6,5,0,0,11,84
"TTACGCCAGGGTGGGA",18,177,35,15,32,277,13039
"TTACGCCTCAGACTGT",1,4,0,0,0,5,48
"TTACGCCTCCATTGGA",8,20,4,0,5,37,411
"TTACGTTAGTGCAGCA",1,17,4,0,8,30,626
"TTACGTTAGTTAGTAG",1,5,2,0,0,8,23
"TTACGTTGTGATGTAA",11,46,19,5,42,123,4717
"TTACGTTGTTGGTGTT",9,47,65,8,22,151,7809
"TTACGTTTCCATGCAA",0,0,0,0,0,0,8
"TTACGTTTCCGTATAG",1,12,6,0,2,21,212
"TTACTGTAGAGTCCGA",1,7,2,0,0,10,153
"TTACTGTAGAGTCTGG",0,8,3,0,0,11,123
"TTACTGTAGCTGTTAC",2,11,5,2,3,23,669
"TTACTGTAGGTGCTTT",0,3,2,0,3,8,154
"TTACTGTAGTACTCGT",2,6,0,0,0,8,180
"TTACTGTAGTGGCCTC",0,2,0,0,0,2,34
"TTACTGTCAACTGCCG",4,9,5,2,3,23,693
"TTACTGTCAATACCCA",0,2,0,0,3,5,303
"TTACTGTCACATCATG",2,48,3,0,5,58,939
"TTACTGTGTATAATGG",0,6,4,0,0,10,29
"TTACTGTGTCTACTGA",2,15,0,0,6,23,54
"TTACTGTTCGTGGGTC",0,8,0,0,0,8,95
"TTAGGCACATTAGGAA",0,0,0,0,0,0,169
"TTAGGCAGTCGCGTCA",0,3,0,2,0,5,12
"TTAGGCAGTCTCGCGA",2,13,0,0,3,18,100
"TTAGGCAGTGCATGAG",0,2,0,0,0,2,10
"TTAGGCAGTGGCTGCT",2,21,2,0,8,33,496
"TTAGGCATCACCTCTG",2,14,4,0,2,22,65
"TTAGGGTAGCAAGCCA",2,24,15,2,12,55,950
"TTAGGGTAGGTGCTTT",3,39,5,2,8,57,714
"TTAGGGTAGTCACGAG",0,0,0,0,0,0,19
"TTAGGGTAGTCTACCA",0,4,3,0,0,7,59
"TTAGGGTCATCGGAAG",2,10,6,0,2,20,205
"TTAGGGTCATTGAGGG",0,6,2,0,0,8,36
"TTAGGGTGTAGATCGG",2,3,0,0,2,7,58
"TTAGGGTGTGCGGATA",1,5,0,0,2,8,138
"TTAGGGTGTTCTCTAT",1,2,0,0,0,3,201
"TTAGGGTTCCAAGCCG",6,26,8,0,4,44,640
"TTAGTCTCAAGGATGC",4,23,6,0,3,36,283
"TTAGTCTCATGACTAC",0,5,2,0,0,7,101
"TTAGTCTGTCACCACG",7,49,28,3,92,179,6951
"TTAGTCTGTTGGGTTT",0,2,0,2,0,4,429
"TTATTGCGTAAGCTCT",0,3,0,0,0,3,90
"TTATTGCGTGGTAATA",0,2,2,0,0,4,120
"TTATTGCGTGTCCGGT",1,8,3,0,2,14,256
"TTATTGCTCAACCGAT",0,0,0,0,0,0,1
"TTATTGCTCGCGAAGA",14,88,22,9,17,150,8025
"TTCAATCAGTACTCGT",41,348,91,33,78,591,26494
"TTCAATCCAAGCTACT",0,8,0,0,0,8,86
"TTCAATCCAGAGGCAT",1,7,0,0,4,12,98
"TTCAATCGTAACCCTA",0,0,0,0,0,0,54
"TTCAATCGTCAGCTTA",2,6,2,0,0,10,209
"TTCAATCGTTTGACAC",0,18,6,0,4,28,696
"TTCAATCTCTCTAAGG",2,10,2,0,6,20,433
"TTCACCGGTAGGGAGG",0,0,0,0,0,0,15
"TTCACCGGTCTATGAC",255,1041,523,146,1837,3802,169837
"TTCACCGTCGTAGTCA",1,9,6,0,0,16,131
"TTCACGCAGCTTTGTG",23,204,51,16,40,334,17977
"TTCACGCCAGACGGAT",0,5,0,0,2,7,139
"TTCACGCCAGTCACGC",6,35,5,2,5,53,1216
"TTCACGCCATCTATCT",0,5,0,0,0,5,66
"TTCACGCGTCTAGGTT",0,2,0,0,0,2,50
"TTCAGGAAGGCTAGCA",0,9,0,0,0,9,168
"TTCAGGAAGGGTTAAT",2,31,12,3,7,55,793
"TTCAGGACAAAGGCAC",5,13,4,0,2,24,626
"TTCAGGACAGCTATAC",0,4,3,0,0,7,107
"TTCAGGACAGGCTATT",3,20,10,0,13,46,538
"TTCAGGAGTCATCAGT",2,18,6,0,4,30,1081
"TTCAGGAGTTGGTGTT",2,8,0,0,0,10,109
"TTCAGGATCACTTTGT",0,22,4,2,2,30,95
"TTCAGGATCGTCGACG",1,7,0,0,0,8,144
"TTCATGTAGAGGTATT",1,2,0,0,0,3,44
"TTCATGTCACTGTCCT",6,39,9,0,6,60,1921
"TTCATGTGTCAAGCGA",0,10,0,0,2,12,397
"TTCATGTGTTCCGGTG",2,7,0,0,0,9,15
"TTCATGTTCGTCGACG",1,0,0,0,0,1,33
"TTCATGTTCTATTGTC",0,11,2,0,0,13,205
"TTCATTGAGAAGAACG",0,5,0,0,0,5,17
"TTCATTGAGGCTGTAG",2,4,0,0,2,8,71
"TTCATTGAGTCCCAAT",3,31,27,2,5,68,2588
"TTCATTGCAGTCTACA",0,3,2,0,0,5,153
"TTCATTGCAGTGGTGA",0,16,5,0,2,23,402
"TTCATTGGTCAGTTTG",0,0,0,0,0,0,3
"TTCATTGGTTGGCTAT",0,6,0,0,0,6,109
"TTCATTGTCCGATCGG",0,2,0,0,0,2,55
"TTCCAATAGCACCGAA",44,176,69,20,229,538,24909
"TTCCAATAGCACTTTG",8,67,17,7,15,114,3870
"TTCCAATAGCAGTAAT",3,13,8,0,4,28,609
"TTCCAATAGCGGGTAT",0,0,0,0,0,0,12
"TTCCAATCAGCAGACA",2,11,4,0,0,17,618
"TTCCAATCAGCGTAGA",6,37,27,5,11,86,2840
"TTCCAATTCAAGAGTA",1,0,0,0,0,1,67
"TTCCACGAGCCTAGGA",1,3,0,0,0,4,64
"TTCCACGCAACGTATC",8,3,0,0,0,11,839
"TTCCACGCACCTTCCA",2,12,2,0,4,20,1010
"TTCCACGCAGCTTCGG",0,0,0,0,0,0,10
"TTCCACGGTTGTCAGT",0,0,2,0,0,2,54
"TTCCACGTCAAGCCAT",2,27,8,3,6,46,1080
"TTCCACGTCCATCCGT",0,6,0,0,0,6,168
"TTCCACGTCCTAAGTG",0,2,0,0,0,2,92
"TTCCGGTAGGCTCAAG",1,10,2,0,3,16,79
"TTCCGGTCATCGCTAA",0,23,4,3,4,34,639
"TTCCGGTGTGACCGAA",1,4,2,0,0,7,90
"TTCCGGTGTGCCTTTC",0,3,0,0,0,3,74
"TTCCGGTTCACCGGTG",9,79,22,5,18,133,5154
"TTCCGGTTCGGTAAGG",3,13,4,3,0,23,232
"TTCCGTGCATCCGAGC",0,0,0,0,0,0,0
"TTCCGTGTCTATCCAT",6,9,0,0,3,18,242
"TTCCGTGTCTTCTGTA",0,2,0,0,0,2,140
"TTCCTAAAGCGTATAA",24,66,120,16,74,300,15261
"TTCCTAAAGTGCCAGA",1,4,0,0,0,5,73
"TTCCTAACAAGCCCAC",0,2,3,0,0,5,131
"TTCCTAACATCGCCTT",5,24,9,0,5,43,986
"TTCCTAAGTCACTCTC",24,94,196,14,41,369,17429
"TTCCTAATCTAACACG",1,9,0,2,0,12,191
"TTCCTCTAGAGACAAG",4,21,7,0,6,38,503
"TTCCTCTCATCAGCTA",0,6,0,0,0,6,148
"TTCCTCTCATGTGGCC",2,7,5,0,0,14,447
"TTCCTCTTCGGTAGGA",1,0,0,0,0,1,5
"TTCCTCTTCTACGCGG",0,2,0,0,0,2,4
"TTCCTTCGTAGGCTCC",0,7,2,0,2,11,227
"TTCCTTCGTCGTTGGC",3,12,6,0,2,23,278
"TTCCTTCGTGCGTCGT",0,0,0,0,0,0,4
"TTCCTTCGTTGTTGCA",0,3,0,0,0,3,7
"TTCCTTCTCTGGTGGC",1,11,3,0,2,17,349
"TTCGATTAGCATCCTA",2,15,6,0,3,26,574
"TTCGATTAGCTCCACG",0,5,2,0,0,7,247
"TTCGATTAGTATTGCC",14,31,8,2,13,68,1704
"TTCGATTCAACATCGT",0,10,0,0,0,10,595
"TTCGATTCAATACCCA",34,184,45,18,46,327,15996
"TTCGATTCATACTGAC",24,189,48,11,30,302,13426
"TTCGATTTCATCCTGC",1,26,0,3,2,32,758
"TTCGATTTCGGTGAAG",0,7,2,0,0,9,87
"TTCGCTGAGGCTTAAA",0,2,3,0,0,5,102
"TTCGCTGCACAAACGG",1,4,0,0,0,5,129
"TTCGCTGCACGATAGG",65,564,94,28,98,849,48177
"TTCGCTGCAGGCTATT",19,63,49,12,147,290,14875
"TTCGCTGCATTCAGGT",2,6,0,0,0,8,141
"TTCGCTGGTAAGCTCT",0,2,0,0,0,2,147
"TTCGCTGGTCGAGATG",4,20,7,0,4,35,867
"TTCGCTGTCAGCTTGA",1,3,4,0,0,8,101
"TTCGCTGTCCAACTGA",4,21,10,2,3,40,878
"TTCGCTGTCTCGAACA",0,6,0,0,0,6,188
"TTCGGTCCAGCGACAA",6,45,71,5,11,138,6191
"TTCGGTCCAGGTGAGT",186,810,279,63,182,1520,74276
"TTCGGTCGTTTGGAGG",10,33,13,5,47,108,3162
"TTCGGTCTCAGTGCGC",0,8,0,0,0,8,88
"TTCGGTCTCGAGCTGC",12,165,34,6,29,246,12247
"TTCGGTCTCGATGGAG",90,476,112,28,106,812,37183
"TTCGGTCTCTTACCAT",1,24,10,0,11,46,1087
"TTCTAACAGAAGTCAT",1,4,0,0,0,5,25
"TTCTAACAGACATAGT",2,6,0,0,0,8,60
"TTCTAACAGACTTCGT",4,19,5,0,7,35,539
"TTCTAACCAAATCAGA",3,25,5,0,9,42,715
"TTCTAACCATCTCATT",14,90,23,54,19,200,5727
"TTCTAACGTAGCACGA",2,5,0,0,2,9,167
"TTCTAACGTCCGGTGT",0,7,2,0,4,13,180
"TTCTAACTCCAGCCTT",2,11,3,0,2,18,458
"TTCTAACTCCGTGTAA",1,17,2,0,4,24,186
"TTCTAACTCTCATTGT",3,30,6,2,2,43,1025
"TTCTAGTAGTATGAAC",1,11,2,0,4,18,186
"TTCTAGTCAACGTATC",3,21,3,0,7,34,816
"TTCTAGTGTCTTACTT",19,95,139,9,28,290,13342
"TTCTAGTGTGGTCTAT",1,20,5,0,4,30,585
"TTCTAGTTCAATGTCG",29,98,98,14,114,353,16180
"TTCTAGTTCAGGAAGC",0,6,0,0,2,8,75
"TTCTCTCAGCCACCGT",0,2,0,0,0,2,216
"TTCTCTCAGTCATGAA",2,26,7,0,5,40,1356
"TTCTCTCCATAGACTC",0,3,0,0,0,3,41
"TTCTCTCGTTCTCGTC",1,4,2,0,0,7,178
"TTCTCTCTCGGACTGC",0,3,0,0,2,5,116
"TTCTCTCTCTATTGTC",1,7,4,0,2,14,412
"TTCTGTAAGTATGCAA",3,25,9,0,4,41,1328
"TTCTGTACACGCGTCA",0,0,0,0,0,0,96
"TTCTGTACAGCTCCTT",0,7,0,0,0,7,164
"TTCTGTAGTATGTCAC",1,3,2,0,0,6,58
"TTCTGTAGTCATCTAG",0,0,0,0,0,0,5
"TTCTGTAGTTCAGGTT",2,29,12,0,7,50,1978
"TTCTGTATCTATTGTC",2,23,3,2,4,34,822
"TTCTGTATCTCCACTG",0,4,0,0,0,4,176
"TTCTTCCAGGAGACCT",2,20,3,0,3,28,626
"TTCTTCCAGGCCACCT",0,5,0,0,0,5,143
"TTCTTCCCAACGCATT",26,92,147,10,43,318,13762
"TTCTTCCGTAAGAACT",0,4,0,0,2,6,80
"TTCTTCCGTTCCTTGC",0,0,0,0,0,0,30
"TTCTTCCTCACCCTGT",2,7,3,0,0,12,172
"TTCTTCCTCATGCTAG",0,3,0,0,0,3,77
"TTCTTCCTCCAATCTT",12,73,71,8,66,230,10457
"TTCTTCCTCTCTCTAA",1,5,0,0,0,6,130
"TTCTTGAAGATGCTGG",2,3,2,0,3,10,104
"TTCTTGAAGGATTTGA",3,17,4,0,4,28,1903
"TTCTTGACAAGCGCAA",1,8,2,0,7,18,49
"TTCTTGACAAGTACCT",0,8,0,0,3,11,351
"TTCTTGACACAGTGTT",2,19,6,0,3,30,530
"TTCTTGAGTAACACCT",17,44,12,2,13,88,4137
"TTCTTGAGTAATACCC",0,9,2,0,0,11,210
"TTCTTGAGTCCCTGTT",6,22,6,0,4,38,897
"TTCTTGAGTCGGCCTA",2,20,8,0,6,36,831
"TTCTTGATCAAACGTC",13,52,32,8,87,192,6681
"TTCTTGATCATGCTAG",0,0,0,0,0,0,51
"TTCTTGATCTGACAGT",3,22,5,3,4,37,690
"TTGAACGAGATAGCAT",6,18,8,3,6,41,812
"TTGAACGAGTAGCTCT",3,4,4,0,0,11,158
"TTGAACGAGTGCACAG",1,35,6,0,4,46,522
"TTGAACGCAACCAGAG",8,6,0,0,4,18,632
"TTGAACGCAACGTAAA",1,4,2,2,3,12,146
"TTGAACGCAGTACTAC",0,2,0,0,0,2,91
"TTGAACGGTACATACC",0,2,0,0,0,2,38
"TTGAACGGTCGTTCAA",1,3,0,0,0,4,183
"TTGAACGGTGTTACTG",0,8,0,0,2,10,157
"TTGAACGTCCACGTGG",0,6,4,0,3,13,241
"TTGACCCAGAATGTTG",0,0,0,0,0,0,5
"TTGACCCAGCGCCTAC",0,0,0,0,0,0,7
"TTGACCCAGTTTCGAC",0,5,0,0,0,5,160
"TTGACCCCAAAGACGC",2,32,8,2,7,51,2390
"TTGACCCCAAAGCTAA",0,6,0,0,0,6,125
"TTGACCCGTAGGTAGC",0,4,0,0,2,6,145
"TTGACCCGTCAAAGCG",8,65,14,4,16,107,3947
"TTGACCCTCACGGACC",0,4,0,0,2,6,128
"TTGACCCTCGTCTAAG",1,0,0,0,0,1,9
"TTGACCCTCTCACGAA",0,10,2,0,0,12,316
"TTGACCCTCTGCCTGT",0,4,2,0,0,6,158
"TTGAGTGGTGAATAAC",3,20,8,4,5,40,1351
"TTGAGTGGTGAGATAT",2,20,6,0,2,30,555
"TTGAGTGGTGCTCTTC",0,3,0,0,5,8,187
"TTGAGTGGTGGGCTCT",1,8,2,0,0,11,363
"TTGAGTGTCGCGCCAA",2,14,6,0,10,32,642
"TTGATGGAGGAACGCT",64,228,271,35,95,693,36691
"TTGATGGAGGGTGAGG",1,0,0,0,0,1,76
"TTGATGGCAAGATGGC",0,8,2,0,0,10,75
"TTGATGGCACCGGCTA",0,0,0,0,0,0,12
"TTGATGGCACTAACGT",0,0,0,0,0,0,31
"TTGATGGCAGACCCGT",0,0,0,0,0,0,17
"TTGATGGTCAGGACAG",4,22,4,0,6,36,236
"TTGATGGTCATTGCGA",0,5,0,0,0,5,175
"TTGATGGTCCTAACAG",0,0,0,0,0,0,69
"TTGCATTTCAGCTGAT",6,12,8,0,6,32,1560
"TTGCCTGAGATGCCGA",0,5,0,0,0,5,201
"TTGCCTGAGGTCGTGA",1,11,5,0,4,21,25
"TTGCCTGAGTGGTGGT",2,28,6,2,5,43,909
"TTGCCTGGTAGGGTAC",0,4,0,0,0,4,63
"TTGCCTGTCAGGAAAT",0,0,0,0,0,0,32
"TTGCCTGTCTTCGTAT",0,3,0,0,0,3,81
"TTGCCTGTCTTGCGCT",0,5,2,0,0,7,207
"TTGCGTCCAATCCAGT",0,2,0,0,0,2,18
"TTGCGTCCACATACGT",8,40,57,3,13,121,3917
"TTGCGTCTCAATGCAC",1,22,21,2,8,54,2268
"TTGCGTCTCATCAGTG",6,37,9,2,9,63,2940
"TTGCTGCAGAAGGCTC",1,21,6,0,12,40,1176
"TTGCTGCAGAGTCAAT",2,5,2,0,0,9,47
"TTGCTGCAGGCATCGA",0,4,0,0,0,4,96
"TTGCTGCAGGCGATAC",5,15,6,0,2,28,726
"TTGCTGCAGTGGACTG",2,7,4,0,2,15,550
"TTGCTGCGTACCTAGT",0,0,0,0,0,0,11
"TTGCTGCGTAGGTACG",0,6,0,0,0,6,128
"TTGCTGCGTCACGCTG",1,4,0,0,0,5,45
"TTGCTGCGTCGAGCAA",25,225,66,11,49,376,9090
"TTGCTGCGTGTTCGAT",3,25,8,3,22,61,2113
"TTGCTGCGTTTAGTCG",13,50,21,0,35,119,5390
"TTGCTGCTCACGGAGA",12,50,142,6,32,242,10373
"TTGCTGCTCATCGTAG",0,8,0,0,0,8,181
"TTGCTGCTCCATACTT",0,3,4,0,2,9,194
"TTGCTGCTCGCAGTGC",1,4,2,0,0,7,108
"TTGGATGGTAGACGTG",0,0,0,0,0,0,3
"TTGGATGGTCGTGTTA",3,11,0,0,0,14,224
"TTGGATGTCAAGCGTT",3,18,7,0,0,28,1252
"TTGGATGTCGGACAAG",0,0,0,0,0,0,13
"TTGGATGTCGTCGACG",0,4,2,0,0,6,33
"TTGGATGTCTTACCAT",2,0,0,0,0,2,18
"TTGGGATAGCGTATGG",3,28,9,4,11,55,567
"TTGGGATAGGGACACT",2,13,2,0,0,17,23
"TTGGGATCACACGGAA",1,4,0,0,2,7,144
"TTGGGATCATGGCCAC",21,142,60,5,31,259,10457
"TTGGGATCATGGCGCT",3,23,3,3,8,40,731
"TTGGGATGTAGGAGGG",372,171,112,26,85,766,31282
"TTGGGATGTCACTACA",2,9,5,0,0,16,58
"TTGGGCGAGATGGTAT",36,252,72,17,74,451,18999
"TTGGGCGAGCAGCAGT",25,100,52,19,216,412,14574
"TTGGGCGAGGTCCTGC",0,0,0,0,0,0,1
"TTGGGCGAGTCAACAA",0,3,0,0,0,3,100
"TTGGGCGCAAATACAG",0,2,4,0,2,8,65
"TTGGGCGCAAGGAGTC",0,27,6,0,2,35,889
"TTGGGCGCAGACCAAG",3,28,2,4,8,45,554
"TTGGGCGGTATCGTAC",2,16,5,2,3,28,450
"TTGGGCGTCAATCCAG",2,21,8,0,4,35,480
"TTGGGCGTCAGGACGA",1,4,0,0,3,8,102
"TTGGGCGTCATGGGAG",4,21,10,0,7,42,431
"TTGGGTAAGCTAAACA",16,94,30,12,28,180,4758
"TTGGGTACACATCATG",0,0,0,0,0,0,31
"TTGGGTAGTAGAGACC",0,0,0,0,0,0,3
"TTGGGTAGTCGAGCAA",0,7,0,0,0,7,205
"TTGGGTAGTCGGAAAC",0,17,2,0,4,23,470
"TTGGGTAGTGATCGTT",58,340,76,31,70,575,30187
"TTGGTTTAGTTCTACG",1,2,0,0,2,5,123
"TTGGTTTCAACCACGC",2,29,4,0,4,39,644
"TTGGTTTCATAGTCGT",1,5,0,0,0,6,185
"TTGGTTTGTACAGTAA",4,12,6,0,3,25,571
"TTGGTTTGTCTGTGTA",1,4,0,0,0,5,166
"TTGGTTTGTGTACATC",0,0,0,0,0,0,33
"TTGGTTTTCGAAACAA",1,5,3,0,2,11,38
"TTGTGGAAGCAGAAAG",0,23,5,2,4,34,468
"TTGTGGAAGGCTGAAC",1,9,0,3,0,13,255
"TTGTGGAAGTTTGTCG",6,49,8,2,7,72,1372
"TTGTGGACAGGATGAC",20,46,97,8,26,197,9197
"TTGTGGAGTCGCTGCA",10,41,3,0,4,58,1422
"TTGTGGAGTTGGACTT",0,0,0,0,0,0,9
"TTGTGGATCTCGGGAC",0,14,2,0,0,16,291
"TTGTGTTAGAGGTCAC",0,2,0,0,0,2,44
"TTGTGTTAGTCTCGTA",39,144,299,22,70,574,30458
"TTGTGTTCAAGAGTAT",0,8,3,0,0,11,186
"TTGTGTTCAATCTCTT",1,19,7,0,3,30,363
"TTGTGTTCACTGCACG",3,27,10,0,13,53,1440
"TTGTGTTGTCCAATCA",79,605,136,40,114,974,50070
"TTGTGTTGTTAGAGAT",3,11,7,0,3,24,466
"TTGTTCAAGATACAGT",0,5,0,0,0,5,255
"TTGTTCAAGCAAGGAA",1,14,3,0,4,22,501
"TTGTTCACAAGTTTGC",1,23,5,0,3,32,480
"TTGTTCAGTCACGTGC",1,18,5,0,2,26,266
"TTGTTCAGTCTTGCTC",8,72,16,7,8,111,3731
"TTGTTCATCTACCACC",0,0,0,0,0,0,30
"TTGTTGTAGACCTCCG",42,132,318,17,60,569,25293
"TTGTTGTAGATAACAC",34,44,17,6,58,159,5434
"TTGTTGTAGCGACCCT",1,2,0,0,0,3,20
"TTGTTGTAGGGTCTTT",0,6,0,0,3,9,172
"TTGTTGTAGTTGCCTA",0,0,0,0,0,0,35
"TTGTTGTCAGTCGCTG",4,16,3,0,3,26,554
"TTGTTGTGTAACTAAG",0,7,3,0,5,15,177
"TTGTTGTGTCTACGTA",1,13,0,0,0,14,379
"TTGTTGTGTGCGAGTA",0,3,0,0,0,3,46
"TTGTTGTTCGAGTTGT",2,4,0,0,0,6,167
"TTGTTGTTCTCATTTG",47,195,267,32,74,615,33517
"TTGTTTGAGATTACCC",0,5,0,0,0,5,124
"TTGTTTGAGCGCCTCA",3,10,0,0,3,16,645
"TTGTTTGAGGGCAACT",0,18,5,3,4,30,544
"TTGTTTGAGTCATCCA",2,4,3,0,0,9,181
"TTGTTTGCACCTCTAC",0,4,3,0,0,7,200
"TTGTTTGCACTAGAGG",1,4,0,0,0,5,17
"TTGTTTGCAGTTGCGC",3,14,4,0,3,24,415
"TTGTTTGGTCAGACTT",0,3,0,0,0,3,52
"TTGTTTGGTCCACATA",0,5,0,0,2,7,209
"TTGTTTGTCTTCGGTC",1,5,0,0,0,6,248
"TTTACCACATAAGCAA",0,3,0,0,0,3,66
"TTTACCACATTCACCC",0,8,0,0,0,8,262
"TTTACCAGTGGCGTAA",7,29,6,2,5,49,779
"TTTACCATCTGTGCAA",2,5,0,0,0,7,161
"TTTACGTAGGTACCTT",3,8,6,0,0,17,415
"TTTACGTCACTGATTG",0,6,2,0,2,10,41
"TTTACGTCAGAAGTGC",0,2,2,0,0,4,77
"TTTACGTGTCTGCGCA",0,2,0,0,0,2,16
"TTTACGTTCGACGCTG",0,5,0,0,0,5,158
"TTTACTGAGCCACCGT",18,119,31,10,27,205,10526
"TTTACTGAGTCACACT",0,5,3,2,3,13,229
"TTTACTGCAAACGTGG",2,12,5,0,2,21,472
"TTTACTGCAAGCGATG",1,4,0,0,0,5,144
"TTTACTGCACACTTAG",2,26,11,2,10,51,838
"TTTACTGCAGCTACAT",4,21,8,0,4,37,615
"TTTACTGCATCGTCCT",3,22,7,3,9,44,260
"TTTACTGGTCACTCTC",44,106,44,11,25,230,10748
"TTTACTGGTGCGTTTA",1,7,0,0,2,10,85
"TTTACTGTCAAGTAAG",5,42,14,0,12,73,2117
"TTTACTGTCTACACTT",0,18,0,0,3,21,322
"TTTAGTCAGAGTGGCT",0,0,0,0,0,0,74
"TTTAGTCCAAGAGTAT",2,12,0,0,2,16,167
"TTTAGTCCAATTCTTC",1,3,0,0,0,4,118
"TTTAGTCGTATTTCTC",3,8,4,0,0,15,123
"TTTAGTCTCCTTATAC",23,133,65,16,188,425,18352
"TTTATGCAGGGTTAAT",3,3,3,0,0,9,240
"TTTATGCAGTTCCATG",2,26,5,2,10,45,929
"TTTATGCCAGGACATG",4,37,5,3,9,58,2068
"TTTATGCCAGGTCAAG",4,17,8,0,3,32,667
"TTTATGCGTATTTCTC",0,5,0,0,2,7,15
"TTTATGCGTCAGACTT",1,3,0,0,0,4,82
"TTTATGCGTCCGGACT",0,4,0,0,0,4,40
"TTTCACACACGGAAGT",0,8,2,0,0,10,287
"TTTCACAGTCAGATTC",1,10,3,0,0,14,244
"TTTCACATCCGATAGT",2,6,2,0,2,12,151
"TTTCAGTAGGGCAATC",2,8,3,0,0,13,124
"TTTCAGTAGTAGCAAT",13,57,71,6,17,164,5478
"TTTCAGTCACGACCTG",0,4,2,0,2,8,355
"TTTCAGTCACTGCATA",8,45,12,0,3,68,1871
"TTTCAGTGTGGTCTCG",0,0,0,0,0,0,7
"TTTCAGTTCAAGTGGG",3,13,2,0,3,21,430
"TTTCAGTTCAGCCTCT",1,4,2,0,3,10,277
"TTTCAGTTCCTTGGAA",2,2,0,0,3,7,106
"TTTCAGTTCGTAGAGG",6,10,6,0,0,22,488
"TTTCATGAGGTCGAGT",3,28,5,2,6,44,570
"TTTCATGCACCAGCTG",0,2,0,0,0,2,91
"TTTCATGCAGCCTACG",0,4,2,0,2,8,96
"TTTCATGCAGTCCGTG",0,5,0,0,2,7,156
"TTTCATGGTCCAAGAG",0,12,0,0,0,12,322
"TTTCATGTCAAGCGTT",1,17,0,0,0,18,605
"TTTCCTCAGAGCATTA",3,22,3,0,4,32,1922
"TTTCCTCAGATGAATC",0,2,2,0,2,6,183
"TTTCCTCCAAATACGA",2,15,9,2,3,31,630
"TTTCCTCCACTGTTCC",0,5,2,0,0,7,159
"TTTCCTCCAGTTCCAA",3,18,7,2,2,32,994
"TTTCCTCCATGCAGCC",1,6,0,0,2,9,579
"TTTCCTCTCTGTCGCT",0,9,5,0,2,16,315
"TTTCGATAGATGCAGC",26,212,49,11,40,338,17218
"TTTCGATAGGTCATCT",1,9,0,2,4,16,226
"TTTCGATCAAATTGCC",31,215,96,14,55,411,18366
"TTTCGATCATAGCTGT",0,19,0,0,0,19,440
"TTTCGATCATGGGTCC",1,2,0,0,0,3,77
"TTTCGATCATTGTGCA",5,32,7,3,12,59,639
"TTTCGATGTACATTGC",0,0,0,0,0,0,1
"TTTCGATGTCCGGATC",0,5,0,0,0,5,140
"TTTCGATGTCTGTGGC",0,3,0,0,0,3,131
"TTTCGATGTGGTCTCG",1,4,0,0,0,5,108
"TTTCGATGTTTCGTGA",0,6,0,0,2,8,104
"TTTGACTAGTAGAATC",2,18,3,2,0,25,358
"TTTGACTCACCTGCGA",15,56,99,8,29,207,11272
"TTTGACTCACGAGAAC",1,4,2,0,2,9,199
"TTTGACTCATGGGATG",6,49,8,5,7,75,2142
"TTTGACTGTAGCTCGC",1,24,0,0,4,29,697
"TTTGACTGTCACTCGG",1,6,0,0,3,10,152
"TTTGACTGTGAGTAAT",0,0,0,0,0,0,4
"TTTGACTGTGGACTAG",0,0,0,0,0,0,13
"TTTGACTGTGGTCAAG",0,13,4,0,0,17,29
"TTTGACTTCCTAGCTC",6,96,21,7,14,144,8356
"TTTGATCAGAGCCCAA",2,22,17,0,7,48,1101
"TTTGATCAGCGGACAT",3,23,11,0,4,41,901
"TTTGATCAGTGGAATT",47,289,68,26,68,498,24810
"TTTGATCCACATGTTG",5,27,11,3,29,75,2610
"TTTGATCCACTTTAGG",9,41,54,5,14,123,4265
"TTTGATCGTATAGGGC",0,7,2,2,0,11,146
"TTTGATCGTATGGAGC",0,8,2,0,0,10,65
"TTTGATCGTCTGTGGC",0,4,2,0,0,6,58
"TTTGATCGTGAGGCAT",5,20,7,0,8,40,477
"TTTGATCGTTAGAAGT",282,1336,677,139,1210,3644,197329
"TTTGATCTCTAGTTCT",7,39,10,3,4,63,2467
"TTTGGAGCATTCGGGC",1,3,0,0,0,4,37
"TTTGGAGGTGTTTACG",62,227,70,24,103,486,29592
"TTTGGAGTCGTTCTAT",0,3,0,0,0,3,24
"TTTGGTTAGCGCTGCT",1,6,5,0,3,15,209
"TTTGGTTAGGACGGAG",1,21,7,0,0,29,399
"TTTGGTTCATCCGATA",0,17,2,0,0,19,383
"TTTGGTTGTAGGAGGG",28,211,60,16,44,359,16804
"TTTGGTTTCCAACCGG",1,33,11,0,14,59,1381
"TTTGGTTTCGCGTTTC",1,4,3,0,0,8,46
"TTTGGTTTCGCTCTCA",1,2,2,0,2,7,75
"TTTGTTGAGCGAGAAA",37,276,69,18,53,453,22447
"TTTGTTGAGTAGACCG",0,6,0,0,2,8,117
"TTTGTTGAGTATTAGG",3,28,6,3,4,44,752
"TTTGTTGCACTCTGCT",2,23,7,2,4,38,448
"TTTGTTGCATCGATAC",2,6,6,0,2,16,736
"TTTGTTGGTACGTGTT",5,18,6,2,26,57,2296
"TTTGTTGGTATCGGTT",22,91,16,4,19,152,6793
"TTTGTTGGTCCAAAGG",3,21,4,0,2,30,596
"TTTGTTGGTTAGGGTG",40,286,76,22,55,479,30209
"TTTGTTGTCAGGGATG",0,2,3,0,0,5,35
"TTTGTTGTCCACTAGA",0,3,0,0,0,3,37
"TTTGTTGTCCTTCACG",3,7,4,0,4,18,618
"TTTGTTGTCTCTCGAC",0,3,0,0,0,3,66
