"","Bar1","Bar2","Bar3","Bar4","Bar5","nUMI","nUMI_total"
"AAACCCAAGCGATGAC",338,77,49,6,18,488,32908
"AAACCCACAGTTGAAA",5,229,43,11,25,313,16669
"AAACCCATCGAGAATA",3,22,11,2,8,46,104
"AAAGAACCATACAGGG",39,187,61,4,19,310,16567
"AAAGAACGTTCCGGTG",14,197,45,8,16,280,10930
"AAAGGGCAGAATTCAG",2,9,7,0,0,18,508
"AAAGTCCAGCACGTCC",0,43,24,1,5,73,4823
"AAAGTGAAGCATGGGT",7,41,107,4,19,178,11759
"AAAGTGACAAGTTGGG",1,52,34,9,4,100,4102
"AAATGGAAGAAACTCA",5,80,47,7,217,356,24820
"AAATGGAGTATGTCAC",8,69,114,3,127,321,23158
"AACAAAGAGAAGCTGC",1,21,7,0,5,34,424
"AACAAAGAGACTAGAT",12,392,74,4,23,505,33850
"AACAAAGAGCGACTGA",5,51,42,1,6,105,4006
"AACAAGAGTAGAATAC",11,75,29,5,17,137,2906
"AACAAGATCGTCTCAC",3,31,12,2,8,56,1360
"AACACACAGGTGATCG",7,95,300,8,479,889,88934
"AACACACAGTAACAGT",12,90,95,3,30,230,12261
"AACACACGTACCCGCA",2,22,8,1,2,35,80
"AACACACGTAGCACAG",3,20,87,1,8,119,10068
"AACAGGGTCACCTCTG",8,58,32,6,18,122,2750
"AACCAACAGTTAGAAC",5,63,27,2,11,108,3397
"AACCAACGTTTGTGGT",3,63,28,4,275,373,33965
"AACCAACTCGACGCTG",3,88,249,4,20,364,27803
"AACCACAAGGTGCCAA",8,641,45,5,39,738,62329
"AACCACACATCTGTTT",28,72,27,7,13,147,5816
"AACCACATCGGAAACG",6,59,88,7,12,172,6790
"AACCACATCTCTTCAA",10,62,72,4,9,157,9591
"AACCATGGTCGCAACC",5,54,219,4,19,301,22413
"AACCTGAAGCGTGCCT",2,80,27,6,17,132,3688
"AACCTGAAGGATACGC",6,61,35,1,10,113,4166
"AACCTGAAGGCATCAG",6,125,86,7,15,239,12630
"AACCTGAGTTCTCTCG",7,73,50,5,15,150,4394
"AACCTTTGTTGGGAAC",4,71,56,6,17,154,8331
"AACCTTTTCCGTAATG",5,47,18,5,15,90,2423
"AACGAAAGTGTCCCTT",4,57,72,4,22,159,7215
"AACGTCAAGCTACGTT",22,92,24,1,10,149,6681
"AACGTCACAACAGTGG",10,65,65,2,11,153,4727
"AACGTCACACGTTGGC",5,59,16,1,9,90,2803
"AACGTCATCATGGTAC",6,47,50,3,19,125,6119
"AACGTCATCGTAACCA",7,65,159,6,16,253,21173
"AACTTCTTCCCGTGAG",0,5,6,0,1,12,44
"AACTTCTTCGGCATTA",178,68,33,5,21,305,22741
"AAGAACACAAGCTCTA",2,12,3,1,2,20,118
"AAGAACAGTGTTAACC",0,59,12,0,1,72,4066
"AAGACAAAGACGTCGA",0,2,3,0,0,5,31
"AAGACAAAGTGAATAC",0,10,4,0,2,16,35
"AAGACTCCAACCGCCA",4,70,34,5,11,124,3561
"AAGACTCGTACAGTTC",9,60,24,3,45,141,6009
"AAGACTCGTAGCACAG",8,68,33,3,7,119,7028
"AAGACTCGTTAAAGTG",6,65,229,0,21,321,18799
"AAGACTCTCTCTCTAA",14,563,100,3,21,701,61990
"AAGATAGTCGGTTGTA",17,182,31,1,10,241,12939
"AAGCCATAGACCTGGA",8,226,39,1,17,291,13104
"AAGCCATTCCTCATAT",0,8,7,3,0,18,734
"AAGCGAGAGGCGATAC",4,47,16,6,13,86,1672
"AAGCGAGAGTTCCATG",45,81,25,4,13,168,8214
"AAGCGAGCATGAATAG",16,58,89,5,17,185,12293
"AAGCGTTAGATCGACG",2,29,8,1,10,50,2262
"AAGCGTTGTCCAGAAG",8,66,28,6,130,238,16116
"AAGCGTTGTTCTTCAT",42,202,57,7,18,326,16358
"AAGCGTTTCCGCAGTG",3,14,12,1,7,37,655
"AAGTACCAGCGCTTCG",4,114,26,7,10,161,7872
"AAGTACCGTTTGTGGT",6,199,24,0,13,242,19545
"AAGTCGTAGTACAGAT",12,370,160,4,44,590,35853
"AAGTCGTGTTCTCGCT",1,344,29,2,13,389,25289
"AAGTCGTGTTGAGTCT",0,28,17,3,161,209,13563
"AAGTCGTTCCGCAGTG",1,39,21,1,12,74,1908
"AATAGAGAGAAATCCA",47,58,80,9,28,222,8737
"AATAGAGAGAAGCTCG",3,68,33,5,15,124,2950
"AATCACGCAGCTGCCA",8,60,38,1,13,120,5289
"AATCACGCATAGAGGC",5,63,21,4,11,104,2583
"AATCACGCATCCGGTG",1,9,7,0,0,17,241
"AATCGTGAGCGTGTTT",9,67,316,6,13,411,37259
"AATGAAGCAATGCTCA",6,58,29,5,86,184,11134
"AATGAAGCAGAACATA",4,89,57,6,20,176,4334
"AATGAAGCATCGCCTT",0,26,21,1,13,61,1779
"AATGAAGGTATTCCTT",5,92,22,3,181,303,21432
"AATGAAGGTCGACGCT",60,73,24,7,19,183,11607
"AATGACCAGTCATAGA",8,191,33,5,22,259,13557
"AATGACCCAAGTGGCA",8,61,18,2,13,102,1670
"AATGACCCAATGTGGG",6,237,54,3,15,315,22883
"AATGACCCAGTTACCA",10,530,26,2,22,590,40427
"AATGACCCATTGACTG",8,82,101,8,26,225,9097
"AATGACCTCACTCTTA",12,274,52,7,90,435,30083
"AATGCCAAGGTCTGGA",3,54,18,1,14,90,3277
"AATGGAACATACAGCT",5,93,53,4,39,194,7258
"AATGGAACATCGGCCA",2,39,14,1,7,63,1188
"AATGGCTAGCTGCCTG",9,69,30,3,14,125,5095
"AATTCCTGTTGAAGTA",13,83,46,4,195,341,28552
"ACAAAGACATGACAAA",1,60,34,1,15,111,3013
"ACAACCAAGACCACGA",8,58,35,6,37,144,4865
"ACAACCAGTTAGGCCC",1,25,7,0,6,39,1102
"ACAACCATCGACATTG",32,216,46,6,43,343,18045
"ACAACCATCGCCAGAC",5,114,40,8,13,180,6897
"ACAAGCTCAGTGGTGA",4,85,27,3,11,130,5579
"ACACAGTCAACACTAC",24,126,27,3,20,200,8700
"ACACAGTGTGTTCCTC",4,310,39,4,12,369,26369
"ACACCAACAGCTCTGG",3,104,33,1,12,153,10213
"ACACGCGAGATACGAT",14,374,47,46,22,503,31244
"ACACGCGAGATGCTAA",3,49,19,0,39,110,3689
"ACACGCGCACTAGTAC",84,51,22,2,14,173,11847
"ACACGCGCACTGAGGA",5,77,22,2,158,264,16124
"ACACGCGCATGACGTT",0,3,2,0,1,6,176
"ACACTGAAGCACCAGA",5,106,135,9,26,281,12506
"ACACTGAAGCCATTTG",0,16,8,0,3,27,103
"ACACTGAGTAGGTACG",5,69,42,1,96,213,14019
"ACACTGATCGCTGACG",9,218,28,4,14,273,12591
"ACAGAAAAGGTGAGCT",5,63,22,3,11,104,2362
"ACAGAAAGTCTCTCCA",4,18,7,1,4,34,99
"ACAGAAAGTGGCCCAT",2,76,25,3,12,118,5015
"ACAGCCGAGCCTGAGA",11,372,57,4,25,469,28575
"ACAGCCGTCATTTGCT",90,51,24,4,13,182,9741
"ACAGGGAAGAGTCTTC",6,46,22,3,12,89,1751
"ACAGGGAAGCTATCCA",3,219,42,7,16,287,19140
"ACAGGGAAGGAGAGGC",4,196,23,2,6,231,14871
"ACAGGGAAGTTACGAA",52,189,39,5,28,313,18137
"ACAGGGACATGACTTG",3,71,59,8,18,159,4904
"ACAGGGAGTTCGTGCG",5,47,33,5,62,152,6938
"ACAGGGATCGTGCATA",6,72,22,1,8,109,5886
"ACATGCATCGCCATAA",0,4,3,1,4,12,47
"ACATGCATCTCATTTG",3,38,14,6,17,78,2439
"ACATTTCCATATCTGG",4,23,14,0,6,47,1285
"ACATTTCTCGCTAAAC",55,190,53,482,33,813,58846
"ACCAAACAGTCGGGAT",20,141,27,6,14,208,14421
"ACCAAACGTACCGGAA",2,9,6,1,4,22,43
"ACCAAACGTCAGTCTA",1,28,13,6,11,59,2339
"ACCAAACGTTCCACGG",0,12,6,3,12,33,1921
"ACCAACAAGCGACTTT",9,137,31,2,10,189,9682
"ACCACAAAGATCACTC",1,10,26,0,3,40,1272
"ACCACAAGTACGCGTC",8,991,187,148,23,1357,111646
"ACCACAAGTTGGTGTT",5,542,52,5,16,620,63554
"ACCATTTAGCATGTTC",7,44,30,4,38,123,6627
"ACCATTTCAGTCTGGC",0,7,1,1,0,9,241
"ACCCAAACAACCCGCA",11,89,560,5,256,921,83018
"ACCCAAAGTCACAGAG",8,57,46,6,21,138,3188
"ACCCTCAGTCGGTGAA",8,444,44,8,21,525,39617
"ACCCTTGCAGTAGAGC",7,96,24,6,16,149,8048
"ACCCTTGGTACCCGAC",6,50,34,1,19,110,4856
"ACCCTTGGTGACGCCT",7,122,37,2,12,180,7800
"ACCGTTCAGAGCCCAA",3,85,11,1,4,104,8451
"ACCGTTCAGAGCGACT",4,116,36,4,39,199,15598
"ACCGTTCAGGTAAGAG",36,230,25,2,13,306,20493
"ACCGTTCTCTTGCAAG",0,28,14,3,5,50,2194
"ACCTACCCACACAGCC",5,54,19,1,10,89,2695
"ACCTACCTCCCAGGAC",0,12,11,2,6,31,481
"ACCTGAACACAAAGTA",12,1147,95,13,250,1517,147485
"ACCTGAAGTCTAACGT",4,20,7,2,2,35,221
"ACCTGAATCTGTCGTC",14,151,25,4,18,212,11376
"ACCTGTCAGTTCATGC",5,295,20,6,18,344,28418
"ACCTGTCCACGCTGAC",40,46,23,9,11,129,5649
"ACCTGTCTCGCCAACG",2,161,18,3,10,194,10839
"ACGATCAAGGTGGCTA",32,151,41,4,21,249,9351
"ACGATCAGTGGGATTG",9,422,30,3,14,478,43269
"ACGCACGGTCGATTCA",32,221,29,2,9,293,15114
"ACGGAAGTCAAGGACG",4,179,38,3,20,244,13064
"ACGGGTCCACTCCGGA",4,52,32,2,116,206,15892
"ACGGTCGAGGGAGATA",3,3,2,0,2,10,21
"ACGGTCGTCATCAGTG",3,199,25,1,13,241,17067
"ACGGTCGTCCGACAGC",3,51,189,6,12,261,21053
"ACGGTTAAGCACCTGC",7,75,17,3,11,113,5407
"ACGGTTATCTCTTAAC",4,36,10,3,4,57,256
"ACGTAACCAACACGTT",5,59,160,5,13,242,17728
"ACGTAACTCCCATTTA",2,17,6,0,5,30,107
"ACGTACACACGCAGTC",3,43,20,2,42,110,2548
"ACGTACACATTAAGCC",6,52,40,1,18,117,2014
"ACGTACAGTGACCGTC",1,25,8,0,13,47,1474
"ACGTAGTCATCCGGCA",6,62,22,4,9,103,2620
"ACGTAGTGTAAGGTCG",2,85,534,5,19,645,58520
"ACGTTCCAGATGCTGG",2,103,13,0,6,124,11188
"ACGTTCCTCGCTACAA",6,69,85,4,99,263,14840
"ACTACGACATTAAAGG",21,57,9,2,10,99,4834
"ACTATCTAGGTACATA",2,81,34,7,5,129,4943
"ACTATCTCACTATCGA",3,103,14,2,15,137,9112
"ACTATCTGTAACAAGT",15,136,47,6,472,676,58827
"ACTATGGTCCTGCTAC",3,17,9,1,2,32,1330
"ACTATTCAGCGATGCA",3,27,7,1,4,42,1324
"ACTATTCCATCATGAC",8,86,45,7,703,849,87081
"ACTATTCTCATGACAC",9,88,115,3,108,323,24648
"ACTCCCAAGGTCGTCC",8,42,18,3,10,81,1919
"ACTCCCAGTACGACAG",10,70,21,5,62,168,7914
"ACTCTCGAGATTGGGC",5,183,33,1,9,231,18820
"ACTCTCGAGGAGCTGT",6,826,54,4,35,925,74922
"ACTCTCGTCTTGATTC",2,62,17,1,9,91,3380
"ACTGATGCACGAGAAC",0,9,9,0,7,25,340
"ACTGATGCAGTGTGCC",3,24,10,0,3,40,743
"ACTGCAAAGTCTGCGC",1,42,15,4,11,73,166
"ACTGCAACAAACTCTG",10,81,42,2,23,158,379
"ACTGTCCCACGCTGTG",5,66,29,4,226,330,26411
"ACTGTGAAGCTCTTCC",7,68,159,4,20,258,20295
"ACTGTGAAGGTTTGAA",7,72,42,3,21,145,5098
"ACTTCCGAGCTATCTG",2,13,4,0,6,25,1692
"ACTTCCGCAAGCTGTT",4,210,28,1,17,260,20406
"ACTTCCGGTACAGTCT",3,69,13,2,6,93,2179
"ACTTCGCGTGGGCTTC",10,59,30,9,24,132,5905
"ACTTCGCTCTGAGGTT",2,14,12,1,2,31,598
"ACTTTCATCGAAGCCC",0,18,4,2,24,48,3115
"ACTTTGTAGCTGGCTC",9,53,14,0,14,90,1534
"ACTTTGTTCGGATTAC",6,49,29,1,9,94,3166
"AGAAATGCAATGAAAC",10,424,56,8,34,532,32309
"AGAAATGCACCCGTAG",4,249,19,3,11,286,24066
"AGAAATGCATGCCGGT",1,12,4,1,25,43,1812
"AGAAATGCATTCATCT",11,66,188,7,17,289,22543
"AGAAATGGTAACAAGT",38,83,33,4,15,173,5521
"AGAAATGTCCATGATG",2,47,119,2,23,193,11435
"AGAACAAGTTAAACAG",2,36,7,1,3,49,985
"AGAACCTAGAGCTGCA",1,65,67,4,68,205,11161
"AGAACCTAGGTTTACC",3,68,31,3,16,121,5183
"AGAACCTGTACATACC",3,24,116,4,4,151,12116
"AGAAGCGTCATGAGTC",1,110,26,1,57,195,8307
"AGAAGTATCAGAACCT",8,150,36,292,35,521,36489
"AGAAGTATCCGTGCGA",3,185,31,5,10,234,20449
"AGAAGTATCCTCTTTC",11,88,21,5,12,137,5494
"AGACAAACAATACCCA",38,357,100,4,26,525,38705
"AGACAAATCAAGCTGT",1,13,5,0,7,26,189
"AGACACTAGAGGTCAC",20,152,200,4,66,442,24624
"AGACACTAGCAATAGT",8,79,49,9,112,257,11046
"AGACACTGTGCCTTCT",7,84,703,11,23,828,84969
"AGACACTTCCAACCGG",3,60,22,2,7,94,4290
"AGACAGGGTTCGGCTG",5,43,36,2,12,98,3517
"AGACCATAGAAATGGG",1,10,9,0,8,28,77
"AGACCATCACCGGTCA",11,82,34,2,458,587,56963
"AGACCATCAGCATCTA",11,59,90,4,21,185,7248
"AGACCCGCAACTGATC",43,121,22,5,20,211,10494
"AGACTCAGTTAGAAAC",4,68,31,7,16,126,2368
"AGAGAATTCATTGAGC",12,71,44,5,179,311,22630
"AGAGAGCAGACGGATC",1,6,5,0,1,13,129
"AGAGCAGAGTCCCTAA",4,54,24,0,4,86,4908
"AGAGCAGCAGTAGAGC",6,61,51,5,151,274,21923
"AGAGCCCCACACCGCA",2,48,16,2,13,81,2324
"AGATAGAAGCTGAAGC",3,19,29,4,10,65,2535
"AGATAGAAGCTGACAG",0,12,7,1,9,29,1032
"AGATAGAAGGACAGCT",2,59,40,1,13,115,2926
"AGATAGAAGGACGGAG",4,59,70,3,16,152,6942
"AGATCCATCCACGAAT",75,132,52,10,38,307,13918
"AGATCGTAGCCTGCCA",2,19,6,1,4,32,639
"AGATCGTAGGATATAC",2,15,7,1,1,26,627
"AGATCGTCACATCCCT",18,27,20,2,11,78,1695
"AGATCGTGTCGAGTGA",23,78,29,7,25,162,3755
"AGATCGTGTCTTACTT",7,61,29,7,17,121,2615
"AGATGAACACTAAACC",9,85,150,5,40,289,14370
"AGATGAAGTCAAGGCA",5,54,334,0,14,407,39239
"AGATGCTAGTATGGCG",6,56,101,3,50,216,14798
"AGCATCAAGATACCAA",5,96,159,8,20,288,16409
"AGCATCATCGACATTG",0,49,21,6,11,87,1945
"AGCCACGAGACAGCGT",4,61,34,5,11,115,3984
"AGCCACGAGCCAACCC",7,62,21,4,17,111,2695
"AGCCAGCTCGGACTTA",1,9,4,1,21,36,2670
"AGCGATTAGGCCCAAA",9,72,221,1,28,331,21339
"AGCGCTGGTGACGCCT",8,70,173,3,15,269,16538
"AGCGCTGGTTTACCTT",6,62,23,1,62,154,6505
"AGCGTATCAGCTCATA",11,391,45,5,18,470,32299
"AGCGTCGCAGCAGTCC",0,16,1,2,13,32,637
"AGCGTCGCAGGGAGAG",2,20,15,0,4,41,882
"AGCTACAAGAGACAAG",3,62,31,4,48,148,3933
"AGCTACAAGTAATCCC",1,23,5,1,3,33,1676
"AGCTACACAGAGAAAG",4,317,36,7,11,375,24718
"AGCTCAACAGGTCAAG",5,53,141,7,14,220,16375
"AGCTCAATCCCAACTC",3,61,30,1,15,110,3931
"AGCTTCCCAGGTGTGA",6,50,77,3,7,143,8570
"AGGAAATCAGGTCCCA",8,66,177,3,16,270,17197
"AGGAAATCATGACAAA",4,54,57,2,16,133,4630
"AGGAAATGTTTGTGGT",10,80,120,9,21,240,14587
"AGGAATAAGATGATTG",15,97,42,117,21,292,15531
"AGGAATAAGTCAGGGT",1,8,21,1,2,33,1888
"AGGAATAGTTTCACTT",6,76,61,7,16,166,5354
"AGGAATATCTTAGCAG",9,108,44,7,28,196,7133
"AGGACGACACTGAGTT",10,315,73,2,9,409,27104
"AGGACGAGTAAGATAC",2,77,25,0,12,116,3367
"AGGACGATCATCACTT",3,24,36,0,4,67,2382
"AGGAGGTTCCCGAACG",0,12,10,0,1,23,759
"AGGATAAAGACCATGG",14,149,35,8,20,226,12622
"AGGATAACAGACCGCT",2,90,22,4,10,128,4952
"AGGATCTAGAACGCGT",6,47,19,2,20,94,2459
"AGGATCTTCAGGTGTT",65,84,33,2,18,202,11915
"AGGCATTCAAATGGCG",15,3051,74,11,43,3194,281695
"AGGCATTCAACTTCTT",0,21,4,1,2,28,615
"AGGCATTGTGACACGA",2,31,55,4,10,102,3663
"AGGCTGCAGCTGAGCA",2,42,139,0,14,197,16415
"AGGCTGCTCCCTCTTT",5,65,59,2,95,226,13851
"AGGGAGTCACCTGTCT",9,173,20,5,11,218,12990
"AGGGCCTAGTATGGCG",216,178,40,3,17,454,34142
"AGGGCCTTCACCTTAT",6,132,43,8,18,207,13701
"AGGGCCTTCACTACGA",2,15,7,0,8,32,204
"AGGGCTCAGCCTCTCT",0,3,2,1,4,10,45
"AGGGCTCCACTGGCCA",4,181,55,6,21,267,17896
"AGGGTCCAGCCGCACT",7,505,30,8,30,580,44430
"AGGGTCCTCAGCTCTC",6,49,199,2,12,268,22966
"AGGGTGAAGACAAGCC",5,73,259,3,20,360,24345
"AGGGTGAAGATCCCAT",2,17,12,1,5,37,489
"AGGGTGATCATTTGGG",5,54,13,1,71,144,8012
"AGGGTTTGTTGCATTG",7,560,48,5,21,641,53916
"AGGGTTTTCGAGCTGC",4,70,204,2,240,520,42441
"AGGTAGGGTATCAGCT",1,108,19,2,11,141,8455
"AGGTAGGGTATTAAGG",10,123,22,5,9,169,8469
"AGGTAGGGTTGTGCAT",4,45,218,5,21,293,29384
"AGGTAGGTCAAGAATG",6,69,320,2,23,420,34119
"AGGTCTAAGACAACTA",0,7,8,0,3,18,36
"AGGTGTTAGAAGCTGC",1,20,9,0,3,33,357
"AGGTGTTAGGCTGAAC",1,17,4,0,9,31,948
"AGGTGTTAGTCTGCAT",2,51,25,1,21,100,3283
"AGGTGTTCAAGTTCCA",3,58,24,2,19,106,2785
"AGGTGTTCATAATGAG",17,1258,80,10,28,1393,109662
"AGGTGTTGTACGTACT",7,54,17,5,11,94,1848
"AGGTGTTTCCCGAGAC",5,96,37,4,17,159,4904
"AGGTTACTCGCATTAG",5,46,23,1,13,88,2426
"AGGTTGTAGAGCAGTC",2,51,374,3,73,503,52385
"AGGTTGTAGCAAGTCG",4,70,21,2,6,103,4641
"AGGTTGTAGTCTTCCC",4,29,22,6,13,74,1626
"AGGTTGTGTCGTGCCA",1,8,6,0,4,19,33
"AGTAACCTCGAAGTGG",9,688,30,3,27,757,52809
"AGTAACCTCTCGTTTA",1,18,7,2,3,31,367
"AGTACCATCACTAGCA",6,80,304,7,18,415,35801
"AGTACCATCGATACAC",25,32,12,3,6,78,3421
"AGTAGCTAGAAGGATG",2,11,5,1,3,22,605
"AGTAGCTAGCCTCTGG",7,84,384,4,173,652,60743
"AGTAGCTAGCGGTAGT",5,46,25,6,27,109,2993
"AGTAGCTCACACGGAA",7,55,34,8,14,118,5123
"AGTAGTCGTTTACGAC",11,128,126,5,59,329,15328
"AGTCACAAGTATCCTG",4,77,231,4,17,333,27787
"AGTCACACAAAGGGTC",3,54,16,1,8,82,2976
"AGTCACACATCCGGCA",35,43,24,3,16,121,6487
"AGTCATGTCCATCTGC",7,556,31,6,26,626,42615
"AGTCTCCTCCCTTGGT",6,199,26,7,18,256,15730
"AGTGACTAGATTGCGG",8,96,31,1,14,150,8188
"AGTGACTTCCGCAGTG",1,46,43,2,12,104,3016
"AGTGACTTCGTAACAC",7,712,73,3,36,831,62690
"AGTGATCAGTCTTGGT",1,39,12,3,15,70,3225
"AGTGATCGTGTGGTCC",4,69,29,1,14,117,3283
"AGTGATCGTTATGACC",5,62,22,2,18,109,2635
"AGTGATCTCATACAGC",7,58,21,2,16,104,1755
"AGTGCCGAGGACGGAG",10,1167,93,7,24,1301,101096
"AGTGTTGTCAAATGAG",0,10,2,1,1,14,197
"AGTTAGCAGGTCGTGA",0,12,5,1,6,24,733
"AGTTAGCGTCGTTATG",0,1,0,1,0,2,33
"AGTTAGCTCAAGAAAC",7,58,115,4,18,202,10898
"AGTTCCCTCGGCAGTC",3,53,65,4,28,153,8275
"AGTTCGAAGACCAGAC",7,85,65,6,7,170,7853
"AGTTCGACAAAGTGTA",9,75,27,4,24,139,2740
"AGTTCGACACATCATG",3,43,38,4,22,110,2434
"AGTTCGAGTCCCGTGA",6,49,24,5,12,96,2090
"AGTTCGAGTCGTTCAA",171,156,47,1,11,386,11116
"ATACCGATCGCCAATA",5,68,75,6,62,216,14024
"ATACCTTCAACCACGC",1,36,15,5,18,75,2402
"ATACCTTCAACCGATT",2,63,26,6,13,110,3305
"ATACCTTTCCCAGTGG",28,298,41,4,21,392,27397
"ATAGACCCAACGGCTC",20,600,306,17,3633,4576,405843
"ATAGACCCACACCTTC",120,134,42,13,18,327,20553
"ATAGACCGTCCATAGT",12,79,18,4,14,127,4279
"ATAGACCTCTGTCTCG",7,159,50,8,20,244,11236
"ATAGAGATCAGCGGAA",3,152,27,5,15,202,13542
"ATAGGCTTCAAGCCCG",53,35,18,2,11,119,4998
"ATATCCTGTTCGGTAT",9,72,47,2,59,189,8836
"ATCACAGCAAACCATC",15,73,10,5,10,113,7547
"ATCACAGCATCGGTTA",1,4,1,0,1,7,101
"ATCACAGGTAGACGTG",0,57,35,1,12,105,2919
"ATCACAGGTCACCCTT",12,93,33,5,21,164,5491
"ATCACGACAAGCTACT",5,85,32,2,25,149,4958
"ATCACTTCAAGGTCGA",0,10,5,2,0,17,47
"ATCACTTCACAGCCTG",0,15,13,0,2,30,647
"ATCAGGTCAGCACCCA",104,296,36,3,19,458,32731
"ATCAGGTGTTCTCGTC",10,118,743,9,126,1006,94684
"ATCAGGTTCCAAAGGG",3,107,22,6,7,145,8876
"ATCATTCTCCGCTAGG",2,68,133,3,14,220,16079
"ATCCACCCAAATTAGG",5,33,16,2,4,60,481
"ATCCACCCACCGCTGA",1,17,9,3,4,34,192
"ATCCACCTCTCTATAC",8,94,105,14,19,240,11441
"ATCCATTAGCAAACAT",22,548,107,9,40,726,56468
"ATCCATTCAAAGCGTG",4,63,30,3,18,118,2707
"ATCCATTGTCATATGC",5,62,19,48,11,145,9449
"ATCCATTTCATGCAGT",7,108,27,4,14,160,6881
"ATCCCTGCAGAAGCTG",8,77,98,2,13,198,7399
"ATCCGTCAGACCAGAC",5,89,28,3,25,150,5678
"ATCCGTCTCTCGCTTG",2,6,18,0,5,31,1052
"ATCCTATGTATCACCA",8,70,26,3,17,124,2252
"ATCGATGAGCTCTGTA",5,43,19,2,15,84,1741
"ATCGATGAGGGTCTTT",18,67,21,2,17,125,3560
"ATCGATGCAAATGAGT",7,419,62,2,15,505,39281
"ATCGATGCACAAGCTT",8,82,573,2,130,795,85333
"ATCGATGGTTCAAGTC",9,82,87,6,119,303,19665
"ATCGCCTCACAATGTC",1,17,5,1,1,25,692
"ATCGCCTCACAGTGTT",5,232,24,6,11,278,23686
"ATCGGCGGTTTGGAAA",2,21,13,3,7,46,717
"ATCGTAGAGGTGGCTA",6,64,152,4,14,240,15885
"ATCGTAGCAGTCTCTC",10,77,135,2,19,243,14244
"ATCGTAGCATGAAAGT",5,378,45,14,22,464,27494
"ATCGTAGGTGTGAGCA",11,33,20,2,9,75,2367
"ATCGTCCGTGTTTACG",4,257,23,4,12,300,19423
"ATCGTGACAGAACATA",7,68,32,2,16,125,3597
"ATCTCTAGTACGACAG",7,71,50,6,25,159,4958
"ATCTTCAAGAAACACT",6,80,314,6,149,555,45561
"ATCTTCACAACCACGC",10,111,44,3,23,191,8058
"ATCTTCAGTCGTTCAA",11,80,34,2,65,192,7416
"ATGAAAGTCGATTGAC",102,651,58,7,39,857,57093
"ATGACCAGTGCCTATA",7,81,37,105,18,248,13653
"ATGACCATCTCGAACA",4,248,19,1,13,285,25839
"ATGAGTCCACAAAGTA",1,25,12,1,12,51,614
"ATGAGTCCATCTCATT",4,129,26,4,14,177,9689
"ATGCATGAGGAGCAAA",44,402,132,124,15,717,48112
"ATGCATGGTAGCTGCC",2,13,92,0,4,111,8992
"ATGCATGGTTTACCTT",4,146,21,5,15,191,11167
"ATGCCTCAGACTCCGC",5,68,26,5,13,117,3245
"ATGCCTCAGGGAGAAT",10,50,31,6,170,267,20238
"ATGGAGGGTAGGTACG",11,98,1086,4,231,1430,156454
"ATGGAGGGTGCTTCAA",225,292,100,7,30,654,44837
"ATGGATCAGCTCGACC",6,48,15,5,105,179,14309
"ATGGATCGTGTGGACA",1,237,30,6,11,285,21724
"ATGGGAGGTGAGGAAA",4,63,15,2,14,98,218
"ATGGGTTCACTGCGTG",3,38,25,1,15,82,3752
"ATGGGTTCATCTCATT",3,99,283,6,861,1252,105423
"ATGGGTTTCAGACAAA",0,21,8,1,3,33,167
"ATGGTTGAGACATCCT",5,51,27,4,16,103,3100
"ATGGTTGCAAACACGG",6,87,29,6,11,139,4463
"ATGGTTGCAGACGATG",1,249,96,2,21,369,26413
"ATGTCCCAGCACTCTA",0,29,41,2,6,78,3295
"ATGTCCCCAATTCTCT",7,114,100,2,16,239,17529
"ATGTCTTCAAGATCCT",1,83,27,2,13,126,5620
"ATGTCTTCAGACCTGC",5,42,270,2,22,341,33139
"ATGTCTTGTAGTGTGG",1,39,21,4,13,78,1486
"ATGTCTTGTGTCATTG",6,33,37,0,42,118,6119
"ATGTCTTTCATGAGGG",2,46,13,37,10,108,3068
"ATGTCTTTCTGAACGT",5,163,20,4,21,213,12423
"ATTACTCCAGAGAATT",3,15,2,3,2,25,121
"ATTACTCTCTTGCAGA",2,76,28,2,67,175,7514
"ATTATCCTCACCTCTG",9,49,42,1,19,120,4553
"ATTCACTAGTCTGCAT",2,80,36,12,14,144,2593
"ATTCACTCAGACGCTC",11,61,40,5,43,160,6269
"ATTCAGGGTTCATCGA",8,43,22,108,15,196,12544
"ATTCATCCATTCTCCG",3,13,6,0,4,26,95
"ATTCATCGTGATCATC",10,62,91,6,49,218,16123
"ATTCCATAGCGCCGTT",7,67,869,5,15,963,58793
"ATTCCATAGGGTACGT",10,73,320,5,18,426,38189
"ATTCCATAGGTATTGA",50,43,21,3,16,133,5843
"ATTCCCGCAGCGTATT",4,76,196,3,18,297,28122
"ATTCCCGCATTACGGT",0,12,5,2,6,25,726
"ATTCCTATCACTGAAC",1,25,11,2,9,48,150
"ATTCGTTAGAGGACTC",5,58,331,8,281,683,69822
"ATTCTACTCATTTGTC",8,190,35,2,28,263,17072
"ATTCTACTCTGGTTGA",21,83,25,4,14,147,6194
"ATTCTTGCACATCCCT",3,64,54,5,12,138,6635
"ATTCTTGCAGCGACCT",1,9,4,2,5,21,413
"ATTCTTGTCGGAGATG",2,13,9,1,8,33,113
"ATTGGGTAGGAGTCTG",2,62,21,7,107,199,9584
"ATTGGGTGTATCGTTG",2,60,25,6,10,103,3379
"ATTGTTCCATAAGATG",2,41,25,6,16,90,1869
"ATTGTTCGTTCAGTAC",8,58,28,2,18,114,2295
"ATTGTTCTCTGATTCT",0,38,18,0,9,65,1738
"ATTTACCCAATGAAAC",3,206,30,7,16,262,13710
"ATTTACCTCAAGCCGC",9,32,9,1,7,58,379
"ATTTCACCAAGACAAT",10,88,174,5,159,436,38032
"ATTTCACTCGAGAAAT",30,136,55,443,34,698,47748
"ATTTCTGAGACATCCT",0,16,8,2,3,29,486
"ATTTCTGCAACGCATT",32,54,26,3,18,133,6326
"CAAAGAAGTGAATGTA",3,12,7,1,5,28,485
"CAAAGAAGTTCCTACC",5,37,24,3,22,91,3282
"CAACAACAGATAGTCA",7,286,104,9,21,427,30332
"CAACAGTCATGTACGT",9,85,277,7,31,409,22493
"CAACAGTTCAAGCCGC",9,261,240,10,21,541,38697
"CAACAGTTCACTCACC",2,45,52,3,47,149,5368
"CAACAGTTCCTCGCAT",6,91,25,6,13,141,6350
"CAACCAAAGAGAACCC",2,9,4,0,5,20,114
"CAACCAAGTATTCCGA",5,91,31,8,18,153,6755
"CAACCAAGTCTTCCGT",1,12,4,2,2,21,168
"CAACCTCAGCCAGACA",11,56,255,2,25,349,34894
"CAACCTCGTCTGCCTT",3,124,17,4,13,161,13256
"CAACCTCTCCCTCGAT",8,70,33,3,18,132,4964
"CAACGATCAAGTTCGT",3,46,33,4,7,93,4051
"CAACGATGTACTTCCC",11,98,44,5,18,176,3549
"CAACGGCAGATGGGCT",3,16,7,0,2,28,540
"CAAGACTGTGCTCGTG",6,250,37,4,18,315,20875
"CAAGAGGAGCCTAGGA",4,148,25,5,13,195,10778
"CAAGCTACACGTCTCT",6,86,33,3,11,139,5725
"CAAGCTACATCGGCCA",0,4,3,3,1,11,48
"CAAGCTATCTCACCCA",3,91,19,1,10,124,8420
"CAAGGGAAGATTGACA",3,269,66,3,20,361,29186
"CAAGGGAAGGAGAGGC",4,10,6,0,2,22,412
"CAAGGGACAAAGACTA",1,21,5,2,5,34,790
"CAAGGGAGTGAAGCGT",4,29,14,2,17,66,1647
"CAAGGGAGTTCACGAT",2,44,19,2,9,76,2531
"CAATACGGTGCGTTTA",13,70,148,6,104,341,24587
"CAATCGAAGATCCCGC",4,21,10,0,4,39,622
"CAATCGAAGCTGTACT",3,88,56,3,145,295,18930
"CAATCGAAGTTGCGAG",5,46,26,16,14,107,3220
"CAATCGACAATTGTGC",2,14,5,1,3,25,111
"CAATCGACAGCGTTTA",5,81,167,2,579,834,82124
"CAATGACAGAAGTCTA",3,201,25,3,7,239,16516
"CAATGACCATGAGATA",1,74,60,2,17,154,6855
"CAATGACGTAAGACCG",4,61,16,0,8,89,1331
"CAATGACGTTGGTGTT",3,21,11,1,7,43,107
"CAATTTCCAAATCCCA",13,61,253,5,71,403,29396
"CACAACACAATACGAA",6,53,58,2,105,224,19723
"CACACAAAGACCAAAT",20,59,34,3,20,136,4114
"CACACAAAGGTTTGAA",4,55,304,5,16,384,30005
"CACAGATCATGAGAAT",6,276,41,4,25,352,20979
"CACAGATCATTGAGGG",4,92,23,3,15,137,5842
"CACAGATGTGCAGGAT",3,40,22,0,11,76,2491
"CACAGGCAGTCAACAA",5,61,16,4,14,100,2463
"CACAGGCGTGAGAACC",3,163,34,1,13,214,16131
"CACAGGCTCTTGTGCC",6,101,19,2,10,138,9923
"CACATGACAGAGTCAG",4,161,37,3,18,223,12122
"CACCAAAAGCATGCGA",8,83,274,2,226,593,57831
"CACCAAAAGTCTGCAT",5,70,24,4,90,193,9541
"CACCAAACACGCTTAA",5,31,12,5,4,57,1773
"CACCGTTAGGGAGAAT",3,80,674,4,22,783,82919
"CACCGTTTCCAGCTCT",9,59,26,4,93,191,13059
"CACGAATCATGAGAAT",4,74,18,5,14,115,3491
"CACGGGTGTATTTCTC",5,36,51,4,19,115,3445
"CACGGGTGTCGAGCAA",3,219,23,3,14,262,18325
"CACGTGGCAGGCGATA",7,227,123,5,1342,1704,158560
"CACGTTCCAGAGATTA",11,64,23,2,18,118,1947
"CACGTTCGTTGGGACA",6,54,108,2,41,211,16276
"CACTAAGAGACATACA",2,19,9,2,10,42,710
"CACTAAGCACTTCATT",4,80,30,3,15,132,4439
"CACTAAGCATCATTGG",2,32,9,2,3,48,1368
"CACTGAATCGCCAGAC",2,68,231,8,12,321,26859
"CACTGAATCTGCTAGA",5,52,119,2,17,195,14945
"CACTGGGAGCTGACAG",4,63,186,2,59,314,27446
"CACTGGGAGGATGGCT",3,45,28,2,13,91,2492
"CACTGGGAGTCATGGG",4,15,11,0,3,33,365
"CACTGGGAGTGCTCGC",27,79,23,4,15,148,8895
"CACTGTCAGAGGTCGT",0,8,2,0,0,10,31
"CACTGTCAGCGTCTCG",9,57,99,2,209,376,31563
"CACTGTCCACAAGTTC",13,1717,90,3,45,1868,158867
"CACTGTCGTTGGGTAG",7,118,24,3,9,161,7977
"CACTTCGTCTCATAGG",1,5,3,0,0,9,92
"CAGAGCCTCCTAAGTG",8,57,20,4,12,101,1522
"CAGAGCCTCGGACTTA",3,71,24,3,11,112,2850
"CAGATACCACTGAATC",6,37,19,4,41,107,4509
"CAGATACCAGCAGTCC",90,55,24,6,11,186,12437
"CAGATACGTAGGTCAG",4,81,24,4,18,131,3587
"CAGATCAGTATTGCCA",6,120,32,61,13,232,16565
"CAGATTGCACACAGAG",7,58,26,2,16,109,2171
"CAGATTGTCCCGTTCA",8,46,187,4,17,262,22834
"CAGCACGAGGCCTTGC",3,9,9,0,3,24,334
"CAGCACGAGGCGATAC",5,68,64,4,22,163,5388
"CAGCACGCAAGCACCC",7,85,318,3,29,442,33901
"CAGCAGCAGATGTAGT",0,19,12,1,8,40,832
"CAGCAGCAGCGATGAC",8,535,111,2,20,676,48761
"CAGCAGCCACCTCAGG",8,531,32,4,22,597,47583
"CAGCAGCGTACGTAGG",0,12,7,3,4,26,321
"CAGCAGCGTAGCACAG",6,82,28,3,15,134,3590
"CAGCAGCGTTCTCCTG",1,24,12,3,3,43,122
"CAGCGTGAGTGTGTTC",7,81,20,5,15,128,4871
"CAGCGTGCAAAGGATT",2,60,17,2,17,98,1479
"CAGCGTGTCACTACTT",3,40,22,2,13,80,3819
"CAGCGTGTCTCCAAGA",5,53,20,4,26,108,2851
"CAGGGCTAGGTCGTGA",8,110,29,3,13,163,7832
"CAGGGCTCAGCTGTAT",5,45,57,3,10,120,6134
"CAGGGCTTCCTTCGAC",6,49,69,3,13,140,8057
"CAGGTATAGAACAAGG",5,38,73,2,13,131,5387
"CAGGTATCAATTGAAG",4,25,14,2,9,54,119
"CAGGTATCATCTTAGG",116,122,31,3,25,297,17599
"CAGTGCGAGCATTGAA",5,52,20,4,32,113,4246
"CAGTGCGAGGTACTGG",5,55,260,4,18,342,29717
"CAGTGCGCAAGAATAC",1,11,5,1,1,19,95
"CAGTGCGGTCCTATAG",5,34,22,4,9,74,1724
"CAGTTAGAGCAGGGAG",5,61,24,3,23,116,2579
"CAGTTAGAGGACTGGT",9,137,36,2,23,207,13100
"CAGTTAGAGGTACAAT",9,88,39,5,118,259,12559
"CAGTTAGGTGAACCGA",4,106,95,7,102,314,29989
"CATAAGCCATGCAGCC",6,863,68,10,28,975,72622
"CATAAGCGTCGAGCTC",8,104,13,1,5,131,3762
"CATAAGCGTTAACCTG",2,31,47,2,4,86,4282
"CATAAGCTCCGCCTAT",37,372,80,9,27,525,32014
"CATAAGCTCGTGCGAC",3,41,35,5,24,108,4273
"CATACAGCAACCGTAT",4,55,22,2,9,92,2845
"CATACCCCACACCTGG",6,71,184,7,16,284,23132
"CATACCCGTATGAGCG",2,26,9,1,5,43,1156
"CATAGACCACTCTGCT",0,8,3,2,5,18,91
"CATCAAGCATTGCTGA",4,102,29,3,5,143,8697
"CATCAAGGTGGCTTAT",3,47,31,3,14,98,2338
"CATCAAGTCCGTGTCT",2,17,3,1,5,28,70
"CATCCACAGTGTACCT",8,97,276,3,380,764,74456
"CATCCACCAAACGTGG",6,75,44,2,329,456,36112
"CATCCGTAGCCATTCA",6,148,29,4,52,239,18055
"CATCCGTAGTGGAAGA",171,71,32,6,19,299,21501
"CATCCGTTCGATAACC",17,53,24,4,10,108,3517
"CATCGCTAGATACTGA",6,123,29,3,116,277,17074
"CATCGCTAGCCAAGGT",0,9,2,1,4,16,56
"CATCGCTTCTATCGGA",1,125,23,2,53,204,13397
"CATCGGGCAGAAATTG",6,38,11,4,8,67,1432
"CATCGGGGTGAATTAG",3,51,18,2,16,90,2300
"CATCGGGGTTGTCCCT",2,30,30,1,8,71,1492
"CATCGGGTCCGTGGGT",4,24,22,0,14,64,1426
"CATCGGGTCGAAGTGG",9,52,124,2,22,209,15411
"CATCGGGTCTGACAGT",1,37,17,3,39,97,5150
"CATCGTCCAACATACC",13,86,463,5,21,588,47930
"CATGAGTAGTAGGGTC",7,138,35,6,15,201,9195
"CATGCAAAGGAAAGTG",9,62,283,4,23,381,29668
"CATGCAATCCGAACGC",1,157,35,156,16,365,25446
"CATGCCTGTCCGGTCA",3,44,26,0,10,83,3691
"CATGCCTTCACTTGTT",8,82,610,8,44,752,73481
"CATGCCTTCCGGACGT",1,25,17,2,9,54,768
"CATGCCTTCCTCAGGG",9,79,208,3,22,321,21371
"CATGCCTTCGTCAGAT",45,1789,175,9,39,2057,178104
"CATGCGGCAGAAATTG",10,159,41,150,24,384,22446
"CATGCGGGTCGTCATA",5,174,30,3,9,221,11722
"CATGCGGGTTCGGTCG",2,54,325,5,9,395,38514
"CATGCTCGTGACTCGC",552,124,42,5,20,743,56493
"CATGCTCTCATCGCAA",6,58,125,9,203,401,32236
"CATGGATAGCCTTTGA",0,6,3,0,1,10,23
"CATGGATAGTCTCGTA",3,20,10,0,6,39,108
"CATGGATCACATGTTG",4,53,26,2,7,92,3018
"CATGGATGTGCAACGA",4,37,145,7,12,205,14400
"CATGGATGTGCCAAGA",1,12,9,3,2,27,531
"CATGGATTCAAGAAAC",2,62,22,6,20,112,2501
"CATGGTACAATAGAGT",3,17,10,2,6,38,437
"CATGGTATCGTAACTG",6,60,32,5,14,117,2514
"CATTCATAGGGCGAGA",34,222,46,3,26,331,18261
"CATTCATCATGTGGCC",10,54,19,1,8,92,3581
"CATTCATGTACCTGTA",6,56,149,5,38,254,20614
"CATTCATTCCGCTAGG",23,121,30,6,21,201,10987
"CATTCATTCTGTGCGG",6,110,208,3,22,349,27626
"CATTCCGTCCCGTGAG",3,119,26,9,16,173,7521
"CATTCTACAAGAGTAT",61,164,20,4,21,270,18131
"CATTCTATCATCTGTT",4,17,10,1,7,39,498
"CATTCTATCGGAGTAG",4,47,30,3,22,106,2158
"CATTGAGAGAAGATCT",3,15,10,0,4,32,89
"CATTGAGCAATGGGTG",10,83,588,3,210,894,89207
"CATTGAGGTCTGTGCG",5,70,29,1,16,121,3399
"CATTGCCCATCCTCAC",0,12,6,1,3,22,81
"CATTGTTCAAGCGAAC",3,60,22,6,45,136,5372
"CATTGTTCAGGACTTT",5,230,89,9,20,353,25617
"CATTGTTTCCATATGG",3,61,31,4,12,111,2991
"CCAAGCGCAAAGGCAC",14,76,35,4,35,164,7254
"CCAAGCGCACTGCGTG",11,237,95,4,20,367,24977
"CCAAGCGGTCTGTCAA",1,12,1,1,1,16,74
"CCAAGCGTCGAATCCA",0,23,65,4,5,97,3528
"CCAAGCGTCGCTTACC",1,32,171,5,11,220,6608
"CCAATGAAGAGAGGTA",6,65,28,1,3,103,2466
"CCAATGACAATCTCTT",1,15,4,0,4,24,145
"CCAATTTAGGACTGGT",1,50,32,1,22,106,3029
"CCAATTTCAGGGAGAG",9,857,106,6,25,1003,84192
"CCACAAATCTGTCCCA",1,63,19,22,5,110,5814
"CCACACTAGAGGTGCT",11,167,38,6,17,239,11304
"CCACGAGGTGCATGTT",3,77,301,9,98,488,43771
"CCACGTTAGTTACGTC",8,226,38,2,16,290,20769
"CCACGTTGTACAGAAT",5,45,22,2,15,89,1936
"CCACGTTGTTTGCAGT",7,23,7,1,6,44,399
"CCACGTTTCCGCCTAT",20,89,39,6,18,172,7586
"CCACGTTTCTTTGCTA",4,109,22,6,19,160,4479
"CCACTTGAGACCAAGC",3,67,32,5,20,127,3006
"CCACTTGGTGATAGTA",1,22,5,1,8,37,154
"CCACTTGGTGCAGATG",8,481,43,127,21,680,59753
"CCATAAGAGGATATAC",99,417,86,9,133,744,43554
"CCATAAGAGTTGAATG",2,97,29,75,23,226,12960
"CCATAAGTCAGCTCTC",1,18,8,0,7,34,1001
"CCATAAGTCCGTAGTA",13,877,116,9,32,1047,82280
"CCATCACAGGTAAGTT",10,51,47,0,21,129,4940
"CCATCACCAAGCAGGT",0,9,3,0,1,13,84
"CCATCACCATGGGAAC",7,73,122,3,203,408,34792
"CCATCACTCAGGAAAT",7,262,39,4,17,329,20109
"CCCAACTCAGGTTTAC",9,54,114,2,175,354,31673
"CCCAACTGTTACACTG",0,12,4,0,1,17,737
"CCCAACTTCCGTGACG",4,84,511,4,302,905,92804
"CCCATTGCAAGCCATT",2,31,40,4,31,108,6660
"CCCATTGGTATCGTGT",8,74,93,3,17,195,9751
"CCCGAAGAGTCTTCGA",8,182,33,2,22,247,11132
"CCCGAAGCAACAGATA",6,56,23,11,13,109,2929
"CCCGAAGCAAGCTGCC",8,78,143,6,14,249,16872
"CCCGAAGCATGGTACT",4,50,109,3,55,221,14508
"CCCGAAGGTGGTCTAT",2,10,3,0,1,16,39
"CCCGAAGTCGTTTACT",0,8,2,0,2,12,133
"CCCGGAACAGACACAG",1,7,4,0,1,13,85
"CCCTCAAGTAGTTCCA",14,54,48,5,22,143,6452
"CCCTCTCAGTCGCCCA",0,21,16,1,4,42,1232
"CCCTCTCCATTCCTAT",4,15,8,0,4,31,619
"CCCTCTCGTAAGATAC",133,85,98,5,134,455,35357
"CCCTCTCGTACGATCT",6,66,245,5,14,336,29644
"CCCTGATAGCAGTAAT",12,86,34,5,15,152,3622
"CCCTGATCAAACCACT",5,44,18,2,2,71,2635
"CCCTGATCACGGCACT",8,111,20,2,6,147,10991
"CCGAACGAGAGATGCC",6,46,84,1,18,155,10267
"CCGAACGCATCGCCTT",2,20,9,5,22,58,1480
"CCGAACGGTGAGTTGG",1,67,248,2,480,798,80987
"CCGATCTAGAGAGCGG",3,23,8,3,4,41,1097
"CCGATCTTCCATGATG",10,623,46,6,29,714,59929
"CCGATGGAGTTGGGAC",10,513,64,4,25,616,41382
"CCGATGGCACTCGATA",5,50,198,4,18,275,19765
"CCGATGGTCCAAAGGG",3,22,34,2,5,66,3558
"CCGCAAGGTCGTTATG",5,47,21,6,21,100,1578
"CCGCAAGGTCTTTATC",6,131,38,1,10,186,13234
"CCGGACAAGTACTGGG",10,85,18,17,18,148,5212
"CCGGACAAGTAGGAAG",4,159,23,22,12,220,14033
"CCGGACACACAGTGAG",4,51,23,3,59,140,6783
"CCGGACACAGGGCTTC",19,270,49,21,21,380,24957
"CCGGACAGTTCGAGCC",2,17,9,2,2,32,222
"CCGGACATCGCCGTGA",3,38,39,1,13,94,3396
"CCGGTAGGTATGAGGC",9,69,178,8,13,277,17654
"CCGGTGAAGTACTGGG",3,24,5,0,6,38,446
"CCGGTGACACCCTATC",2,10,9,1,1,23,572
"CCGTAGGAGATAACGT",1,28,11,1,11,52,172
"CCGTAGGAGCATCCTA",9,112,167,9,34,331,18688
"CCGTGAGCATAACAGA",5,52,59,4,13,133,8810
"CCGTGAGGTTAAGGAT",1,3,4,0,2,10,252
"CCGTGAGTCGCTACAA",6,248,24,5,12,295,18919
"CCGTTCAAGTCAACAA",5,84,315,5,240,649,59377
"CCGTTCACAACGTTAC",4,231,31,5,20,291,21042
"CCGTTCATCTTCCGTG",23,684,96,10,39,852,64186
"CCTAACCAGCAAACAT",41,152,38,1,18,250,16532
"CCTAACCCAGGTCCCA",17,70,33,2,13,135,5111
"CCTAACCCAGTAACCT",4,42,19,2,17,84,3245
"CCTAACCTCCGAGATT",12,145,34,2,19,212,12788
"CCTAACCTCGTTGTGA",8,91,47,3,14,163,6551
"CCTAAGATCGCTGTTC",11,1209,117,7,29,1373,123302
"CCTACGTCAGCATCTA",9,70,39,3,14,135,4027
"CCTACGTGTCCATACA",5,41,23,2,60,131,7058
"CCTACGTGTGACCGTC",6,53,85,5,11,160,9221
"CCTACGTTCATCACAG",6,525,41,3,24,599,47274
"CCTACGTTCATTGTGG",3,46,18,1,13,81,2014
"CCTACGTTCTGACCCT",0,0,0,0,2,2,6
"CCTATCGGTACGATTC",100,274,48,4,20,446,34845
"CCTATCGGTGATAGAT",3,30,10,0,27,70,3159
"CCTATCGGTTCAAGTC",3,315,43,7,25,393,24038
"CCTCAACCAATCTAGC",4,61,39,6,12,122,6896
"CCTCAACTCGAAGTGG",7,43,73,3,21,147,9446
"CCTCACAAGGTCGTCC",10,34,23,2,5,74,1883
"CCTCAGTAGTCACTAC",0,12,2,2,6,22,118
"CCTCAGTCACGTATAC",0,7,7,2,4,20,78
"CCTCATGCAAATCAGA",7,128,20,3,13,171,8607
"CCTCATGTCCAATCTT",9,46,52,2,58,167,10139
"CCTCCAAGTCCGGACT",2,50,84,3,17,156,13318
"CCTCCAATCTACAGGT",0,23,3,1,0,27,1128
"CCTCCTCAGTAGATCA",6,25,76,2,8,117,10589
"CCTCCTCCAGAGGACT",5,19,12,3,9,48,528
"CCTCTAGAGTCACTAC",2,57,40,8,42,149,5324
"CCTCTAGCATCACAGT",4,56,52,5,106,223,11373
"CCTCTCCAGACTACGG",5,23,10,1,18,57,2198
"CCTCTCCCAATCGTCA",4,51,25,6,21,107,2721
"CCTCTCCGTCATCCCT",0,4,6,1,2,13,110
"CCTGCATCAGAATGTA",6,254,30,4,22,316,21045
"CCTGCATCAGGGCTTC",4,59,47,2,85,197,13663
"CCTGCATGTGGTCAAG",9,73,58,7,25,172,5169
"CCTGCATTCACCGGGT",10,52,23,2,83,170,10205
"CCTGTTGAGCTCGTGC",6,66,275,3,12,362,29630
"CCTGTTGCATCGTTCC",9,61,212,5,11,298,24263
"CCTGTTGTCTCGCTCA",3,63,14,3,16,99,3871
"CCTTCAGAGATGACAT",6,70,772,5,17,870,92200
"CCTTCAGCAGAGCCCT",7,43,47,2,13,112,4929
"CCTTGTGCAACAACAA",8,52,31,11,12,114,1954
"CCTTGTGCATTGACAC",2,49,20,5,19,95,1895
"CCTTGTGGTAGACACG",4,48,15,4,212,283,25106
"CCTTGTGTCTACGCGG",3,186,24,2,12,227,14533
"CCTTTGGAGTCGAAAT",3,83,12,5,12,115,4449
"CCTTTGGCAGAAGCGT",11,67,28,14,19,139,5036
"CGAAGTTGTGTTAGCT",3,61,427,5,16,512,47810
"CGAAGTTGTTCGAACT",14,71,24,2,12,123,2314
"CGAATTGAGGTAAACT",1,33,32,2,27,95,3368
"CGAATTGGTGGGCTTC",3,35,24,4,13,79,2063
"CGACAGCAGCCACTCG",5,71,37,3,189,305,20026
"CGACAGCGTGGGACAT",4,103,16,5,10,138,5607
"CGAGAAGAGTCTAACC",1,17,6,1,7,32,150
"CGAGAAGCACACAGCC",4,64,32,2,19,121,5567
"CGAGGCTAGGCTAAAT",6,48,50,2,11,117,5634
"CGAGGCTCACAACGCC",4,199,24,5,10,242,14401
"CGAGTGCAGTTGGACG",3,319,24,6,42,394,28064
"CGAGTGCCAAACCATC",4,28,16,1,9,58,2590
"CGAGTGCCAACCGTGC",3,71,24,0,65,163,12165
"CGAGTGCGTGTTCAGT",6,49,17,5,12,89,1925
"CGAGTTACATCGCCTT",3,44,21,1,20,89,2157
"CGATCGGAGGAGAATG",2,19,9,2,9,41,569
"CGATCGGAGGTGATAT",6,48,107,2,115,278,22659
"CGATGCGAGGGCCAAT",3,227,39,6,14,289,17846
"CGATGCGAGTTTGCTG",2,26,11,1,8,48,169
"CGATGGCTCCCTCGTA",29,34,22,1,10,96,3077
"CGATGGCTCGGACGTC",5,52,22,4,9,92,1385
"CGCAGGTCAAGGATGC",2,12,4,0,3,21,64
"CGCAGGTTCTATACTC",3,140,40,6,7,196,13111
"CGCATAACATAGATGA",3,15,12,2,4,36,485
"CGCATGGGTCCTACGG",6,77,189,7,18,297,18607
"CGCATGGGTTCCTACC",7,71,390,2,18,488,33282
"CGCATGGTCCTTTGAT",1,14,4,1,5,25,405
"CGCCAGACAACACGAG",8,49,122,3,18,200,9869
"CGCCATTAGGATACGC",3,44,36,0,16,99,4323
"CGCCATTCAGGCGTTC",4,49,18,21,6,98,3040
"CGCCATTGTTCTCTCG",1,48,22,4,5,80,1872
"CGCCATTTCCGAAATC",7,215,37,6,8,273,16615
"CGCGTGACACGCTTAA",31,172,60,2,14,279,17730
"CGGAACCCAGTCACGC",11,95,401,5,257,769,54575
"CGGAATTCATCGTTCC",2,42,36,1,49,130,4869
"CGGAATTTCACAGTGT",68,467,53,7,31,626,42957
"CGGACACAGAGCTGAC",7,59,30,9,15,120,1595
"CGGACACTCGGACTGC",4,44,37,3,13,101,2965
"CGGACACTCTCGCTCA",1,2,2,0,2,7,80
"CGGAGAACAAGTACCT",5,44,67,2,13,131,8781
"CGGAGAACACGTCATA",9,138,49,6,15,217,13329
"CGGCAGTAGATCGACG",4,391,34,8,20,457,29521
"CGGCAGTCAGCTTTCC",3,54,244,4,13,318,23700
"CGGGACTAGGAAACGA",3,52,75,2,6,138,8084
"CGGGACTCAATGTGGG",6,102,60,4,22,194,8585
"CGGGACTGTCTTGCTC",1,38,15,4,7,65,2720
"CGGGCATCACAAAGCG",0,21,16,2,1,40,3185
"CGGGTCAGTTCGGACC",7,58,86,2,81,234,16600
"CGGGTCATCTCTAAGG",0,3,2,0,0,5,38
"CGGGTCATCTTGGAAC",8,53,121,2,16,200,13552
"CGGTCAGAGGCCTAAG",9,474,50,5,18,556,43111
"CGGTCAGGTTGCTAGT",29,75,21,2,13,140,5672
"CGTAATGGTTGTCTAG",9,49,33,4,20,115,2900
"CGTAATGTCATCAGTG",8,70,266,6,277,627,61379
"CGTAGTAGTCCTGGTG",7,55,46,2,15,125,4878
"CGTAGTAGTTCGTACA",3,57,86,5,38,189,11333
"CGTAGTAGTTGCCAAT",14,137,27,14,11,203,8144
"CGTAGTATCGCATTGA",9,61,26,1,57,154,9558
"CGTAGTATCGGCCTTT",2,24,12,1,4,43,238
"CGTAGTATCTCGCTTG",721,161,48,5,23,958,76769
"CGTCAAACAAGGCCTC",6,39,13,42,15,115,4541
"CGTCCATAGTTTGCTG",101,54,17,1,20,193,8501
"CGTCCATCAATAGAGT",11,667,137,4,36,855,61309
"CGTCCATGTATCCTTT",25,52,14,5,18,114,3508
"CGTCCATTCTAGGAAA",1,40,27,1,103,172,8914
"CGTGAATCAATTGCGT",10,65,30,5,216,326,23255
"CGTGAATCACCGCTGA",6,163,17,4,14,204,9635
"CGTGAATGTCGGTGTC",20,55,16,1,13,105,3104
"CGTGAATTCATACGAC",8,42,27,3,18,98,1752
"CGTGAATTCCATGAGT",5,70,247,5,19,346,21686
"CGTGATAAGGATGAGA",3,4,1,0,3,11,17
"CGTGATAAGTAGTGCG",6,67,62,3,45,183,10599
"CGTGATATCGTCCTCA",4,159,33,10,19,225,9955
"CGTGCTTCAAGGATGC",10,15,9,3,4,41,856
"CGTGCTTCATCCGTTC",12,637,102,9,23,783,51189
"CGTGCTTTCATTCTTG",12,87,36,8,13,156,2025
"CGTGCTTTCGTGCACG",1,28,7,1,9,46,683
"CGTGTCTCAAGCTGCC",1,195,14,0,8,218,13487
"CGTGTCTCAAGTGATA",0,7,1,0,0,8,24
"CGTGTCTCATCTTAGG",2,57,327,5,11,402,31106
"CGTGTCTGTATGCTTG",3,72,21,2,10,108,4408
"CGTGTCTGTCTAGATC",7,37,148,2,68,262,18211
"CGTTAGAAGATCGACG",6,46,21,20,7,100,2971
"CGTTAGACAGAGACTG",1,14,11,1,3,30,116
"CGTTAGACAGGGATAC",1,28,13,1,6,49,193
"CGTTAGAGTTGCGGAA",13,325,70,117,173,698,44386
"CGTTCTGAGCAAATCA",6,87,22,5,157,277,18517
"CGTTCTGAGGCCACTC",6,9,5,1,3,24,1326
"CGTTGGGCACGGGCTT",4,55,28,6,120,213,12673
"CGTTGGGGTGGCCCAT",1,28,28,0,5,62,1868
"CGTTGGGGTGTTAAAG",1,15,96,0,7,119,11557
"CTAACCCAGGTAGATT",2,58,34,7,15,116,2371
"CTAACCCCAAACACCT",1,16,14,2,4,37,460
"CTAACCCGTTGGGTTT",6,315,41,2,19,383,33635
"CTAAGTGAGACAGTCG",513,117,43,113,26,812,52616
"CTACAGAGTCTGTAAC",3,8,6,0,2,19,162
"CTACAGAGTGATCATC",6,48,179,1,26,260,17862
"CTACATTCATTGGGAG",2,119,24,2,16,163,7058
"CTACATTGTCGAAACG",13,135,16,5,13,182,10336
"CTACCCAAGTCTAACC",160,72,30,21,16,299,18334
"CTACCCATCTATCGGA",0,8,9,0,1,18,220
"CTACGGGAGAGGTCGT",19,27,17,33,8,104,2464
"CTACGGGTCCCGTGTT",1,17,33,1,4,56,2553
"CTACGGGTCGTCGACG",3,99,25,2,10,139,6589
"CTACTATGTCGAACGA",0,60,44,5,15,124,4280
"CTATAGGTCTCCCAAC",1,44,10,4,5,64,3448
"CTATCCGGTCGCACAC",5,54,30,4,14,107,2543
"CTATCTACATCGGAAG",2,29,14,5,5,55,141
"CTATCTAGTACCATAC",3,10,4,1,4,22,89
"CTCAACCTCAAGCCCG",3,91,25,7,14,140,5014
"CTCAAGATCGGTGTTA",7,78,957,6,25,1073,115241
"CTCAATTAGGTGATCG",3,59,59,2,12,135,6076
"CTCACTGCACGGTGTC",0,14,6,1,3,24,247
"CTCACTGGTAGGAGTC",6,303,37,4,307,657,45248
"CTCAGAAGTCCAGCGT",3,48,71,3,66,191,12832
"CTCAGAAGTCTTGAGT",2,41,20,5,9,77,1826
"CTCAGAAGTGGCTACC",6,64,23,4,70,167,8502
"CTCAGAATCGTTACCC",11,45,73,2,15,146,5571
"CTCAGTCCACCCTAAA",2,47,18,2,8,77,511
"CTCATCGAGGTTTACC",2,122,33,4,11,172,11174
"CTCATCGCAATTGAAG",4,48,36,3,38,129,9378
"CTCATCGGTATCAGCT",9,141,25,3,19,197,8728
"CTCATCGGTCTAGGTT",1,55,20,4,8,88,6576
"CTCATGCCAGGTCAAG",5,80,23,5,31,144,4460
"CTCATGCTCGCCAATA",6,47,136,8,13,210,15503
"CTCATTACATTCCTAT",10,198,39,4,27,278,16937
"CTCATTATCTATGCCC",8,68,19,1,17,113,5463
"CTCCAACAGTTGTAGA",12,70,26,22,14,144,5674
"CTCCAACCAACCAGAG",10,167,30,5,17,229,9559
"CTCCAACCAATCGCCG",85,75,37,2,16,215,10251
"CTCCAACCACGTAGTT",8,63,31,321,14,437,33956
"CTCCAACTCACAAGGG",9,102,141,4,505,761,55951
"CTCCACACAAAGTATG",10,63,57,3,25,158,5102
"CTCCACAGTGCTCTTC",28,102,22,4,8,164,10822
"CTCCATGTCAAAGAAC",2,145,53,4,9,213,11753
"CTCCCAAAGGCTCTAT",1,69,208,4,20,302,25881
"CTCCCTCCAAGAGGCT",8,54,32,2,115,211,14948
"CTCCGATCATGCCGGT",3,20,10,2,13,48,1089
"CTCCGATTCCCTCTTT",21,62,21,2,16,122,4478
"CTCCGATTCTGCGGGT",5,168,16,3,15,207,16122
"CTCCTCCAGATGAATC",5,72,34,5,129,245,13952
"CTCCTCCGTGGAAATT",10,72,169,6,25,282,19396
"CTCCTTTAGTCTCTGA",0,62,8,0,2,72,6071
"CTCCTTTCACAAATCC",7,52,16,3,7,85,3324
"CTCTCAGAGGTACATA",0,13,35,1,5,54,2606
"CTCTCAGTCCAAGCTA",2,11,7,1,3,24,1155
"CTCTCGAAGAATTTGG",4,36,9,2,32,83,2640
"CTCTCGAAGCGATGGT",2,17,13,0,2,34,600
"CTCTCGACAACCGGAA",1,43,41,2,47,134,7671
"CTCTCGACAATCTAGC",180,436,57,582,37,1292,122645
"CTCTCGACACCTCGTT",1,50,14,4,6,75,3544
"CTCTCGAGTGTAACGG",7,49,26,3,19,104,2503
"CTCTGGTCACGAGGAT",1,9,9,0,3,22,116
"CTGAATGCACCCTCTA",27,64,37,6,20,154,6588
"CTGAATGGTCTACATG",1,57,31,2,19,110,3199
"CTGAATGGTGTTGCCG",8,46,27,51,9,141,7428
"CTGAATGTCTGTACAG",7,63,40,4,33,147,5438
"CTGAGCGAGCTGACAG",7,166,258,5,328,764,67500
"CTGAGCGAGGGAGGCA",0,8,1,0,1,10,32
"CTGAGCGCACAGTCAT",3,37,17,1,4,62,1799
"CTGAGGCAGTGACCTT",2,6,3,0,4,15,43
"CTGAGGCTCATCGGGC",6,65,60,4,58,193,8889
"CTGATCCGTAGCGATG",2,38,21,0,13,74,2611
"CTGATCCTCGCCGAAC",11,243,60,5,49,368,16705
"CTGCAGGCAAGCTACT",3,50,19,1,16,89,2504
"CTGCATCAGCTGACAG",2,89,37,6,255,389,25441
"CTGCATCCAACCACAT",14,656,37,2,29,738,56532
"CTGCATCCAAGGTCGA",0,112,20,0,10,142,8544
"CTGCATCCATAGGAGC",17,77,29,1,8,132,4668
"CTGCATCCATTGTGCA",10,55,24,82,26,197,10745
"CTGCCATCACCAACAT",0,17,11,0,3,31,142
"CTGCCATGTGTGATGG",18,1425,114,61,116,1734,147540
"CTGCCTAGTCCAGCCA",1,1,4,0,1,7,25
"CTGCCTAGTGTTCGAT",3,19,16,3,8,49,153
"CTGCCTATCTAGCAAC",4,334,52,3,12,405,29842
"CTGCGAGAGATTGAGT",5,79,350,9,15,458,40636
"CTGCGAGAGGCTAAAT",12,269,23,2,25,331,27729
"CTGCGAGCATCCGAAT",2,11,7,2,2,24,109
"CTGCGAGGTGCGTTTA",1,20,12,2,18,53,2701
"CTGCGAGGTTTCACAG",6,54,15,2,240,317,27194
"CTGCTCACATTGGGAG",32,46,17,3,8,106,5113
"CTGGACGAGGCGATAC",6,163,33,2,18,222,11788
"CTGGACGAGGTAAGAG",1,11,3,2,3,20,90
"CTGGACGGTCGCGTCA",5,40,84,1,6,136,6649
"CTGGCAGCACTGTGTA",3,70,33,54,13,173,7932
"CTGGCAGCATGACACT",19,84,27,3,16,149,4677
"CTGGTCTTCTCGTCAC",55,65,30,5,15,170,6841
"CTGTACCGTTCATCGA",5,63,23,5,18,114,3269
"CTGTAGAGTATGATCC",1,86,91,7,141,326,26111
"CTGTAGAGTCACTCAA",1,10,5,0,4,20,145
"CTGTAGAGTTGCCAAT",5,63,26,0,16,110,3081
"CTGTATTCAATGGGTG",3,10,1,0,6,20,284
"CTGTCGTAGCAATTCC",3,64,538,6,19,630,62668
"CTGTCGTCAACAGAGC",6,361,251,5,26,649,50726
"CTGTCGTCATTACTCT",4,43,21,1,10,79,3055
"CTGTCGTGTACGGTTT",14,20,14,2,5,55,1585
"CTGTCGTGTCTCCCTA",2,19,8,1,14,44,1573
"CTTACCGAGACCAGAC",8,52,108,10,15,193,11193
"CTTACCGAGCTAGCCC",7,122,329,5,31,494,34764
"CTTACCGCACTAGAGG",6,40,42,5,41,134,6002
"CTTACCGGTATTTCGG",0,13,5,0,0,18,67
"CTTACCGTCCAGTGCG",1,15,3,0,1,20,157
"CTTAGGATCAGCTGTA",0,13,7,0,5,25,88
"CTTAGGATCTCTCCGA",0,7,3,0,1,11,78
"CTTCAATAGACTGGGT",5,65,35,2,167,274,20775
"CTTCAATTCGGAAACG",14,82,183,4,27,310,21828
"CTTCCTTAGGGCAGTT",2,52,70,4,14,142,8926
"CTTCGGTCAGTGTACT",6,43,33,2,17,101,2690
"CTTCTAAAGCATCCCG",0,2,0,1,1,4,18
"CTTCTAAGTCAACACT",4,266,38,3,21,332,21945
"CTTCTAATCAGTGTCA",10,20,12,0,9,51,1585
"CTTCTCTCAGTTAAAG",20,89,46,97,15,267,17423
"CTTGAGAAGCCAGACA",0,8,0,0,1,9,107
"CTTGAGACATTCAGGT",11,71,33,6,131,252,17353
"CTTGAGATCACGGACC",101,89,40,6,26,262,10716
"CTTGATTAGTATCCTG",2,13,11,1,4,31,311
"CTTGATTCAATCGTCA",12,368,124,8,27,539,38215
"CTTTCAAGTTCGGACC",5,96,36,4,193,334,20956
"CTTTCGGAGGCCCGTT",24,86,23,4,14,151,7195
"CTTTCGGAGTGCGCTC",4,23,9,0,3,39,89
"CTTTCGGAGTGGAAGA",2,90,24,5,10,131,5012
"CTTTCGGTCTTCTGGC",2,18,13,1,2,36,728
"GAAACCTCAAATTGCC",21,50,20,2,9,102,2541
"GAAACCTCACTTGACA",4,63,18,3,8,96,2754
"GAAACCTCACTTGGCG",5,93,979,7,10,1094,109718
"GAAACCTCAGCTGTTA",11,73,39,6,17,146,3589
"GAACACTAGGGAGATA",5,58,27,5,61,156,7151
"GAACACTGTTTCTTAC",1,16,6,1,3,27,209
"GAACGTTAGAGTCGAC",8,308,35,3,17,371,23546
"GAACGTTAGTACTGGG",30,67,30,3,95,225,14445
"GAACGTTCATGATGCT",128,114,48,9,11,310,22451
"GAACTGTCACATTCTT",12,88,325,4,28,457,35564
"GAAGCCCGTTGGCCTG",47,168,35,2,17,269,11462
"GAAGCGACAGCGTATT",7,53,131,4,142,337,26575
"GAAGCGAGTAGATGTA",5,29,9,29,5,77,4590
"GAAGCGAGTGCAGGAT",11,859,69,4,40,983,84385
"GAAGCGAGTTTCACTT",7,47,39,4,10,107,2822
"GAAGGGTAGTCATGAA",4,63,19,4,25,115,3709
"GAAGGGTCATACCAGT",10,47,108,2,45,212,13452
"GAAGGGTCATGAGGGT",0,18,17,0,5,40,835
"GAAGGGTTCACCGGTG",8,73,121,4,16,222,14913
"GAAGTAACAGGACGAT",5,71,220,5,14,315,27945
"GAATAGAAGACCTTTG",4,21,17,2,4,48,365
"GAATCACGTCGGCTAC",2,34,28,0,12,76,1002
"GAATCACTCCATTGGA",9,93,146,11,153,412,31013
"GAATCACTCGGTTGTA",3,230,78,5,23,339,20245
"GAATCACTCTCGCAGG",3,82,22,2,18,127,5316
"GAATCGTAGCTTACGT",82,379,45,293,26,825,71025
"GAATCGTTCCGGTAAT",9,76,540,2,23,650,68596
"GACAGCCAGTCATAGA",0,19,6,2,5,32,417
"GACAGCCTCACGATAC",8,96,33,9,16,162,4519
"GACAGCCTCTCCAAGA",8,44,12,1,19,84,1463
"GACATCAAGTAGCTCT",16,238,31,2,20,307,17438
"GACATCACAATCTAGC",7,59,60,7,14,147,5929
"GACATCATCACGTAGT",1,19,7,2,3,32,781
"GACCAATAGAGGTCGT",21,82,34,2,7,146,6368
"GACCCAGGTTATGTGC",4,62,87,5,243,401,35218
"GACCCTTCATCCCACT",7,74,32,4,192,309,22330
"GACCCTTCATGACGAG",1,50,50,3,20,124,3004
"GACCCTTGTGGCTGAA",14,183,38,6,17,258,12940
"GACCCTTTCGAACTCA",6,30,9,2,4,51,1163
"GACCGTGAGGCTTAAA",8,82,27,99,10,226,15174
"GACCGTGAGTCTTGGT",6,156,23,7,16,208,10079
"GACCTTCCAACACAAA",4,47,15,3,101,170,8618
"GACGCTGGTAGAGACC",30,48,21,3,23,125,4469
"GACGCTGTCATCTCTA",17,74,30,4,318,443,35191
"GACGCTGTCGAATGCT",9,43,33,1,93,179,5667
"GACGTTAAGTGATAGT",4,77,134,6,24,245,13539
"GACTATGAGGTATCTC",10,73,33,3,59,178,9123
"GACTATGCAAATAAGC",3,54,33,4,15,109,1746
"GACTCAAAGCAGATAT",9,72,41,9,23,154,2082
"GACTCAAAGTCAGAGC",109,1336,213,50,39,1747,122061
"GACTCAACAGCTTCCT",1,26,7,0,2,36,450
"GACTCAAGTGAGTTGG",3,21,11,63,11,109,7474
"GACTCAAGTGTCATTG",10,45,37,3,19,114,2913
"GACTGATCAAGGCTTT",7,63,77,7,11,165,8027
"GACTGATCATTGAGGG",10,582,115,10,13,730,62325
"GACTTCCCAAGAGGTC",4,148,12,7,16,187,12195
"GAGACCCAGCCGGAAT",2,41,10,1,4,58,2874
"GAGACCCGTCCTGTCT",4,64,34,4,14,120,4475
"GAGACCCTCGCATTGA",17,45,21,3,27,113,3090
"GAGAGGTGTTCCGGTG",2,43,10,2,4,61,2653
"GAGATGGCAGCATTGT",4,112,27,1,22,166,7109
"GAGATGGTCGATGCAT",0,8,4,1,2,15,363
"GAGCCTGAGTGCAGGT",8,262,23,6,11,310,22567
"GAGCCTGCAAATGATG",8,73,903,6,32,1022,100834
"GAGCCTGGTAGGTAGC",7,72,19,2,8,108,4472
"GAGCCTGTCCTATGGA",13,56,26,29,16,140,2990
"GAGCCTGTCTTCACGC",6,310,287,8,30,641,56635
"GAGCTGCAGGGACAGG",10,62,23,2,7,104,3083
"GAGCTGCCAGCATTGT",2,107,23,1,14,147,7827
"GAGGCAAAGCTAGATA",4,44,24,5,16,93,2869
"GAGGCCTCAGCTGAAG",3,88,9,1,6,107,7697
"GAGGCCTGTGTTGATC",4,57,206,3,191,461,42476
"GAGGCCTTCACGATCA",3,43,314,2,20,382,31167
"GAGGGATAGACCACGA",10,88,41,2,26,167,2831
"GAGGGATTCCATGATG",1,2,8,0,1,12,68
"GAGGGTAAGCTATCCA",3,12,2,2,4,23,1315
"GAGGGTAAGCTTCATG",5,52,114,2,12,185,11913
"GAGGGTACAAACAGGC",6,58,30,3,28,125,2879
"GAGGGTACAAGCTCTA",4,15,5,1,11,36,531
"GAGGGTACATCAGCAT",6,286,34,3,22,351,26513
"GAGTCATGTACGAAAT",7,1106,68,2,30,1213,92261
"GAGTCATGTGAACTAA",1,7,2,2,30,42,1971
"GAGTCATTCTTTGGAG",10,76,47,3,19,155,6938
"GAGTCTAGTATGACAA",5,79,33,5,15,137,3403
"GAGTCTAGTGTATTCG",8,48,93,4,13,166,9310
"GAGTCTATCCACACCT",1,42,17,2,8,70,415
"GAGTGAGCAACTAGAA",12,102,22,1,18,155,5640
"GAGTGTTCAAGCGCAA",0,12,4,1,4,21,114
"GAGTTACCAGCAGTAG",1,18,6,2,5,32,869
"GAGTTACGTAGAATGT",8,66,171,4,13,262,20546
"GAGTTACTCTCTGCTG",5,69,132,7,21,234,14713
"GAGTTGTAGGGTACAC",0,9,2,0,4,15,45
"GAGTTGTGTACCATAC",7,254,22,3,14,300,17768
"GAGTTGTTCGTAGGAG",8,241,45,5,21,320,18743
"GAGTTTGAGAGAGGTA",11,62,541,1,59,674,74935
"GAGTTTGCACAACGAG",8,85,17,2,16,128,3537
"GAGTTTGTCCGCACGA",8,382,56,2,16,464,33921
"GATAGAATCAACGAGG",9,66,307,4,15,401,29088
"GATAGCTAGATTGTGA",3,83,12,3,10,111,9021
"GATAGCTCAGGTCCGT",2,42,38,1,19,102,3039
"GATCACACAAGATGTA",2,57,91,4,10,164,8205
"GATCACAGTGGCGCTT",8,124,30,3,12,177,6528
"GATCAGTCAATCCAGT",9,168,56,5,20,258,10879
"GATCAGTTCAAAGCCT",9,45,28,8,16,106,2601
"GATCAGTTCATGCCAA",5,108,42,4,24,183,5342
"GATCATGAGGAAAGTG",10,84,43,5,13,155,3468
"GATCATGAGTGTTCAC",2,15,8,1,1,27,651
"GATCATGCAGTGTGGA",7,74,279,3,28,391,31675
"GATCCCTCACGACGTC",2,25,180,2,18,227,21324
"GATCCCTTCTGCGAGC",4,68,556,6,299,933,85480
"GATCGTAAGATCCAAA",3,40,24,1,20,88,1788
"GATCGTAAGCCGAACA",1,17,8,1,3,30,934
"GATCGTAAGGCGTCCT",1,10,2,1,13,27,167
"GATCGTACAGCTACCG",4,579,34,3,19,639,56450
"GATGACTAGGGTCTTT",3,82,33,14,18,150,3704
"GATGATCGTACCGTGC",3,16,3,1,7,30,698
"GATGATCTCGCGTCGA",7,31,146,3,12,199,5594
"GATGCTATCCTCAGGG",7,72,240,4,16,339,28577
"GATGCTATCGAGTGAG",8,1136,49,4,26,1223,106543
"GATGGAGGTATGAGCG",13,967,70,7,27,1084,88928
"GATGGAGTCGAGTCTA",6,751,66,2,21,846,63518
"GATGGAGTCTGAATCG",7,68,15,2,12,104,2912
"GATGTTGGTTGAGAGC",2,59,368,8,18,455,43368
"GATGTTGTCATGGGAG",5,45,21,3,8,82,1355
"GATGTTGTCTCCAATT",53,122,27,5,14,221,11875
"GATTCGAAGAGATGCC",6,195,22,4,9,236,17136
"GATTCGAGTGCTTATG",5,70,91,4,46,216,12411
"GATTCGATCAAGAGGC",4,318,25,1,9,357,28096
"GATTCTTAGAAACTGT",2,18,4,16,6,46,1522
"GATTCTTCAGGCTTGC",7,79,31,3,13,133,4612
"GATTGGTAGCACGGAT",3,64,152,3,13,235,18636
"GATTTCTAGTTCATGC",7,184,33,2,7,233,21100
"GATTTCTTCCAATGCA",2,49,22,1,7,81,1074
"GATTTCTTCTTCTAAC",6,124,33,4,14,181,9063
"GCAACATGTCACTTCC",10,62,245,3,15,335,31981
"GCAACATTCTCCGTGT",1,10,6,1,2,20,38
"GCAACCGAGTGAGCCA",7,51,47,2,14,121,4267
"GCACATAAGTCGAAGC",5,71,124,4,149,353,26904
"GCACATAGTCGCATCG",6,55,17,1,14,93,1579
"GCACATATCGAGATGG",5,64,61,5,110,245,15365
"GCACGGTTCTGTCGTC",0,10,4,0,5,19,42
"GCACGTGAGTAGGTTA",27,93,42,6,18,186,5824
"GCACGTGGTCAGTCCG",1,12,4,2,6,25,95
"GCACTAAAGAGGTCGT",2,135,26,5,11,179,7966
"GCACTAAAGATCCAAA",2,22,5,0,6,35,111
"GCACTAACAGAGGAAA",2,22,4,1,5,34,249
"GCAGCCAAGAGTATAC",3,119,32,5,18,177,8519
"GCAGCCATCTCCAAGA",7,61,21,2,20,111,1963
"GCAGCTGTCAGCGCGT",1,41,23,4,12,81,1737
"GCAGGCTAGGGCTTCC",0,44,29,4,7,84,2473
"GCAGGCTTCTTCGATT",3,10,8,1,1,23,341
"GCAGTTAAGACAACTA",10,175,35,6,18,244,11469
"GCAGTTAGTTGCTAGT",13,59,18,7,12,109,6271
"GCATCGGCAGAGACTG",130,43,14,1,19,207,9685
"GCATCTCCACGGTAGA",4,65,436,5,21,531,45291
"GCATGATAGTTCACTG",1,53,43,4,11,112,3573
"GCATGATGTGCAACAG",10,70,66,2,9,157,7276
"GCATTAGCATACCGTA",5,65,36,5,80,191,9357
"GCCAACGCAAGCCATT",5,38,16,3,7,69,1741
"GCCAACGCAGTAACGG",3,271,44,5,32,355,23334
"GCCAACGGTCGTGTTA",5,119,19,1,11,155,5584
"GCCAACGTCATGCCCT",28,55,37,11,20,151,3638
"GCCAACGTCGCCGAAC",5,51,20,3,12,91,1552
"GCCAACGTCGGATAAA",0,9,1,0,1,11,539
"GCCAGCACAGTCAGTT",4,87,27,5,12,135,5099
"GCCAGGTGTTCTCACC",17,34,15,3,7,76,2353
"GCCAGTGCAAGTGGGT",1,16,4,0,4,25,417
"GCCAGTGCAGATCACT",5,66,23,4,8,106,4159
"GCCAGTGTCGAGTCCG",8,68,32,2,13,123,1404
"GCCAGTGTCTGATTCT",49,1059,80,8,30,1226,84324
"GCCATGGCACGGTGTC",1,100,16,0,10,127,4736
"GCCATGGGTAGAATAC",2,51,135,2,28,218,9774
"GCCATGGGTCGCAACC",70,13,10,3,6,102,4728
"GCCATTCTCATGAAAG",10,303,37,2,15,367,21078
"GCCCAGAAGAGGACTC",6,147,656,6,204,1019,91938
"GCCCAGATCAAACGTC",2,47,184,4,14,251,18179
"GCCCGAAAGCTGACCC",15,71,216,2,8,312,22171
"GCCGATGAGTAACCGG",5,62,69,2,17,155,7963
"GCCGATGTCCGATCGG",49,69,22,319,19,478,33263
"GCCGTGACAAGCGCAA",0,5,0,0,6,11,215
"GCCTGTTCAGAGAGGG",4,57,114,3,9,187,10874
"GCCTGTTCATCCGATA",4,48,30,5,17,104,1871
"GCCTGTTCATGTTCAG",6,42,127,4,8,187,13587
"GCCTGTTGTACAGCGA",0,51,101,1,9,162,12241
"GCCTGTTGTGAGTTTC",5,40,38,2,12,97,2558
"GCGAGAAAGCATGGGT",2,453,75,6,11,547,48169
"GCGAGAAGTCAATGGG",0,16,3,0,2,21,62
"GCGAGAATCCTATTTG",10,64,104,3,28,209,13705
"GCGAGAATCCTGCTAC",3,59,45,4,17,128,5447
"GCGATCGAGGGTGGGA",0,11,6,1,1,19,74
"GCGATCGTCCAATCCC",3,370,52,6,14,445,34177
"GCGGAAAGTATGGTAA",6,164,28,2,13,213,9291
"GCGGAAATCAAGTGTC",27,64,33,10,11,145,5135
"GCGGAAATCATGTCTT",5,67,376,10,31,489,43548
"GCGGAAATCTGCATGA",8,71,584,2,26,691,60725
"GCGGATCCAGAGAGGG",1,32,63,5,3,104,9432
"GCGGATCCATGGCTAT",3,64,19,9,14,109,3424
"GCGTGCAAGGCTGGAT",3,63,18,1,13,98,3071
"GCGTGCACAGCTACTA",2,38,8,0,4,52,2578
"GCGTTTCAGTTGAAGT",1,11,10,1,8,31,511
"GCTACAAAGATACAGT",4,61,15,2,4,86,2643
"GCTACAACAATTCTCT",3,45,43,4,29,124,4238
"GCTACAACAGTAGTGG",2,57,19,3,6,87,4030
"GCTACCTCAAGACCGA",4,68,23,2,9,106,3806
"GCTACCTCAAGTTCGT",5,197,64,2,20,288,17505
"GCTACCTGTATCATGC",12,141,34,3,18,208,11676
"GCTACCTTCTTCCCGA",0,35,10,2,13,60,1463
"GCTGGGTAGTCCCTAA",5,43,38,1,41,128,5619
"GCTGGGTGTTATGTCG",3,46,190,3,15,257,18754
"GCTTCACGTGTCACAT",41,488,70,3,61,663,53644
"GCTTCACGTTCCTAAG",4,38,87,3,9,141,10041
"GCTTCACTCGCCCAGA",5,44,21,3,6,79,1935
"GCTTGGGAGGTGCCAA",12,54,23,1,13,103,2215
"GCTTGGGAGTATGGAT",2,22,23,4,8,59,2063
"GCTTGGGCAAAGGCGT",1,66,24,6,15,112,3378
"GCTTGGGCACTTCAGA",1,21,9,0,3,34,121
"GCTTGGGTCGACGAGA",1,56,19,2,9,87,2026
"GCTTTCGAGGCGTTAG",20,1548,121,5,29,1723,115354
"GCTTTCGAGTGGTTGG",3,145,24,1,13,186,13328
"GCTTTCGGTGCCTAAT",3,124,25,1,15,168,9184
"GCTTTCGTCGTGGGAA",0,3,4,0,2,9,50
"GGAACCCAGCAATTAG",5,47,17,1,8,78,632
"GGAACCCAGTTGCCTA",9,71,49,1,8,138,4965
"GGAACCCGTATCTTCT",5,56,27,2,18,108,2031
"GGAACCCGTGATACTC",5,365,48,5,14,437,26670
"GGAACCCTCGCGGACT",2,23,27,0,11,63,2495
"GGAATCTAGAGTCACG",2,39,9,2,7,59,2080
"GGAATCTAGTGGTGAC",4,59,13,1,32,109,2964
"GGAATCTGTACGTGAG",10,298,35,2,17,362,23775
"GGAATGGGTACGATCT",4,57,26,2,161,250,15645
"GGACGTCCACGCGTCA",1,11,8,1,0,21,343
"GGAGAACCAGCATACT",4,65,225,5,55,354,23873
"GGAGATGAGTAGCCAG",2,17,9,1,9,38,134
"GGAGCAACACTACCGG",3,277,64,3,15,362,26771
"GGAGCAAGTATGCTAC",74,383,61,3,21,542,29919
"GGAGCAATCGGAAACG",2,87,36,4,12,141,3531
"GGAGGATCAGCAGACA",8,56,236,2,18,320,23397
"GGAGGATCATCAGCGC",7,23,18,2,41,91,4341
"GGAGGATTCGATACAC",6,43,20,2,23,94,2489
"GGAGGTACACAGCCTG",7,105,19,5,19,155,6949
"GGAGGTACATTGTGCA",6,66,26,5,281,384,30267
"GGAGGTATCAGCTTGA",5,73,45,5,128,256,16261
"GGATCTAGTCACGTGC",3,44,27,4,59,137,6169
"GGATGTTGTAAGTCAA",4,68,264,3,18,357,27118
"GGATGTTTCAATCGGT",3,65,318,2,11,399,32763
"GGCACGTGTGCTCGTG",4,44,15,4,27,94,2626
"GGCACGTTCGCCTTTG",0,8,30,1,5,44,1495
"GGCAGTCAGAGGGTGG",4,49,373,0,7,433,19425
"GGCTGTGAGCCGGAAT",2,46,126,2,3,179,6502
"GGCTGTGAGGAAGTAG",10,21,11,0,8,50,568
"GGCTTGGAGTTGCTCA",2,59,336,0,79,476,20503
"GGCTTGGTCTCCATAT",16,19,5,2,7,49,1024
"GGCTTTCGTAGCACGA",1,30,18,2,1,52,1345
"GGCTTTCGTATACGGG",1,2,6,0,0,9,234
"GGGAAGTAGACTTCGT",5,51,33,5,27,121,5270
"GGGAAGTAGGGTAGCT",3,35,19,0,15,72,1173
"GGGACAAAGCCTTTGA",3,38,78,1,9,129,7655
"GGGACAACAGAGTTCT",2,18,14,1,8,43,119
"GGGACTCAGAAGTATC",4,437,41,5,13,500,31364
"GGGACTCTCTAGGCAT",2,25,22,4,17,70,4201
"GGGAGATAGAGTTGCG",3,53,17,0,71,144,6131
"GGGAGATGTACTGACT",4,46,28,5,18,101,1812
"GGGATCCCATCCGGCA",5,60,635,5,47,752,61460
"GGGATCCGTCTCAAGT",8,383,43,7,16,457,32016
"GGGATCCTCCAGCTCT",3,65,24,2,10,104,3752
"GGGATCCTCGAAGCCC",13,32,17,1,11,74,3191
"GGGATGAAGTGGTGGT",7,91,17,1,11,127,8095
"GGGATGACATCTCAAG",68,57,102,7,142,376,31009
"GGGATGACATGGCTGC",3,60,189,3,22,277,19388
"GGGATGAGTATACCCA",1,6,2,0,5,14,286
"GGGCCATGTAGCGATG",4,39,18,5,12,78,1935
"GGGCCATGTGTTACTG",5,49,13,3,9,79,1360
"GGGCCATTCTCTATGT",2,22,2,3,3,32,1333
"GGGCGTTAGACATAAC",49,111,32,2,26,220,6743
"GGGCGTTAGGGCTGAT",4,37,71,5,122,239,18979
"GGGCGTTCAATCCTAG",4,37,18,0,12,71,1199
"GGGCTACAGAAGCCTG",3,50,52,2,15,122,3200
"GGGCTACCAGTGGGTA",6,60,22,10,13,111,2274
"GGGCTCAAGAGGGTAA",12,1279,113,15,35,1454,112302
"GGGCTCACACCCTAAA",6,312,33,4,20,375,21366
"GGGCTCAGTCATCAGT",0,12,4,1,6,23,250
"GGGCTCATCGGACAAG",4,67,85,2,58,216,14019
"GGGTAGATCCAACTGA",5,68,34,3,111,221,13736
"GGGTATTAGAAACTCA",13,130,26,1,21,191,7708
"GGGTATTAGCGCCCAT",1,48,35,2,69,155,6249
"GGGTATTTCACTTCTA",4,103,18,3,8,136,7791
"GGGTATTTCTATACGG",50,216,30,4,26,326,20068
"GGGTCACCAAAGGATT",0,4,3,0,0,7,42
"GGGTCACCAGCATTGT",196,116,29,5,18,364,19335
"GGGTCACCATAACTCG",6,53,25,4,18,106,2931
"GGGTCACGTTCACGAT",9,67,164,5,182,427,35681
"GGGTCTGTCGTAGCCG",6,602,40,7,23,678,40956
"GGGTCTGTCGTCCTTG",2,59,26,91,22,200,10246
"GGGTGAAGTTGCATCA",19,27,23,5,14,88,1888
"GGGTGAATCTCCCATG",228,227,25,3,25,508,29666
"GGGTTATAGAGTCAGC",8,16,7,0,2,33,1115
"GGGTTATGTTTCAGAC",5,478,26,4,23,536,38726
"GGGTTATTCACCTCGT",6,52,220,5,74,357,28906
"GGGTTATTCATTATCC",3,81,28,9,195,316,20511
"GGGTTTAAGTCACAGG",3,90,18,5,11,127,4919
"GGGTTTACACACCAGC",3,64,470,5,20,562,51056
"GGGTTTATCCAATGCA",4,74,43,0,8,129,3949
"GGTAACTCATGACAGG",10,75,494,11,26,616,49933
"GGTAACTCATTGTACG",7,155,46,5,16,229,7948
"GGTAACTGTGAGACCA",4,20,11,4,7,46,624
"GGTAACTTCACTTCTA",7,159,34,3,10,213,15869
"GGTAATCAGACACACG",0,4,4,0,1,9,25
"GGTAATCAGACCTGGA",5,37,59,3,19,123,4973
"GGTAATCAGCGGGTAT",11,153,39,1,20,224,11597
"GGTAATCCACAAGCAG",0,23,5,0,7,35,510
"GGTAATCTCACCGCTT",5,238,24,6,16,289,18847
"GGTAGAGAGGGTCAAC",4,90,50,5,140,289,13872
"GGTAGAGCAGCAGACA",7,173,21,1,10,212,10750
"GGTAGAGGTCACTTCC",4,50,19,3,17,93,2341
"GGTAGAGGTGATTGGG",8,56,153,3,116,336,26842
"GGTCACGCAACACTAC",6,58,16,3,13,96,1860
"GGTCACGCACCAGTAT",8,73,23,2,110,216,11120
"GGTCACGGTTAAGCAA",5,57,91,1,14,168,5527
"GGTCACGTCTAGCATG",3,44,241,2,13,303,20381
"GGTCTGGAGGATGTTA",1,47,30,7,14,99,2294
"GGTCTGGCAAATACGA",7,139,325,4,272,747,62027
"GGTGAAGAGTCATGGG",8,73,35,7,17,140,3437
"GGTGAAGCAGTGCGCT",5,56,34,5,49,149,6999
"GGTGATTGTATCCCAA",13,84,342,5,131,575,37404
"GGTGATTGTCGCGTCA",0,16,5,1,19,41,1378
"GGTGATTGTTCAGCGC",8,222,55,5,20,310,19370
"GGTGGCTGTTCGAAGG",4,51,30,7,25,117,2485
"GGTGTCGGTACTGCGC",0,31,6,2,6,45,1457
"GGTGTTAAGAGGATGA",7,239,27,2,16,291,17776
"GGTGTTAAGCGTTGTT",5,331,66,5,18,425,32385
"GGTGTTAAGGTAATCA",4,14,9,2,1,30,283
"GGTGTTACATGACGGA",5,41,23,0,40,109,3916
"GGTGTTATCATTGTTC",0,2,11,1,2,16,41
"GGTGTTATCGTTCCTG",2,13,3,1,1,20,100
"GGTTAACAGACCATAA",37,63,37,1,23,161,4500
"GGTTAACAGAGAGGTA",9,64,119,7,20,219,10134
"GGTTAACCACGCCACA",7,352,41,8,25,433,22959
"GGTTCTCGTGGACTGA",4,61,17,4,19,105,2958
"GGTTCTCTCGGAGCAA",7,68,22,1,13,111,3178
"GGTTGTAAGGTTAAAC",3,34,28,2,7,74,1216
"GGTTGTACACATAGCT",7,56,19,2,7,91,3558
"GGTTGTAGTAAGATCA",3,117,14,2,5,141,9759
"GGTTGTATCCGGGACT",4,57,29,5,156,251,17153
"GTAACACTCTGGCTGG",0,13,7,0,3,23,124
"GTAACCAAGTGTTCCA",8,327,141,2,19,497,30590
"GTAACCACAGCTCCTT",6,62,21,4,14,107,2539
"GTAACCATCGTAGGAG",8,87,390,5,169,659,62639
"GTAATCGAGTAGACCG",5,48,56,6,18,133,5679
"GTAATGCGTCTGCGCA",9,100,49,412,24,594,36358
"GTACAGTAGTGGTCAG",4,125,17,3,19,168,10313
"GTAGAAAAGCATCCTA",6,19,53,0,4,82,3571
"GTAGATCAGGGAGGAC",2,62,360,1,14,439,37312
"GTAGATCGTCAAAGAT",5,36,24,0,109,174,10683
"GTAGCTAAGTATTGCC",5,63,111,5,23,207,8789
"GTAGCTAGTCTTGAAC",5,55,28,5,14,107,2177
"GTAGCTATCACGGTCG",1,7,1,1,2,12,55
"GTAGGAGAGCTTGTTG",2,43,22,2,11,80,1447
"GTAGGAGAGTTGCCTA",2,35,23,72,14,146,7500
"GTAGGAGGTGCCTTTC",3,102,27,3,15,150,6648
"GTAGGAGTCCACAAGT",3,73,31,3,13,123,4613
"GTAGGTTAGATTAGCA",3,32,24,2,15,76,1883
"GTAGGTTTCTCCCAAC",7,67,30,10,17,131,1894
"GTAGTACGTATTGACC",4,22,9,2,10,47,712
"GTAGTACGTCCCAAAT",6,84,487,5,25,607,48009
"GTATTTCAGGCACTAG",3,56,14,1,12,86,2681
"GTATTTCCAGAGGCTA",9,66,23,3,64,165,7361
"GTATTTCTCACGGGCT",9,113,69,7,77,275,13580
"GTCAAACAGCACTCCG",14,86,20,4,8,132,4388
"GTCAAGTAGAGAATCT",2,13,7,1,1,24,47
"GTCACTCAGGCGTTGA",3,29,14,3,11,60,1284
"GTCACTCCAATTAGGA",8,55,153,5,31,252,11954
"GTCACTCTCAACTTTC",5,56,22,4,21,108,3304
"GTCAGCGAGCATTGAA",17,46,24,3,9,99,1653
"GTCAGCGCACCCATAA",1,4,1,0,0,6,23
"GTCAGCGCATACCAGT",7,70,57,2,18,154,6884
"GTCAGCGTCAATGTCG",2,39,17,3,10,71,991
"GTCAGCGTCAGCATTG",3,33,10,2,51,99,4244
"GTCAGCGTCGGTCTGG",0,55,7,0,4,66,1461
"GTCATCCAGCTCCATA",0,20,51,2,7,80,2694
"GTCATCCAGGCGTTGA",147,149,24,3,16,339,21406
"GTCATCCAGTGCCTCG",1,7,11,2,4,25,370
"GTCATCCTCAGCGCAC",5,43,19,2,8,77,1476
"GTCATGAGTCCTCCTA",2,39,35,2,16,94,2032
"GTCATTTAGATGATTG",8,49,22,3,19,101,1527
"GTCATTTTCGCATAGT",5,18,10,1,6,40,106
"GTCCACTCACTTCATT",1,156,20,1,12,190,15043
"GTCCACTTCCATCTCG",5,65,27,4,16,117,4181
"GTCCCATAGGTCATAA",15,2603,206,11,54,2889,243442
"GTCCCATCAATGGCCC",0,5,10,0,1,16,142
"GTCCTCAAGAGATTCA",12,89,54,5,9,169,4458
"GTCCTCAAGTACCGGA",4,58,197,4,11,274,14572
"GTCCTCAAGTGAGTTA",10,42,22,1,119,194,10824
"GTCCTCACAAGTGGCA",6,213,45,2,18,284,10653
"GTCGAATCAATTGAGA",5,94,20,3,14,136,5911
"GTCGAATTCCCTGGTT",4,53,27,3,75,162,8033
"GTCGTAACAACACGAG",2,11,4,0,4,21,561
"GTCGTAATCCTCACGT",2,32,232,1,5,272,18239
"GTCGTTCCACATACTG",3,54,18,5,79,159,5708
"GTCGTTCGTCATCGGC",3,47,81,0,9,140,4809
"GTCGTTCTCACGATCA",1,83,15,1,13,113,5065
"GTCTACCGTCACTCAA",7,176,28,5,20,236,12005
"GTCTAGAAGCTAAATG",22,101,44,1,22,190,6013
"GTCTAGAGTCTTCGAA",2,104,17,1,17,141,6444
"GTCTCACCAAGACGGT",5,55,17,5,22,104,1923
"GTCTCACCACGGGCTT",2,24,16,1,5,48,877
"GTCTCACGTGGGTCAA",3,27,31,2,9,72,2728
"GTCTCACGTTCTAAGC",12,315,125,8,14,474,30608
"GTCTCACTCACGGTCG",10,79,101,8,23,221,7871
"GTCTGTCCACTCATAG",2,67,18,5,9,101,5211
"GTCTGTCCAGCTACTA",3,31,17,28,8,87,4277
"GTCTGTCCAGCTCTGG",55,76,43,2,16,192,4950
"GTCTGTCTCCCAACTC",8,93,279,8,140,528,31782
"GTCTTTATCGATACAC",9,91,25,3,196,324,24501
"GTGACGCAGTTACGGG",3,7,7,5,3,25,666
"GTGACGCGTCTAGGCC",3,43,19,2,7,74,1100
"GTGACGCTCAAGCCAT",1,66,32,6,214,319,21606
"GTGACGCTCGGCTTGG",13,50,29,56,13,161,5532
"GTGAGCCAGAATTGTG",5,58,116,4,139,322,26346
"GTGAGCCGTAGCACGA",4,142,34,5,12,197,9478
"GTGAGGACAATAGTGA",5,65,21,2,13,106,2300
"GTGAGGAGTCCAGAAG",4,64,17,4,10,99,5374
"GTGAGGAGTTAGCGGA",5,95,23,2,13,138,6578
"GTGAGTTCAAGGCTTT",4,46,23,1,21,95,2446
"GTGATGTGTCTGCAAT",0,5,4,2,0,11,31
"GTGCACGCACAGCATT",6,62,23,43,20,154,5947
"GTGCACGGTAACTGCT",0,8,4,0,1,13,89
"GTGCAGCGTTTGGCTA",5,86,22,2,13,128,4293
"GTGCAGCTCATGTCAG",2,84,32,1,9,128,6904
"GTGCTGGCATCCGAGC",2,8,7,1,4,22,110
"GTGCTGGCATGCCATA",6,73,28,4,19,130,3097
"GTGCTGGTCATTCACT",2,36,26,4,15,83,3598
"GTGCTTCAGGTAGTCG",3,13,6,0,3,25,289
"GTGCTTCAGTACTGTC",4,134,17,2,9,166,8588
"GTGCTTCAGTCAGGGT",1,14,3,0,5,23,911
"GTGCTTCCATCATCTT",6,84,574,3,151,818,73681
"GTGCTTCGTGGAGGTT",2,5,1,1,1,10,31
"GTGGAAGAGGTGAGCT",7,48,47,2,86,190,12904
"GTGGAAGCAAGCAATA",3,46,23,3,10,85,1981
"GTGGAAGGTAACATAG",8,298,37,10,22,375,22604
"GTGGAAGTCACAACCA",8,60,24,4,18,114,1309
"GTGGAGAAGGTAAGAG",6,130,38,53,11,238,11621
"GTGGAGAGTGGACAGT",0,10,3,2,10,25,1345
"GTGGCGTGTTCCATTT",3,45,93,4,13,158,8466
"GTGGCGTGTTCGGCTG",0,7,4,1,2,14,41
"GTGGGAATCTCGGCTT",5,61,22,3,287,378,38220
"GTGTCCTAGTTCCAGT",6,59,55,1,6,127,4684
"GTGTCCTCAAGTTGGG",3,67,23,4,20,117,2710
"GTGTCCTTCGATTTCT",3,25,5,2,3,38,99
"GTGTGATAGATTGAGT",6,285,20,7,20,338,24900
"GTGTGATGTCTCTCAC",520,248,43,6,28,845,61408
"GTGTGATTCCCGTTGT",1,9,7,0,6,23,926
"GTGTGATTCTAAGCCA",3,54,23,1,20,101,1391
"GTGTGGCAGTGAATAC",9,492,62,5,17,585,38874
"GTGTTAGCACAAAGTA",5,23,24,2,83,137,9522
"GTGTTCCCAACAACAA",2,57,134,4,21,218,14956
"GTGTTCCTCCTTGACC",67,87,27,2,10,193,10600
"GTTACAGAGTAAATGC",3,23,13,2,3,44,145
"GTTACCCAGACCAAGC",3,11,4,0,8,26,460
"GTTACGAAGGGTACGT",6,64,34,4,10,118,3896
"GTTACGACAATGTCTG",7,68,76,5,18,174,10251
"GTTACGAGTCGCAACC",21,18,8,1,8,56,2949
"GTTACGATCCATTTAC",5,47,17,0,49,118,4826
"GTTAGACCACCAGCCA",1,17,7,1,2,28,449
"GTTAGTGAGCGGTATG",9,81,237,6,25,358,24238
"GTTAGTGCACGTCGGT",5,35,22,0,119,181,12906
"GTTAGTGTCCGAGGCT",5,62,38,1,158,264,17084
"GTTAGTGTCGGTAAGG",4,31,12,1,6,54,2477
"GTTATGGAGTCACAGG",6,56,86,1,18,167,8086
"GTTATGGCAGGAGGTT",4,114,27,5,14,164,8548
"GTTATGGGTTACGTAC",8,66,238,3,23,338,31838
"GTTCATTAGCTCCACG",15,101,37,1,22,176,3018
"GTTCCGTGTAGTTACC",2,28,83,1,42,156,4236
"GTTCTATAGAGGATGA",0,16,12,1,2,31,384
"GTTCTATGTGTTCCTC",3,80,91,4,20,198,10437
"GTTGAACCACGGCACT",2,17,8,1,4,32,309
"GTTGAACTCACGGGCT",78,46,19,4,19,166,7581
"GTTGAACTCCCTTGTG",4,93,44,7,173,321,19474
"GTTGAACTCTGGAAGG",5,45,22,45,17,134,5006
"GTTGCGGAGTACCATC",4,118,24,6,8,160,6576
"GTTGCGGTCGCTCTCA",1,17,6,0,2,26,475
"GTTGTAGAGCCATTGT",6,65,78,2,17,168,11913
"GTTGTGACATGTGGCC",7,70,25,2,67,171,10424
"GTTGTGAGTGCCTGAC",4,34,16,0,13,67,1257
"GTTGTGAGTTGGACTT",4,38,18,3,13,76,1579
"GTTGTGATCCTAGCTC",8,59,83,1,9,160,7262
"GTTTACTAGGTCCTGC",5,64,137,7,15,228,18525
"GTTTACTGTGCAATGG",10,189,60,2,14,275,15297
"GTTTGGAGTGCCCTTT",2,268,29,35,14,348,23420
"GTTTGGAGTTCAATCG",1,6,28,2,0,37,2581
"GTTTGGATCCCTTGTG",8,69,26,3,12,118,2811
"TAACACGAGTAACCTC",18,56,21,2,11,108,2964
"TAACACGGTTAGAAAC",42,69,27,4,15,157,7084
"TAACCAGAGCGGTATG",4,58,14,1,9,86,2471
"TAACCAGAGTAGTCCT",251,62,31,0,18,362,27029
"TAACCAGAGTTAACAG",4,29,14,1,5,53,1212
"TAACCAGGTAACATGA",9,59,23,2,14,107,2632
"TAACGACCACATGAAA",9,43,17,0,4,73,2370
"TAACGACCATACCACA",7,421,43,4,21,496,33489
"TAACGACGTCTCCCTA",5,82,20,7,9,123,3695
"TAACTTCCAGTGCCTG",10,51,30,3,7,101,3372
"TAACTTCTCGCCTATC",10,76,26,6,20,138,3445
"TAAGCACAGTATAGGT",1,22,11,2,21,57,2187
"TAAGCCAAGGCGAAGG",5,269,25,4,18,321,19092
"TAAGCCAAGTTCCTGA",0,11,1,1,0,13,49
"TAAGCCAGTTCCACGG",6,36,44,1,14,101,4418
"TAAGCCATCAGCACCG",102,113,33,6,15,269,13455
"TAAGCGTAGTTACGTC",8,57,146,8,122,341,22637
"TAAGCGTGTCAGGTGA",3,48,17,0,14,82,2735
"TAAGCGTGTTGCATAC",20,22,6,0,8,56,1860
"TAAGTCGAGGCAGCTA",2,84,18,5,8,117,7885
"TAAGTCGAGTTGCCTA",6,78,25,8,9,126,3006
"TAAGTCGCACGCTTAA",6,62,19,1,28,116,3531
"TAAGTCGGTGCCCACA",4,51,19,5,91,170,9134
"TAAGTCGGTGGTCAAG",4,55,36,1,17,113,2604
"TAAGTCGTCCGAAGGA",7,122,24,4,10,167,7116
"TAATTCCCAGGCATGA",11,158,100,6,93,368,21385
"TAATTCCGTACTAACC",6,72,180,2,19,279,21055
"TACAACGGTTAAGGAT",6,114,290,6,873,1289,127281
"TACAACGTCTTCGACC",1,23,34,1,38,97,8661
"TACAGGTGTCCTCATC",8,280,19,4,15,326,25770
"TACAGGTGTGTCTTAG",5,78,44,1,217,345,25717
"TACAGGTGTTGCCGAC",9,47,21,3,18,98,2194
"TACATTCAGATGCTGG",6,85,17,5,11,124,4789
"TACATTCCAAAGGCAC",1,42,4,0,3,50,2336
"TACATTCCATGCGGTC",4,105,26,3,9,147,8805
"TACCCACGTTGGTAGG",8,59,97,4,78,246,14694
"TACCCGTCAGTGCGCT",1,23,3,1,2,30,1341
"TACCCGTGTTAGTTCG",5,61,33,3,10,112,2617
"TACCGAAAGTAGTCTC",4,46,18,3,5,76,1613
"TACCGAAGTTGATGTC",3,386,82,4,21,496,38968
"TACCGGGAGGCTAGCA",7,68,33,3,607,718,71374
"TACCGGGCATGGTACT",6,61,105,5,10,187,11838
"TACCGGGGTACCGTGC",2,6,1,1,10,20,622
"TACGCTCAGCACTAGG",4,107,18,2,14,145,10993
"TACGCTCTCCATTTGT",3,17,35,0,4,59,3709
"TACGCTCTCCGTGGCA",7,69,173,4,20,273,19255
"TACGGTAAGTCGGCCT",12,99,38,2,27,178,4263
"TACGGTACAATGTCAC",3,27,2,2,1,35,915
"TACGTCCAGAGTATAC",3,49,16,2,6,76,3061
"TACGTCCCACGGTGTC",7,162,37,3,23,232,11299
"TACGTCCTCCGGACGT",6,327,35,3,18,389,24999
"TACGTCCTCGCTCTCA",5,142,67,4,12,230,12654
"TACTGCCAGCAGGTCA",6,70,13,1,70,160,10342
"TACTGCCGTACGCGTC",3,103,16,2,8,132,7724
"TACTTACAGGTTGAGC",0,13,4,0,3,20,321
"TACTTCAAGTGCCCGT",0,19,7,2,1,29,491
"TACTTCAGTCCAGCAC",14,52,26,1,19,112,3210
"TACTTGTCAAATGATG",34,159,32,6,23,254,15254
"TACTTGTCAGCATGCC",6,114,27,3,15,165,10494
"TACTTGTTCAAGAAAC",24,83,32,5,15,159,4605
"TAGACCAAGATAGCTA",14,68,26,5,14,127,2473
"TAGACCATCTTCCCAG",6,675,79,8,33,801,57268
"TAGACTGAGCTACTGT",4,53,20,1,12,90,1510
"TAGACTGGTGACTGAG",6,247,48,4,21,326,23597
"TAGACTGGTTCCACAA",8,76,29,5,115,233,12162
"TAGAGTCTCCAACTGA",8,51,26,5,13,103,2631
"TAGATCGAGAGTCTTC",7,433,74,4,24,542,35868
"TAGCACACATCGCTCT",3,103,20,8,11,145,7055
"TAGCACAGTACAAGCG",11,390,47,6,26,480,29132
"TAGGAGGTCCCGATCT",3,74,37,1,129,244,15118
"TAGGGTTCAAGCGCAA",7,267,100,6,26,406,35027
"TAGGGTTCATGGAGAC",4,74,101,3,17,199,9228
"TAGGGTTGTCACGCTG",15,12,13,0,4,44,3470
"TAGGGTTGTTCCGCGA",4,49,42,3,31,129,7276
"TAGGGTTTCTCAATCT",3,140,32,5,192,372,29134
"TAGGGTTTCTGGGTCG",65,151,27,2,20,265,11418
"TAGGTACCAGGCAATG",12,55,23,3,30,123,3094
"TAGGTACGTCCGTACG",3,42,38,1,13,97,3498
"TAGGTACTCTCTCGCA",6,65,34,7,12,124,2232
"TAGGTTGAGACCCTTA",1,19,7,3,4,34,1105
"TAGGTTGAGGTTACCT",9,70,69,5,224,377,27367
"TAGGTTGCAGTAGAAT",2,44,40,5,21,112,4919
"TAGGTTGCATCAGCTA",6,25,7,1,10,49,267
"TAGGTTGTCACGTAGT",8,50,111,2,12,183,11256
"TAGGTTGTCCATCGTC",5,45,16,5,12,83,1532
"TAGGTTGTCTACAGGT",5,42,15,6,14,82,1037
"TAGTGCAAGAGAGTTT",3,9,4,0,2,18,92
"TAGTGCAGTACAACGG",10,638,38,5,25,716,49402
"TATACCTAGTCGCCCA",4,186,31,7,42,270,15362
"TATACCTCAGAATGTA",6,596,157,6,55,820,59867
"TATATCCCAAATGATG",6,53,116,3,21,199,10040
"TATCAGGTCGACGTCG",19,128,23,5,13,188,8754
"TATCAGGTCTTGTTAC",11,75,38,7,24,155,2245
"TATCCTAGTCAGGCAA",8,690,186,9,17,910,89892
"TATCCTATCATGCGGC",5,50,29,0,160,244,19989
"TATCGCCGTCAAGTTC",1,4,6,0,8,19,104
"TATCTGTCAATAACGA",4,144,28,1,20,197,10464
"TATCTGTGTACACGCC",8,58,86,3,23,178,10529
"TATCTGTGTCTACGAT",7,359,32,6,23,427,29616
"TATCTTGAGAGTCAAT",5,84,27,3,16,135,6126
"TATCTTGAGCTACGTT",4,93,79,4,540,720,59686
"TATCTTGTCTCGGTCT",8,179,68,5,40,300,23124
"TATGTTCCAAGAGCTG",4,44,19,4,11,82,2223
"TATGTTCTCTTCTGGC",4,54,24,3,14,99,2481
"TATTCCAAGGTCCGAA",2,60,46,3,15,126,6472
"TATTCCAAGGTTCCGC",2,56,272,2,43,375,31583
"TATTCCACATGTCGTA",7,72,292,4,16,391,33316
"TATTGCTCAACCGGAA",1,61,24,1,90,177,11055
"TATTGCTTCCCGAAAT",0,139,24,0,6,169,13021
"TATTGCTTCGTGGAAG",3,19,12,2,11,47,746
"TATTGGGCAAATGAAC",9,96,647,4,32,788,68124
"TATTGGGGTGTCCATA",9,315,62,4,19,409,34852
"TATTGGGTCAAGATAG",4,66,29,2,14,115,3428
"TATTTCGCAGGCTTGC",8,112,24,1,22,167,6608
"TATTTCGCATAGATCC",4,181,27,1,15,228,13298
"TATTTCGGTCAAGTTC",3,138,42,5,30,218,11380
"TCAAGACCACCCTATC",4,56,128,1,19,208,10396
"TCAAGCAAGGTTCCGC",60,291,45,3,22,421,25049
"TCAAGCAGTAGCTTTG",139,107,32,2,57,337,23164
"TCAAGTGAGAGTCTTC",4,68,16,1,13,102,4083
"TCAAGTGAGCGCCATC",3,138,20,4,24,189,8801
"TCAATCTAGTCCCTAA",13,132,40,6,23,214,7471
"TCAATCTGTACCTAAC",8,189,464,4,151,816,81282
"TCAATCTGTCGTATTG",3,27,8,2,16,56,659
"TCAATCTTCCTAAGTG",8,362,36,4,27,437,28492
"TCAATCTTCCTTTAGT",3,15,14,3,7,42,270
"TCAATTCAGGCTTAAA",5,48,13,4,13,83,3382
"TCAATTCGTCTTGAGT",5,54,24,4,20,107,2253
"TCAATTCTCATAGCAC",7,96,96,5,190,394,29210
"TCACAAGGTCAGTTTG",4,31,74,3,10,122,8363
"TCACAAGTCCTGGCTT",0,13,8,0,3,24,71
"TCACACCCAGTCGCTG",3,63,37,0,91,194,8777
"TCACACCGTATGACAA",126,482,39,8,31,686,48571
"TCACACCTCAGACCCG",7,65,127,2,30,231,13023
"TCACACCTCCTTGGAA",13,83,209,7,27,339,26090
"TCACATTAGCCTCTTC",10,78,156,7,51,302,21101
"TCACATTAGTGGATAT",6,27,17,1,4,55,161
"TCACATTCATGTGACT",116,788,54,11,54,1023,87919
"TCACATTGTCTAGGTT",11,93,39,4,28,175,4122
"TCACATTGTGAAGCGT",1,10,10,0,5,26,609
"TCACATTGTTTACGTG",10,70,65,4,8,157,5662
"TCACGCTCAATCAAGA",8,54,185,1,19,267,22698
"TCACGCTCATCACAGT",1,12,2,1,19,35,2113
"TCACGGGCATTGAAAG",2,91,32,3,10,138,6662
"TCACGGGGTCACTGAT",5,86,35,1,14,141,6770
"TCACTATTCTAAGCGT",5,52,13,2,6,78,2731
"TCACTCGGTAGGCAGT",0,32,3,0,3,38,2419
"TCACTCGTCTCGACGG",22,116,24,3,14,179,7030
"TCAGCAAAGGGTTTCT",4,58,31,5,10,108,2181
"TCAGCAACACTTTATC",11,197,37,4,18,267,16486
"TCAGCCTAGCGCATCC",3,94,20,1,8,126,8181
"TCAGCCTCACGATAGG",4,70,65,5,23,167,7393
"TCAGGGCGTCCTGTTC",1,31,104,3,6,145,9244
"TCAGGGCTCGCCTTGT",11,65,28,1,21,126,2985
"TCAGGGCTCGCGTGAC",7,65,183,5,13,273,17138
"TCAGGTAAGCGGACAT",2,68,26,3,21,120,2815
"TCAGGTAGTAAGTTGA",7,61,113,6,109,296,21908
"TCAGGTATCGCGTCGA",0,19,8,1,3,31,247
"TCAGTGACAATAGTGA",5,62,21,5,9,102,2728
"TCAGTGAGTGACAGCA",24,35,12,1,3,75,4382
"TCAGTTTCAGCAATTC",3,51,37,4,30,125,5409
"TCATACTGTGCACAAG",10,1158,60,13,28,1269,95500
"TCATACTTCCGTGCGA",133,117,17,3,12,282,17093
"TCATATCCAAGTAGTA",271,350,43,8,23,695,46423
"TCATATCGTGGTCTGC",1,15,18,1,4,39,869
"TCATCATAGGCCTAGA",4,99,24,4,14,145,5230
"TCATCCGAGTCCTGTA",5,81,136,4,30,256,14771
"TCATCCGCAGTCAGCC",2,26,8,0,1,37,2485
"TCATCCGTCGAGCCTG",31,91,22,1,14,159,6087
"TCATCCGTCGTCAACA",9,74,52,3,164,302,16867
"TCATCCGTCTCTGGTC",24,80,14,4,8,130,6079
"TCATGCCTCCTTCGAC",6,64,35,4,116,225,14469
"TCATTACAGGATGCGT",1,9,8,1,1,20,274
"TCATTCACAACCCTAA",36,70,23,4,12,145,5566
"TCATTCACACACACTA",5,55,23,4,12,99,3010
"TCATTCATCCGTTTCG",8,140,140,4,22,314,22774
"TCATTGTGTATCACCA",126,209,60,5,41,441,23890
"TCATTGTTCGTAGCCG",10,51,28,2,30,121,3529
"TCATTTGAGCTGACCC",1,12,4,0,0,17,61
"TCATTTGTCAGGACGA",8,56,27,7,103,201,13723
"TCCACCATCTCTTGCG",23,2010,270,10,46,2359,186981
"TCCAGAAAGTGTGTTC",1,22,25,1,4,53,1831
"TCCAGAACAGTGGCTC",3,73,62,4,10,152,4646
"TCCAGAAGTCTCCTGT",7,67,32,9,12,127,3842
"TCCAGAATCTTGGCTC",4,183,56,4,38,285,17426
"TCCATCGGTTTCGACA",1,13,7,3,17,41,635
"TCCATGCAGGTTCATC",4,12,9,2,2,29,195
"TCCATGCCAAGCGCAA",8,33,19,4,16,80,2003
"TCCATGCGTTGCATAC",13,142,42,6,14,217,7586
"TCCATGCTCGTGTGGC",6,425,47,9,22,509,28819
"TCCCACAAGTCATGCT",9,80,22,5,138,254,14532
"TCCCACACACACCAGC",4,67,76,1,16,164,11164
"TCCCACATCAAGCCGC",9,70,23,4,102,208,11465
"TCCCAGTGTACTCGAT",2,72,26,1,19,120,2903
"TCCCAGTGTTGCGGCT",0,6,2,0,0,8,259
"TCCCATGAGGCGAAGG",5,25,12,3,33,78,2748
"TCCCATGCATGTGACT",3,39,10,1,5,58,493
"TCCCATGGTAGGTGCA",0,116,23,2,5,146,12969
"TCCCATGTCTGGGCAC",3,63,32,121,8,227,12172
"TCCGAAAGTTCTGACA",12,47,24,4,21,108,4215
"TCCGAAATCGGAGTGA",2,42,22,2,23,91,3810
"TCCGTGTGTAACACCT",8,92,328,7,171,606,49536
"TCCTAATCAACATACC",5,86,149,8,23,271,15106
"TCCTAATCAACCGTGC",6,457,29,6,14,512,48125
"TCCTAATGTCCCTGAG",0,4,1,0,1,6,40
"TCCTAATGTCTGTGGC",6,49,20,1,16,92,2076
"TCCTAATTCTGTACAG",74,184,20,3,22,303,24226
"TCCTCTTAGGCTAAAT",6,68,67,3,19,163,8581
"TCCTCTTCACGCTATA",1,43,16,3,8,71,1733
"TCCTCTTCAGCTAACT",9,95,340,5,18,467,34075
"TCCTTCTCACCGTGAC",1,13,5,1,3,23,1239
"TCCTTCTCAGAATTCC",10,553,65,4,23,655,48313
"TCCTTCTGTCCAGCCA",15,2712,95,13,47,2882,237521
"TCCTTCTGTTACCGTA",13,69,34,3,12,131,5014
"TCCTTCTTCATTTCCA",4,20,14,4,26,68,2885
"TCCTTCTTCGTGTCAA",6,71,111,4,31,223,12638
"TCCTTTCCAAAGTGTA",5,64,33,6,13,121,3816
"TCCTTTCCATAGCACT",7,192,38,0,26,263,14146
"TCGAACAAGCAATAAC",5,181,37,4,21,248,12459
"TCGAACAAGTCGGCCT",73,80,32,5,19,209,8687
"TCGAACAGTCCGCAGT",5,58,20,2,112,197,13442
"TCGAACAGTGTCATCA",3,74,21,3,6,107,5128
"TCGAAGTGTTACAGCT",3,42,15,4,9,73,2176
"TCGAAGTTCCCTCATG",5,46,15,32,12,110,4068
"TCGACCTGTATGTCAC",3,70,291,4,19,387,30564
"TCGACGGGTAGGTACG",7,60,23,2,12,104,2012
"TCGACGGGTTGGGACA",8,27,10,1,7,53,1446
"TCGACGGTCCGAAATC",5,54,13,4,4,80,2664
"TCGATTTGTCCTCATC",2,23,11,1,5,42,270
"TCGCACTCAAAGGTTA",4,79,268,2,14,367,27669
"TCGCACTCAGCCATTA",5,223,83,2,17,330,20256
"TCGCAGGTCTAGTGTG",12,75,39,8,69,203,5894
"TCGCTCAAGTTGCTGT",10,78,26,4,27,145,3481
"TCGCTCATCGTCGCTT",5,35,257,1,14,312,10648
"TCGCTTGAGCGACATG",8,66,18,2,13,107,2027
"TCGCTTGCAGACATCT",2,8,14,1,3,28,1255
"TCGCTTGTCGAATCCA",8,53,198,4,19,282,18678
"TCGGATAGTTCTAACG",13,97,538,2,24,674,65528
"TCGGATATCTTTGCTA",2,18,9,1,2,32,747
"TCGGGACGTAAGTTAG",1,310,45,3,5,364,25926
"TCGGGACTCCATTCGC",0,15,3,2,4,24,72
"TCGGGCAAGCACTTTG",4,60,15,4,11,94,2959
"TCGGGCACAGTGGGTA",25,186,40,3,32,286,18170
"TCGGGCAGTGTAAATG",88,283,29,4,19,423,31660
"TCGGGTGTCCGCCTAT",0,18,8,2,6,34,437
"TCGGTCTTCAGAGCGA",5,367,21,3,11,407,26414
"TCGTAGATCGGCCCAA",101,192,36,5,13,347,23423
"TCGTCCAGTTCAGCGC",10,173,36,50,10,279,15186
"TCGTGCTAGATCCCGC",1,31,68,1,8,109,4377
"TCGTGCTAGTATGGAT",2,6,2,1,3,14,254
"TCGTGCTCATCCTGTC",2,33,146,4,160,345,14981
"TCGTGCTTCCACGGGT",2,155,32,6,13,208,6752
"TCGTGGGGTAAGTAGT",4,58,14,3,116,195,10298
"TCGTGGGGTGATTAGA",0,7,2,0,3,12,40
"TCTAACTGTATGAAGT",4,58,15,3,7,87,3771
"TCTAACTTCAAGAAAC",4,68,30,3,20,125,2559
"TCTACATCAGCATCTA",6,194,45,3,17,265,17361
"TCTACATGTTCGGTTA",5,83,32,7,192,319,26905
"TCTACATGTTCTCCCA",15,71,136,5,16,243,15836
"TCTACATGTTGGAGGT",4,69,21,1,12,107,4687
"TCTACCGAGATGTTAG",0,5,1,0,49,55,4524
"TCTACCGCACAGTACT",6,51,25,1,55,138,6839
"TCTACCGTCGGCATTA",3,21,7,7,12,50,1101
"TCTATACAGTGGTGAC",54,97,43,3,22,219,7419
"TCTATACCACACCGAC",2,211,97,4,23,337,20891
"TCTATACTCGCAGATT",6,67,200,6,18,297,17602
"TCTATACTCTTCACAT",2,270,32,27,28,359,24778
"TCTATCAGTGGACTAG",52,123,21,3,18,217,10969
"TCTATCAGTTGCCTAA",8,54,21,7,15,105,2671
"TCTATCATCCTCCACA",16,52,36,5,16,125,4718
"TCTATCATCTCTGGTC",9,92,122,2,17,242,12573
"TCTCACGTCACTGCTC",25,298,30,3,21,377,25345
"TCTCAGCGTGGCTTGC",10,74,53,6,343,486,42117
"TCTCAGCTCTCCCAAC",4,50,21,2,14,91,3253
"TCTCCGAAGTTGGGAC",4,60,15,4,16,99,2299
"TCTCCGACATAGGAGC",10,133,34,5,29,211,10352
"TCTCCGATCTCCGAAA",5,71,91,1,23,191,9599
"TCTGCCATCCTGTAGA",153,68,33,82,96,432,33763
"TCTGCCATCGATACGT",7,44,30,1,11,93,1909
"TCTGGCTGTCCATACA",7,56,280,2,19,364,34498
"TCTGGCTGTTCTCCTG",6,98,23,3,17,147,7707
"TCTGTCGGTGTACGCC",1,30,7,2,5,45,847
"TCTTAGTAGCCGCACT",35,86,25,1,15,162,9068
"TCTTAGTAGCGAACTG",4,58,34,2,18,116,3197
"TCTTAGTAGGCCACTC",5,66,36,2,16,125,3858
"TCTTAGTGTCACCGAC",10,60,117,3,22,212,13302
"TCTTAGTTCCTCACTG",12,780,154,8,28,982,66145
"TCTTCCTCACAGCTTA",10,77,90,3,39,219,14495
"TCTTCCTGTGAGTCAG",5,47,23,0,13,88,1644
"TCTTCCTTCGACACCG",5,209,52,3,14,283,19162
"TCTTGCGAGCGGGTTA",2,56,35,2,40,135,5934
"TCTTTGAAGTTGCTGT",1,17,30,2,3,53,3359
"TCTTTGAGTGCACGCT",5,114,32,2,20,173,7655
"TCTTTGAGTGTTTCTT",5,61,23,1,12,102,3486
"TCTTTGAGTTGCTCAA",4,38,15,2,14,73,947
"TGAACGTCACAGTCCG",6,138,33,1,27,205,12391
"TGAATCGAGAGATTCA",35,57,15,3,11,121,5517
"TGAATCGCACAGAAGC",6,82,477,3,404,972,99568
"TGAATCGTCCAAGCAT",4,43,14,4,7,72,2117
"TGAATGCGTCACCTTC",3,64,38,4,17,126,4394
"TGACAGTAGCAATAAC",119,557,85,5,30,796,58198
"TGACAGTCAAATCGGG",1,117,3,0,1,122,6407
"TGACAGTGTTGTGGCC",3,73,16,1,13,106,6055
"TGACAGTTCAGTGATC",11,423,54,6,18,512,40504
"TGACTCCAGTCATGCT",13,93,40,5,308,459,35062
"TGACTCCCAATCAAGA",34,59,21,3,12,129,5033
"TGACTCCCAATGTCTG",0,20,18,2,12,52,872
"TGACTCCTCGTTATCT",8,71,136,4,12,231,13872
"TGAGCGCGTCCACGCA",0,33,173,0,15,221,20901
"TGAGGAGAGTATCTGC",9,59,25,5,28,126,2418
"TGAGGAGGTTCCGCTT",3,11,3,3,2,22,162
"TGAGGAGTCCTTCGAC",94,52,31,4,13,194,11643
"TGAGGGAAGCAGCCTC",54,115,21,4,21,215,8185
"TGAGGGACAGCTACAT",4,58,160,4,15,241,18290
"TGAGGGATCGCTAGCG",2,47,10,3,12,74,3289
"TGAGGTTAGTATGAGT",9,177,32,1,17,236,12583
"TGAGGTTGTTGAATCC",8,66,258,2,108,442,38729
"TGAGTCAAGCCAAGGT",2,66,14,1,2,85,6507
"TGAGTCACAACCGGAA",6,146,28,3,28,211,7377
"TGAGTCATCATAGAGA",4,83,18,161,24,290,15985
"TGATCAGCAGACGCTC",9,68,35,1,140,253,16230
"TGATCAGGTGGCAGAT",6,100,19,5,53,183,7999
"TGATCAGGTTACCCTC",17,256,43,19,24,359,17377
"TGATCTTAGTAGAATC",4,62,44,5,20,135,6478
"TGATCTTCAGCATCTA",3,106,33,0,239,381,27323
"TGATCTTCAGCCATTA",15,60,33,4,14,126,3128
"TGATCTTCAGGACTTT",0,51,30,1,3,85,6922
"TGATCTTTCATTTGTC",10,76,33,3,12,134,4573
"TGATGCAAGCAAGTCG",5,63,405,5,15,493,38259
"TGATGCAGTCAGACGA",40,50,45,3,19,157,6089
"TGATGCATCACGAGGA",7,60,103,4,106,280,18935
"TGATGCATCTCGCCTA",3,148,34,7,11,203,12313
"TGATGGTAGACCAGCA",2,58,30,3,94,187,9463
"TGATGGTAGCGCATCC",2,65,17,3,17,104,3313
"TGATGGTGTAACCCGC",3,36,18,5,155,217,15852
"TGATGGTGTTGATCGT",2,11,13,1,6,33,307
"TGATTCTCACCTAAAC",9,69,24,1,13,116,2605
"TGATTCTGTTGCCAAT",5,33,31,1,18,88,2540
"TGATTCTTCCAAAGGG",8,63,33,6,33,143,4280
"TGATTTCCAGTGGCTC",3,109,33,4,16,165,6811
"TGATTTCGTTGCCGCA",4,857,52,9,23,945,75008
"TGCACGGGTACGGGAT",33,69,100,2,75,279,15211
"TGCAGATCAGATTAAG",2,15,7,0,18,42,2116
"TGCAGATTCCCATGGG",10,128,23,6,17,184,7239
"TGCAGATTCGGTATGT",11,81,47,3,147,289,15799
"TGCAGGCCAATAAGGT",3,50,274,4,11,342,28648
"TGCAGGCCACCCTGAG",4,73,231,5,18,331,20063
"TGCAGGCCATCTAGAC",0,18,4,0,5,27,153
"TGCAGGCTCGGCCTTT",13,57,135,5,268,478,35146
"TGCAGTAAGGACATCG",13,60,93,6,16,188,8729
"TGCAGTATCCGCGATG",0,22,7,1,0,30,843
"TGCAGTATCTCTGCTG",7,70,37,6,11,131,4950
"TGCATCCCAATCCAGT",10,179,281,3,16,489,33436
"TGCATGAAGTTGTAAG",11,416,56,5,27,515,29977
"TGCATGACAACGTTAC",4,71,11,2,5,93,5461
"TGCATGATCCGTACGG",7,272,40,3,26,348,16564
"TGCCGAGCATCATTTC",8,49,16,3,6,82,3259
"TGCGACGAGAAACTCA",0,3,1,0,0,4,19
"TGCGACGAGTCATGCT",4,40,66,1,9,120,5472
"TGCGACGTCCTCACCA",0,9,8,0,2,19,60
"TGCGATAAGAAACTCA",8,69,51,4,21,153,7766
"TGCGATAAGTGATTCC",1,35,19,0,9,64,2176
"TGCGATACACACTTAG",5,77,34,7,157,280,18975
"TGCGATATCATTTACC",1,15,9,0,6,31,111
"TGCGGCAAGTGCGACA",8,71,33,1,17,130,4688
"TGCGGCATCAGACATC",2,70,27,3,8,110,1977
"TGCGGGTCACTGCTTC",152,320,59,5,36,572,42436
"TGCGGGTGTAGCCCTG",8,650,76,3,395,1132,89837
"TGCGGGTGTTCAAGTC",4,56,22,4,185,271,19404
"TGCTCCAAGTCGGGAT",21,83,198,6,12,320,25439
"TGCTCCAAGTGCACTT",7,36,24,2,14,83,2689
"TGCTGAATCAACTCTT",5,81,191,1,21,299,21945
"TGCTTCGCACAATTCG",4,63,141,6,13,227,12583
"TGCTTCGCACTCACTC",0,26,1,1,2,30,1839
"TGCTTGCCAACGGCTC",7,72,256,0,19,354,24331
"TGCTTGCGTTGCATTG",2,86,27,3,17,135,3413
"TGCTTGCTCGAGAAAT",12,122,498,6,45,683,48671
"TGGAACTGTGGTCCGT",15,131,45,54,19,264,12115
"TGGAGAGCAGGGCTTC",3,68,47,1,15,134,4259
"TGGAGGATCACGGGCT",0,11,4,0,6,21,372
"TGGATCAAGAAGTGTT",2,21,20,0,5,48,902
"TGGATCACAAATGAGT",13,86,160,5,20,284,17312
"TGGATGTGTGCGTTTA",7,151,27,6,15,206,10408
"TGGATGTTCCTTCTTC",4,50,26,3,157,240,20047
"TGGCGTGCACCTGCAG",1,4,5,0,2,12,63
"TGGCGTGCATAAGATG",5,175,195,3,21,399,27545
"TGGCGTGGTCGAACAG",5,46,12,1,12,76,1755
"TGGGAAGCAAGGCGTA",9,73,326,5,18,431,35483
"TGGGAAGGTTTACTTC",5,56,191,5,124,381,33452
"TGGGAGACACTGCGTG",10,42,36,2,14,104,4408
"TGGGAGACAGAGAATT",5,133,47,3,58,246,10327
"TGGGAGAGTTGTTGTG",3,39,7,4,13,66,2632
"TGGGATTCAGGCCTGT",3,35,11,4,4,57,1838
"TGGGATTGTGGCCACT",4,45,16,0,17,82,168
"TGGGATTGTTTCCATT",4,44,23,2,8,81,186
"TGGGCGTCAAAGCTCT",6,58,43,3,96,206,11559
"TGGGCGTCAATCTCGA",4,76,27,1,15,123,2920
"TGGGCGTCAGCAGTAG",9,230,56,6,16,317,15338
"TGGGCGTTCCACCTGT",3,47,29,3,13,95,3819
"TGGGCGTTCCAGCAAT",6,122,33,2,7,170,7547
"TGGGCTGAGACGCTCC",1,59,7,3,6,76,3540
"TGGGCTGGTGTCCTAA",1,22,4,0,4,31,482
"TGGGTTACAGACAAGC",2,80,12,27,9,130,9979
"TGGGTTATCGACCTAA",5,51,28,3,19,106,1932
"TGGTACACAAGGGTCA",8,25,9,2,7,51,271
"TGGTACATCCACTGAA",8,82,22,7,20,139,2476
"TGGTAGTAGCAAGCCA",4,52,24,3,89,172,11112
"TGGTAGTAGGTGGGTT",8,560,70,4,83,725,71938
"TGGTAGTCATCTCGTC",9,167,75,8,22,281,15217
"TGGTAGTGTTAAACCC",10,103,29,1,58,201,8763
"TGGTGATAGGCGACAT",7,94,35,4,80,220,9239
"TGGTGATCATATGAAG",0,6,3,0,0,9,29
"TGGTGATTCACTCTTA",10,77,35,4,33,159,3143
"TGGTGATTCGCGTTTC",3,17,20,3,9,52,1866
"TGGTGATTCTCGTGGG",39,109,34,440,23,645,49604
"TGGTTAGAGGTCGCCT",4,23,24,0,36,87,4198
"TGGTTAGCAGAGAGGG",0,12,9,0,2,23,268
"TGGTTAGTCATCGTAG",30,88,36,6,20,180,5403
"TGTAACGTCCTGGCTT",9,48,37,4,77,175,12749
"TGTAAGCAGTTCGCAT",3,23,13,0,7,46,713
"TGTAAGCCACAGTACT",8,276,30,3,16,333,23049
"TGTAAGCGTAGACACG",7,51,26,0,13,97,2133
"TGTAAGCGTTAGGGAC",9,99,31,83,20,242,15264
"TGTAAGCTCTGACAGT",8,63,26,2,8,107,2154
"TGTACAGCAAAGGCAC",1,47,52,5,9,114,6432
"TGTACAGGTGGACCAA",2,36,8,5,5,56,2354
"TGTACAGGTTGTACGT",4,44,35,2,20,105,2316
"TGTACAGTCGATACAC",51,31,29,18,14,143,6671
"TGTCAGAAGGGAGGCA",7,44,55,2,19,127,6216
"TGTCAGAAGTGGTCAG",13,824,37,9,16,899,69317
"TGTCAGACACTTCATT",1,49,19,6,15,90,2258
"TGTCCACAGAATGTTG",4,64,168,4,18,258,16043
"TGTCCACCAGTGTATC",10,529,48,5,21,613,41500
"TGTCCCAAGTGCTCGC",9,70,285,5,84,453,33941
"TGTCCCATCGAGCCAC",3,60,21,1,8,93,1947
"TGTCCTGCAATCGCAT",7,191,29,4,352,583,45325
"TGTCCTGTCACGGACC",4,18,14,1,8,45,1432
"TGTGAGTAGTATGAGT",15,101,23,1,11,151,9064
"TGTGAGTAGTTCTCTT",67,387,59,53,39,605,42174
"TGTGAGTCATCCGAGC",9,48,20,2,7,86,1706
"TGTGAGTTCGGACCAC",7,65,96,5,15,188,10124
"TGTGATGGTGAATAAC",9,384,58,4,40,495,42729
"TGTGATGTCACTTCTA",31,86,37,144,12,310,18803
"TGTGATGTCATCGCCT",3,49,25,5,14,96,1976
"TGTGCGGAGACTCTTG",27,140,43,11,32,253,9597
"TGTGCGGAGAGCCGAT",6,51,21,3,8,89,1880
"TGTGGCGAGAGTCAAT",3,42,14,3,8,70,1933
"TGTGGCGAGCAATTAG",5,85,20,4,167,281,18701
"TGTGGCGAGGTGCTTT",4,34,51,2,26,117,5113
"TGTGGCGAGTGGCCTC",4,60,41,3,141,249,16164
"TGTGGCGCAGCGACCT",3,43,267,10,18,341,32039
"TGTGGCGGTAACTGCT",7,77,28,6,21,139,4797
"TGTGGCGGTCACTACA",7,74,47,7,15,150,5263
"TGTGGCGGTGCGAGTA",1,6,1,0,1,9,31
"TGTGGCGGTGGGAGAG",27,84,37,2,16,166,7203
"TGTGGCGTCCATCTAT",2,14,10,5,4,35,108
"TGTGTGAAGCGAGTAC",10,158,16,0,11,195,17468
"TGTGTGAGTCTACGAT",3,41,65,2,8,119,7274
"TGTGTGAGTTCGAACT",8,65,183,2,19,277,22606
"TGTTACTAGCACACCC",2,18,14,2,8,44,82
"TGTTCCGCACAAAGTA",5,691,98,3,28,825,56824
"TGTTCCGCATCAGTGT",12,77,33,2,167,291,19474
"TGTTCTAGTCCATACA",10,54,30,4,14,112,1918
"TGTTCTAGTGCTGCAC",4,124,37,4,19,188,13561
"TGTTCTATCTAAGAAG",3,21,14,0,6,44,389
"TGTTGAGAGCTCCGAC",4,52,105,3,41,205,12722
"TGTTGAGCAGTAACAA",7,60,33,2,12,114,2718
"TGTTTGTAGGACGCAT",21,58,38,221,18,356,26902
"TGTTTGTGTGAGAACC",10,80,723,8,16,837,82509
"TGTTTGTTCGAGATAA",8,63,16,1,10,98,3610
"TGTTTGTTCGGTGTTA",5,106,32,2,14,159,8933
"TTAATCCAGGCTATCT",2,3,3,0,0,8,23
"TTACCATGTAGTGCGA",13,54,144,5,54,270,20730
"TTACCATGTCCTGGTG",5,44,18,1,78,146,8494
"TTACCATTCTTCGGTC",3,43,372,1,24,443,33242
"TTACGCCGTAGCTTTG",30,56,20,36,13,155,5881
"TTACGCCGTTGACGGA",238,439,31,1,20,729,57027
"TTACGCCTCCACGTAA",226,308,40,15,17,606,55121
"TTAGGCAGTGTCTAAC",1,10,5,1,3,20,418
"TTAGGGTAGTAAACAC",8,468,32,6,29,543,39761
"TTAGGGTTCCCACAGG",8,65,103,6,13,195,11514
"TTAGTCTAGCTGTTCA",2,83,28,0,13,126,5747
"TTAGTCTTCCCGAAAT",10,19,13,0,4,46,768
"TTAGTCTTCTTAAGGC",61,68,29,7,26,191,7040
"TTATTGCAGGTCCCGT",2,30,8,3,3,46,2025
"TTATTGCCAAGTGGCA",0,7,0,1,3,11,20
"TTCAATCAGGCGAAGG",4,276,39,3,15,337,22180
"TTCACCGAGGTCGAGT",0,0,2,0,1,3,26
"TTCACCGGTAGATCGG",1,5,2,1,1,10,54
"TTCACCGGTTGCAAGG",3,60,74,5,76,218,16082
"TTCACCGTCCATATGG",7,448,32,3,18,508,46078
"TTCACGCCAATGTTGC",5,53,158,1,14,231,18550
"TTCACGCCAGAGGTAC",4,68,67,6,7,152,6929
"TTCACGCCATTGTCGA",8,212,19,5,15,259,15443
"TTCAGGACAACGGCCT",6,171,26,4,12,219,17164
"TTCAGGACAGTGTATC",6,76,36,2,16,136,5518
"TTCAGGAGTTGCCTAA",3,34,11,1,7,56,115
"TTCAGGATCATTGTGG",1,144,32,2,20,199,12055
"TTCAGGATCCTCACCA",3,14,11,0,5,33,269
"TTCATGTCAGGACGAT",5,48,31,1,14,99,1655
"TTCATTGAGAAGGCTC",4,68,22,5,16,115,3293
"TTCCAATGTGGAGGTT",0,38,5,0,2,45,3165
"TTCCAATGTGTCGCTG",1,13,11,0,2,27,405
"TTCCACGGTATGAAGT",3,68,12,0,13,96,4892
"TTCCACGTCAGTGTCA",4,30,24,3,11,72,2165
"TTCCGTGCAGGACTAG",7,71,22,7,96,203,11903
"TTCCGTGTCCATTTGT",3,25,9,0,7,44,210
"TTCCTCTCAATTGTGC",0,6,4,1,6,17,346
"TTCCTCTTCATTATCC",8,221,23,4,16,272,16001
"TTCCTTCCAAAGCGTG",1,59,23,5,14,102,2328
"TTCCTTCGTATGGAAT",5,60,17,4,19,105,1742
"TTCCTTCTCGAGAAGC",12,312,27,8,17,376,24845
"TTCGATTAGCTGGCTC",1,15,4,1,4,25,656
"TTCGATTAGTCTGCGC",6,39,16,1,7,69,161
"TTCGCTGAGACGGTCA",6,56,32,3,105,202,13446
"TTCGCTGCAAAGGCAC",4,61,19,2,18,104,3087
"TTCGCTGCAACTTGGT",6,69,16,2,7,100,3942
"TTCGGTCCATTGAAAG",6,104,26,1,78,215,16539
"TTCGGTCTCAGCTTCC",21,81,35,0,16,153,5183
"TTCGGTCTCGTTATCT",6,188,23,45,17,279,16301
"TTCTAACAGTGACCTT",2,75,46,2,73,198,8559
"TTCTAACTCATCAGTG",52,79,24,1,22,178,7911
"TTCTAGTAGGAAGTCC",0,17,5,1,7,30,344
"TTCTAGTAGGTAGACC",7,54,34,1,9,105,3052
"TTCTAGTAGTCTAGAA",2,345,103,3,13,466,34242
"TTCTAGTCAGCAATTC",7,613,46,7,19,692,56871
"TTCTAGTGTATCGCTA",5,173,19,4,12,213,15283
"TTCTCTCAGTCTCCTC",11,126,22,1,15,175,9682
"TTCTCTCCACTACCCT",4,50,27,2,35,118,4548
"TTCTCTCCAGGTCTCG",6,144,14,2,19,185,12134
"TTCTTCCAGAATCGTA",12,45,23,3,5,88,2016
"TTCTTCCTCACCGGGT",2,42,21,6,12,83,2030
"TTCTTGAAGATCGCTT",2,53,24,5,35,119,4564
"TTCTTGAGTACAGAAT",6,112,215,11,86,430,38456
"TTGAACGGTATATGGA",0,13,2,0,2,17,619
"TTGAACGTCACCCTGT",6,45,22,63,8,144,7257
"TTGAGTGAGGTGAGAA",13,53,12,3,11,92,2299
"TTGAGTGCAAACTAAG",4,50,40,2,27,123,5278
"TTGATGGCATGTGCTA",1,324,13,2,15,355,28782
"TTGATGGGTCAAATCC",15,87,23,1,11,137,5558
"TTGCATTAGCCTGAAG",5,66,70,7,50,198,9352
"TTGCATTAGTGCAGGT",9,73,31,2,16,131,3731
"TTGCATTTCGTCTACC",5,7,5,0,2,19,723
"TTGCCTGCAGCTTCGG",5,64,37,2,53,161,9857
"TTGCCTGTCTCTTAAC",3,10,16,0,12,41,1369
"TTGCGTCAGTCCTACA",138,158,146,1,15,458,32831
"TTGCGTCCATGTTCAG",5,46,128,5,11,195,16154
"TTGCGTCTCCTCAGAA",9,340,72,6,13,440,26544
"TTGGGATAGCTAGCCC",7,64,88,1,24,184,10835
"TTGGGCGCATCGCTCT",2,60,26,1,52,141,6906
"TTGGTTTAGACCTTTG",9,90,146,3,25,273,15070
"TTGGTTTAGTGCAAAT",5,93,45,3,19,165,9083
"TTGGTTTCATTACTCT",120,2847,395,9,62,3433,314273
"TTGGTTTGTACGGTTT",7,73,57,3,23,163,6622
"TTGGTTTGTCTTCCGT",3,62,168,5,18,256,16680
"TTGGTTTTCGACGCTG",4,37,24,2,70,137,7482
"TTGTGGACAGAATTCC",7,181,44,17,13,262,15200
"TTGTGGAGTACTGAGG",6,65,129,2,53,255,18682
"TTGTGTTAGGTAAAGG",3,40,44,4,31,122,6240
"TTGTGTTAGTCCGTCG",2,52,20,0,8,82,2549
"TTGTGTTCAAGAGTGC",6,59,32,3,39,139,4720
"TTGTGTTCAGAACTAA",2,42,16,1,8,69,2978
"TTGTGTTCAGCTACTA",1,27,31,0,12,71,2024
"TTGTGTTCATAGCTGT",2,41,27,5,16,91,3381
"TTGTGTTCATTGTCGA",4,309,36,6,16,371,20427
"TTGTGTTGTGTTGACT",1,23,8,1,66,99,6289
"TTGTTCAAGCCTCTTC",2,83,28,6,13,132,4123
"TTGTTCAAGCTTGTTG",2,137,12,2,10,163,10420
"TTGTTCAGTGGTATGG",1,47,26,5,13,92,3105
"TTGTTGTGTCTTGGTA",1,87,22,5,9,124,3603
"TTGTTGTGTGAGGAAA",6,61,265,7,20,359,32950
"TTGTTTGGTGAATAAC",9,75,34,3,26,147,2474
"TTTACCAGTCTCGCGA",10,179,26,3,11,229,11146
"TTTACCAGTGCTCCGA",51,226,29,2,12,320,20548
"TTTACGTAGACCATAA",0,8,3,1,1,13,54
"TTTACGTAGGGTGAGG",9,61,23,1,18,112,2542
"TTTACGTCACAGTCCG",27,72,39,5,16,159,5920
"TTTACGTTCTCTGCTG",2,39,11,2,7,61,2040
"TTTACTGAGAGGTTTA",7,54,68,6,82,217,10744
"TTTACTGAGCTTGTTG",3,75,19,3,8,108,3892
"TTTACTGAGGATGTTA",2,31,22,2,12,69,196
"TTTACTGCAACGGTAG",4,111,21,0,6,142,6920
"TTTAGTCAGGCACAAC",9,96,87,2,279,473,38924
"TTTAGTCCAGCATCTA",1,19,8,1,0,29,1370
"TTTAGTCTCGAGCACC",9,65,272,7,29,382,30369
"TTTAGTCTCTGTCTCG",12,106,35,6,19,178,8082
"TTTATGCAGGACCCAA",7,177,25,4,28,241,11726
"TTTCACAAGCTGGCTC",5,302,61,3,12,383,31364
"TTTCACAGTAGCTTAC",4,122,29,3,11,169,8295
"TTTCACAGTTGCAACT",10,61,39,4,16,130,2730
"TTTCAGTCAGACACCC",10,60,19,8,154,251,18028
"TTTCAGTGTAGAATAC",1,24,20,0,7,52,1492
"TTTCATGGTGAGTGAC",12,39,20,0,10,81,2444
"TTTCATGTCGCAGTGC",6,174,117,8,115,420,25192
"TTTCATGTCGGTAGGA",7,55,40,3,16,121,5497
"TTTCCTCGTATGTCCA",40,316,40,7,23,426,25594
"TTTCGATAGTCCTGTA",8,202,33,4,16,263,13231
"TTTCGATGTAGGTGCA",2,37,9,0,4,52,2298
"TTTCGATTCGAATGCT",8,120,40,6,14,188,9142
"TTTGACTGTATCGTGT",6,69,22,5,13,115,2209
"TTTGATCAGTTGGAAT",2,21,0,0,5,28,1001
"TTTGATCGTCTACACA",79,69,36,9,19,212,8490
"TTTGATCTCGGTTAGT",40,134,34,3,15,226,13569
"TTTGATCTCTTCGTGC",3,15,10,1,4,33,78
"TTTGGAGAGAGGATGA",3,82,26,44,23,178,8358
"TTTGGTTAGGTCGTAG",5,59,400,7,27,498,48543
"TTTGGTTGTAGGGTAC",9,55,256,5,11,336,31612
"TTTGGTTTCGGACTTA",5,73,29,2,24,133,2911
"TTTGTTGGTCGACTTA",5,59,25,2,21,112,2867
"TTTGTTGGTTTGGCTA",0,37,11,1,6,55,573
"TTTGTTGTCGTAATGC",0,6,8,3,3,20,370
